TQ,DPQ,C,OU,DI,DFT,RD,DFO,DPQ2,C2,TQ2,OU2,DI2,DFT2,RD2,DFO2,DPQ3,C3,TQ3,OU3,DI3,DFT3,RD3,DFO3
1,4,2,0,5,1,4,0,4,2,1,0,4,1,3,0,4,2,1,0,3,0,3,0
1,2,4,2,10,2,8,4,2,4,1,2,8,2,6,2,2,4,1,2,6,1,5,2
3,2,0,2,13,9,4,2,2,0,3,2,4,2,2,0,2,0,3,2,2,1,1,0
0,0,4,0,28,2,26,2,0,4,0,0,26,2,24,2,0,4,0,0,24,2,22,2
2,1,4,0,29,14,15,1,1,4,2,0,15,7,8,0,1,4,2,0,8,4,4,0
4,4,0,3,0,0,0,0,4,0,4,3,0,0,0,0,4,0,4,3,0,0,0,0
1,4,2,4,1,0,1,0,4,2,1,4,1,0,1,0,4,2,1,4,1,0,1,0
2,1,1,4,22,11,11,9,1,1,2,4,11,5,6,5,1,1,2,4,6,3,3,2
2,1,2,3,16,8,8,5,1,2,2,3,8,4,4,2,1,2,2,3,4,2,2,1
3,4,0,4,3,2,1,0,4,0,3,4,1,0,1,0,4,0,3,4,1,0,1,0
3,1,1,3,9,6,3,2,1,1,3,3,3,2,1,0,1,1,3,3,1,0,1,0
0,3,2,0,11,1,10,1,3,2,0,0,10,1,9,0,3,2,0,0,9,0,9,0
1,4,1,0,5,1,4,0,4,1,1,0,4,1,3,0,4,1,1,0,3,0,3,0
1,4,0,1,0,0,0,0,4,0,1,1,0,0,0,0,4,0,1,1,0,0,0,0
2,3,2,3,6,3,3,2,3,2,2,3,3,1,2,1,3,2,2,3,2,0,2,1
4,1,0,3,13,11,2,1,1,0,4,3,2,1,1,0,1,0,4,3,1,0,1,0
2,4,1,0,4,2,2,0,4,1,2,0,2,0,2,0,4,1,2,0,2,0,2,0
0,1,2,0,15,1,14,1,1,2,0,0,14,1,13,1,1,2,0,0,13,1,12,1
1,1,3,2,16,4,12,6,1,3,1,2,12,3,9,4,1,3,1,2,9,2,7,3
1,0,0,2,4,1,3,1,0,0,1,2,3,0,3,1,0,0,1,2,3,0,3,1
2,3,3,4,6,2,4,3,3,3,2,4,4,1,3,2,3,3,2,4,3,1,2,1
2,1,2,2,21,10,11,5,1,2,2,2,11,5,6,3,1,2,2,2,6,3,3,1
1,0,4,4,28,8,20,18,0,4,1,4,20,6,14,12,0,4,1,4,14,4,10,8
3,1,3,1,26,18,8,2,1,3,3,1,8,5,3,0,1,3,3,1,3,2,1,0
0,4,3,4,8,0,8,7,4,3,0,4,8,0,8,7,4,3,0,4,8,0,8,7
1,4,3,0,2,0,2,0,4,3,1,0,2,0,2,0,4,3,1,0,2,0,2,0
2,0,1,3,20,10,10,6,0,1,2,3,10,4,6,4,0,1,2,3,6,2,4,2
3,0,1,3,10,6,4,2,0,1,3,3,4,2,2,1,0,1,3,3,2,1,1,0
0,2,0,3,4,0,4,2,2,0,0,3,4,0,4,2,2,0,0,3,4,0,4,2
4,2,0,1,12,10,2,0,2,0,4,1,2,1,1,0,2,0,4,1,1,0,1,0
3,1,2,0,20,14,6,0,1,2,3,0,6,4,2,0,1,2,3,0,2,1,1,0
2,1,1,3,7,3,4,2,1,1,2,3,4,2,2,1,1,1,2,3,2,0,2,1
2,0,0,1,0,0,0,0,0,0,2,1,0,0,0,0,0,0,2,1,0,0,0,0
2,2,4,0,20,10,10,0,2,4,2,0,10,5,5,0,2,4,2,0,5,2,3,0
2,3,0,0,10,4,6,0,3,0,2,0,6,3,3,0,3,0,2,0,3,1,2,0
2,4,1,0,5,2,3,0,4,1,2,0,3,1,2,0,4,1,2,0,2,1,1,0
0,1,3,3,20,2,18,12,1,3,0,3,18,1,17,11,1,3,0,3,17,1,16,11
0,2,4,4,23,2,21,18,2,4,0,4,21,2,19,17,2,4,0,4,19,1,18,16
1,2,1,1,23,6,17,5,2,1,1,1,17,5,12,3,2,1,1,1,12,3,9,2
3,0,1,3,12,8,4,2,0,1,3,3,4,2,2,1,0,1,3,3,2,1,1,0
3,2,4,0,22,15,7,0,2,4,3,0,7,4,3,0,2,4,3,0,3,2,1,0
3,4,3,4,10,7,3,2,4,3,3,4,3,2,1,0,4,3,3,4,1,0,1,0
1,2,1,2,8,2,6,3,2,1,1,2,6,1,5,2,2,1,1,2,5,1,4,1
2,4,2,2,5,2,3,1,4,2,2,2,3,1,2,1,4,2,2,2,2,0,2,1
3,3,2,0,19,13,6,0,3,2,3,0,6,4,2,0,3,2,3,0,2,1,1,0
0,0,3,4,27,2,25,22,0,3,0,4,25,2,23,20,0,3,0,4,23,2,21,18
0,2,1,2,12,1,11,5,2,1,0,2,11,1,10,5,2,1,0,2,10,1,9,4
3,2,3,3,19,13,6,4,2,3,3,3,6,4,2,1,2,3,3,3,2,1,1,0
3,2,0,2,5,3,2,1,2,0,3,2,2,1,1,0,2,0,3,2,1,0,1,0
1,4,4,1,18,5,13,3,4,4,1,1,13,3,10,2,4,4,1,1,10,2,8,2
1,4,4,2,5,1,4,2,4,4,1,2,4,1,3,1,4,4,1,2,3,0,3,1
2,3,4,2,7,3,4,2,3,4,2,2,4,1,3,1,3,4,2,2,3,1,2,0
3,4,2,3,6,4,2,1,4,2,3,3,2,1,1,0,4,2,3,3,1,0,1,0
4,4,2,4,6,5,1,0,4,2,4,4,1,0,1,0,4,2,4,4,1,0,1,0
2,4,0,1,8,3,5,1,4,0,2,1,5,2,3,0,4,0,2,1,3,1,2,0
0,1,2,0,24,2,22,2,1,2,0,0,22,2,20,2,1,2,0,0,20,1,19,1
2,1,3,3,21,10,11,7,1,3,2,3,11,5,6,4,1,3,2,3,6,2,4,2
0,0,4,3,26,2,24,16,0,4,0,3,24,2,22,15,0,4,0,3,22,2,20,13
2,4,4,2,7,3,4,2,4,4,2,2,4,2,2,0,4,4,2,2,2,1,1,0
2,1,1,0,9,4,5,0,1,1,2,0,5,2,3,0,1,1,2,0,3,1,2,0
4,1,3,1,16,14,2,0,1,3,4,1,2,1,1,0,1,3,4,1,1,0,1,0
4,0,3,1,20,17,3,0,0,3,4,1,3,2,1,0,0,3,4,1,1,0,1,0
4,2,3,0,16,14,2,0,2,3,4,0,2,1,1,0,2,3,4,0,1,0,1,0
0,1,3,1,23,2,21,6,1,3,0,1,21,2,19,5,1,3,0,1,19,1,18,5
3,2,1,1,6,4,2,0,2,1,3,1,2,1,1,0,2,1,3,1,1,0,1,0
3,0,1,2,16,11,5,2,0,1,3,2,5,3,2,0,0,1,3,2,2,1,1,0
2,4,4,0,13,6,7,0,4,4,2,0,7,3,4,0,4,4,2,0,4,2,2,0
1,0,1,0,17,5,12,1,0,1,1,0,12,3,9,0,0,1,1,0,9,2,7,0
3,4,2,4,6,4,2,1,4,2,3,4,2,1,1,0,4,2,3,4,1,0,1,0
1,1,0,0,9,2,7,0,1,0,1,0,7,2,5,0,1,0,1,0,5,1,4,0
4,1,0,4,3,2,1,0,1,0,4,4,1,0,1,0,1,0,4,4,1,0,1,0
3,4,4,1,6,4,2,0,4,4,3,1,2,1,1,0,4,4,3,1,1,0,1,0
4,2,0,0,7,6,1,0,2,0,4,0,1,0,1,0,2,0,4,0,1,0,1,0
3,1,4,1,29,20,9,2,1,4,3,1,9,6,3,0,1,4,3,1,3,2,1,0
3,0,3,0,26,18,8,0,0,3,3,0,8,5,3,0,0,3,3,0,3,2,1,0
4,3,3,3,21,18,3,2,3,3,4,3,3,2,1,0,3,3,4,3,1,0,1,0
3,0,2,1,22,15,7,2,0,2,3,1,7,4,3,0,0,2,3,1,3,2,1,0
0,4,1,2,2,0,2,1,4,1,0,2,2,0,2,1,4,1,0,2,2,0,2,1
2,4,1,1,8,4,4,1,4,1,2,1,4,1,3,0,4,1,2,1,3,1,2,0
0,2,0,3,18,1,17,11,2,0,0,3,17,1,16,11,2,0,0,3,16,1,15,10
2,1,4,3,26,12,14,9,1,4,2,3,14,7,7,4,1,4,2,3,7,3,4,2
2,1,2,0,29,14,15,1,1,2,2,0,15,7,8,0,1,2,2,0,8,3,5,0
0,1,1,2,12,1,11,5,1,1,0,2,11,1,10,5,1,1,0,2,10,0,10,4
3,1,2,0,16,11,5,0,1,2,3,0,5,3,2,0,1,2,3,0,2,1,1,0
1,2,3,2,22,6,16,7,2,3,1,2,16,4,12,6,2,3,1,2,12,3,9,4
0,3,2,4,3,0,3,2,3,2,0,4,3,0,3,2,3,2,0,4,3,0,3,2
3,4,0,3,2,1,1,0,4,0,3,3,1,0,1,0,4,0,3,3,1,0,1,0
4,4,0,4,1,0,1,0,4,0,4,4,1,0,1,0,4,0,4,4,1,0,1,0
0,0,1,1,17,1,16,4,0,1,0,1,16,1,15,4,0,1,0,1,15,1,14,4
4,1,0,0,7,6,1,0,1,0,4,0,1,0,1,0,1,0,4,0,1,0,1,0
2,3,0,0,0,0,0,0,3,0,2,0,0,0,0,0,3,0,2,0,0,0,0,0
2,0,3,0,23,11,12,1,0,3,2,0,12,5,7,0,0,3,2,0,7,3,4,0
0,3,0,4,6,0,6,5,3,0,0,4,6,0,6,5,3,0,0,4,6,0,6,5
0,2,4,3,25,2,23,16,2,4,0,3,23,2,21,14,2,4,0,3,21,2,19,13
0,1,2,2,15,1,14,7,1,2,0,2,14,1,13,6,1,2,0,2,13,1,12,5
0,3,4,3,6,0,6,4,3,4,0,3,6,0,6,4,3,4,0,3,6,0,6,4
1,1,3,3,22,6,16,11,1,3,1,3,16,4,12,8,1,3,1,3,12,3,9,6
2,0,4,3,27,13,14,9,0,4,2,3,14,6,8,5,0,4,2,3,8,3,5,3
2,0,1,0,12,6,6,0,0,1,2,0,6,2,4,0,0,1,2,0,4,2,2,0
2,1,0,2,3,1,2,1,1,0,2,2,2,0,2,1,1,0,2,2,2,0,2,0
2,3,1,1,7,3,4,1,3,1,2,1,4,1,3,0,3,1,2,1,3,1,2,0
2,0,0,1,6,3,3,0,0,0,2,1,3,1,2,0,0,0,2,1,2,1,1,0
4,3,1,0,14,12,2,0,3,1,4,0,2,1,1,0,3,1,4,0,1,0,1,0
4,0,1,1,15,13,2,0,0,1,4,1,2,1,1,0,0,1,4,1,1,0,1,0
2,3,2,3,7,3,4,2,3,2,2,3,4,2,2,1,3,2,2,3,2,1,1,0
3,3,3,0,16,11,5,0,3,3,3,0,5,3,2,0,3,3,3,0,2,1,1,0
1,2,1,2,3,0,3,1,2,1,1,2,3,0,3,1,2,1,1,2,3,0,3,1
2,0,1,4,16,7,9,8,0,1,2,4,9,4,5,4,0,1,2,4,5,2,3,2
2,2,0,2,1,0,1,0,2,0,2,2,1,0,1,0,2,0,2,2,1,0,1,0
2,1,0,0,0,0,0,0,1,0,2,0,0,0,0,0,1,0,2,0,0,0,0,0
0,3,2,0,0,0,0,0,3,2,0,0,0,0,0,0,3,2,0,0,0,0,0,0
3,2,4,0,13,9,4,0,2,4,3,0,4,2,2,0,2,4,3,0,2,1,1,0
4,1,1,0,11,9,2,0,1,1,4,0,2,1,1,0,1,1,4,0,1,0,1,0
2,0,4,2,29,14,15,7,0,4,2,2,15,7,8,3,0,4,2,2,8,3,5,2
2,0,0,3,6,3,3,2,0,0,2,3,3,1,2,1,0,0,2,3,2,0,2,1
2,4,4,1,9,4,5,1,4,4,2,1,5,2,3,0,4,4,2,1,3,1,2,0
1,4,2,4,3,0,3,2,4,2,1,4,3,0,3,2,4,2,1,4,3,0,3,2
1,4,4,1,6,1,5,1,4,4,1,1,5,1,4,1,4,4,1,1,4,1,3,0
3,3,0,2,7,4,3,1,3,0,3,2,3,2,1,0,3,0,3,2,1,0,1,0
4,4,3,2,17,15,2,0,4,3,4,2,2,1,1,0,4,3,4,2,1,0,1,0
4,2,3,1,9,8,1,0,2,3,4,1,1,0,1,0,2,3,4,1,1,0,1,0
2,4,2,3,5,2,3,2,4,2,2,3,3,1,2,1,4,2,2,3,2,1,1,0
3,0,2,4,20,14,6,5,0,2,3,4,6,4,2,1,0,2,3,4,2,1,1,0
1,1,4,4,26,7,19,17,1,4,1,4,19,5,14,12,1,4,1,4,14,4,10,9
1,2,1,1,3,0,3,0,2,1,1,1,3,0,3,0,2,1,1,1,3,0,3,0
0,3,3,4,9,0,9,8,3,3,0,4,9,0,9,8,3,3,0,4,9,0,9,8
2,4,2,3,9,4,5,3,4,2,2,3,5,2,3,2,4,2,2,3,3,1,2,1
2,1,1,2,11,5,6,3,1,1,2,2,6,2,4,2,1,1,2,2,4,1,3,1
4,0,0,4,5,4,1,0,0,0,4,4,1,0,1,0,0,0,4,4,1,0,1,0
0,3,2,4,12,1,11,9,3,2,0,4,11,1,10,8,3,2,0,4,10,1,9,8
4,2,1,4,5,4,1,0,2,1,4,4,1,0,1,0,2,1,4,4,1,0,1,0
4,3,1,3,6,5,1,0,3,1,4,3,1,0,1,0,3,1,4,3,1,0,1,0
2,3,3,2,21,10,11,5,3,3,2,2,11,5,6,3,3,3,2,2,6,3,3,1
2,4,1,0,3,1,2,0,4,1,2,0,2,1,1,0,4,1,2,0,1,0,1,0
3,3,4,0,13,9,4,0,3,4,3,0,4,2,2,0,3,4,3,0,2,1,1,0
2,0,0,4,15,7,8,7,0,0,2,4,8,4,4,3,0,0,2,4,4,1,3,2
4,3,1,4,13,11,2,1,3,1,4,4,2,1,1,0,3,1,4,4,1,0,1,0
0,2,4,2,26,2,24,11,2,4,0,2,24,2,22,11,2,4,0,2,22,2,20,10
1,1,4,0,26,7,19,1,1,4,1,0,19,5,14,1,1,4,1,0,14,4,10,1
4,2,3,3,19,17,2,1,2,3,4,3,2,1,1,0,2,3,4,3,1,0,1,0
1,0,3,0,21,6,15,1,0,3,1,0,15,4,11,1,0,3,1,0,11,3,8,0
4,3,4,0,3,2,1,0,3,4,4,0,1,0,1,0,3,4,4,0,1,0,1,0
4,0,0,2,2,1,1,0,0,0,4,2,1,0,1,0,0,0,4,2,1,0,1,0
1,0,0,1,6,1,5,1,0,0,1,1,5,1,4,1,0,0,1,1,4,1,3,0
3,3,1,1,1,0,1,0,3,1,3,1,1,0,1,0,3,1,3,1,1,0,1,0
0,1,3,4,21,2,19,17,1,3,0,4,19,1,18,16,1,3,0,4,18,1,17,15
2,0,3,3,28,14,14,9,0,3,2,3,14,6,8,5,0,3,2,3,8,3,5,3
4,1,3,1,18,16,2,0,1,3,4,1,2,1,1,0,1,3,4,1,1,0,1,0
3,4,2,2,3,2,1,0,4,2,3,2,1,0,1,0,4,2,3,2,1,0,1,0
1,4,2,2,4,1,3,1,4,2,1,2,3,0,3,1,4,2,1,2,3,0,3,1
0,1,3,3,24,2,22,15,1,3,0,3,22,2,20,14,1,3,0,3,20,2,18,12
0,2,1,3,15,1,14,9,2,1,0,3,14,1,13,9,2,1,0,3,13,1,12,8
4,3,0,3,14,12,2,1,3,0,4,3,2,1,1,0,3,0,4,3,1,0,1,0
3,4,0,3,4,2,2,1,4,0,3,3,2,1,1,0,4,0,3,3,1,0,1,0
2,1,4,4,26,12,14,12,1,4,2,4,14,7,7,6,1,4,2,4,7,3,4,3
1,2,2,0,10,2,8,0,2,2,1,0,8,2,6,0,2,2,1,0,6,1,5,0
0,1,3,4,26,2,24,21,1,3,0,4,24,2,22,19,1,3,0,4,22,2,20,17
2,1,0,4,15,7,8,7,1,0,2,4,8,4,4,3,1,0,2,4,4,2,2,1
2,0,2,1,22,10,12,3,0,2,2,1,12,5,7,2,0,2,2,1,7,3,4,1
3,2,2,2,14,9,5,2,2,2,3,2,5,3,2,1,2,2,3,2,2,1,1,0
0,0,3,3,29,2,27,18,0,3,0,3,27,2,25,17,0,3,0,3,25,2,23,16
4,1,2,2,15,13,2,0,1,2,4,2,2,1,1,0,1,2,4,2,1,0,1,0
4,4,1,3,1,0,1,0,4,1,4,3,1,0,1,0,4,1,4,3,1,0,1,0
2,3,4,0,10,4,6,0,3,4,2,0,6,2,4,0,3,4,2,0,4,2,2,0
0,2,4,1,27,2,25,7,2,4,0,1,25,2,23,6,2,4,0,1,23,2,21,6
0,1,4,2,26,2,24,12,1,4,0,2,24,2,22,11,1,4,0,2,22,2,20,10
3,4,3,1,2,1,1,0,4,3,3,1,1,0,1,0,4,3,3,1,1,0,1,0
2,3,0,2,6,2,4,2,3,0,2,2,4,1,3,1,3,0,2,2,3,1,2,1
4,1,3,2,17,15,2,1,1,3,4,2,2,1,1,0,1,3,4,2,1,0,1,0
2,3,1,4,9,4,5,4,3,1,2,4,5,2,3,2,3,1,2,4,3,1,2,1
3,3,1,3,8,5,3,2,3,1,3,3,3,2,1,0,3,1,3,3,1,0,1,0
0,2,1,2,4,0,4,1,2,1,0,2,4,0,4,2,2,1,0,2,4,0,4,2
3,3,1,0,3,2,1,0,3,1,3,0,1,0,1,0,3,1,3,0,1,0,1,0
2,1,1,1,9,4,5,1,1,1,2,1,5,2,3,0,1,1,2,1,3,1,2,0
0,0,2,1,18,1,17,5,0,2,0,1,17,1,16,4,0,2,0,1,16,1,15,4
1,0,1,3,10,2,8,5,0,1,1,3,8,2,6,4,0,1,1,3,6,1,5,3
3,0,2,1,20,14,6,1,0,2,3,1,6,4,2,0,0,2,3,1,2,1,1,0
1,4,1,4,14,4,10,9,4,1,1,4,10,2,8,7,4,1,1,4,8,2,6,5
4,3,3,1,9,8,1,0,3,3,4,1,1,0,1,0,3,3,4,1,1,0,1,0
3,0,1,2,14,9,5,2,0,1,3,2,5,3,2,1,0,1,3,2,2,1,1,0
0,3,4,2,8,0,8,4,3,4,0,2,8,0,8,4,3,4,0,2,8,0,8,3
3,1,3,4,29,20,9,8,1,3,3,4,9,6,3,2,1,3,3,4,3,2,1,0
4,0,1,2,20,17,3,1,0,1,4,2,3,2,1,0,0,1,4,2,1,0,1,0
2,1,1,0,16,8,8,0,1,1,2,0,8,4,4,0,1,1,2,0,4,1,3,0
2,2,4,2,23,11,12,6,2,4,2,2,12,5,7,3,2,4,2,2,7,3,4,2
1,3,1,0,9,2,7,0,3,1,1,0,7,2,5,0,3,1,1,0,5,1,4,0
3,2,2,2,10,6,4,1,2,2,3,2,4,2,2,1,2,2,3,2,2,1,1,0
3,4,2,0,11,7,4,0,4,2,3,0,4,2,2,0,4,2,3,0,2,1,1,0
1,1,4,2,24,7,17,8,1,4,1,2,17,5,12,6,1,4,1,2,12,3,9,4
1,0,4,0,28,8,20,1,0,4,1,0,20,5,15,1,0,4,1,0,15,4,11,1
4,1,4,4,24,21,3,2,1,4,4,4,3,2,1,0,1,4,4,4,1,0,1,0
2,1,3,0,23,11,12,1,1,3,2,0,12,6,6,0,1,3,2,0,6,3,3,0
1,3,1,0,7,2,5,0,3,1,1,0,5,1,4,0,3,1,1,0,4,1,3,0
0,3,4,4,16,1,15,13,3,4,0,4,15,1,14,12,3,4,0,4,14,1,13,11
0,4,4,4,10,1,9,8,4,4,0,4,9,0,9,8,4,4,0,4,9,0,9,8
2,4,3,0,7,3,4,0,4,3,2,0,4,2,2,0,4,3,2,0,2,0,2,0
3,0,0,0,11,7,4,0,0,0,3,0,4,2,2,0,0,0,3,0,2,1,1,0
3,2,3,4,16,11,5,4,2,3,3,4,5,3,2,1,2,3,3,4,2,1,1,0
3,0,1,1,14,9,5,1,0,1,3,1,5,3,2,0,0,1,3,1,2,1,1,0
3,3,1,0,3,2,1,0,3,1,3,0,1,0,1,0,3,1,3,0,1,0,1,0
2,0,1,2,13,6,7,3,0,1,2,2,7,3,4,1,0,1,2,2,4,1,3,1
0,2,1,0,5,0,5,0,2,1,0,0,5,0,5,0,2,1,0,0,5,0,5,0
4,0,2,2,21,18,3,1,0,2,4,2,3,2,1,0,0,2,4,2,1,0,1,0
0,2,0,3,6,0,6,4,2,0,0,3,6,0,6,4,2,0,0,3,6,0,6,4
2,2,2,0,10,4,6,0,2,2,2,0,6,3,3,0,2,2,2,0,3,1,2,0
4,0,1,4,5,4,1,0,0,1,4,4,1,0,1,0,0,1,4,4,1,0,1,0
1,3,3,0,1,0,1,0,3,3,1,0,1,0,1,0,3,3,1,0,1,0,1,0
2,0,3,1,27,13,14,4,0,3,2,1,14,7,7,2,0,3,2,1,7,3,4,1
3,3,4,0,20,13,7,0,3,4,3,0,7,4,3,0,3,4,3,0,3,2,1,0
3,0,3,2,18,12,6,3,0,3,3,2,6,4,2,1,0,3,3,2,2,1,1,0
0,1,2,4,17,1,16,14,1,2,0,4,16,1,15,13,1,2,0,4,15,1,14,12
0,4,4,1,3,0,3,0,4,4,0,1,3,0,3,0,4,4,0,1,3,0,3,0
3,4,3,4,12,8,4,3,4,3,3,4,4,2,2,1,4,3,3,4,2,1,1,0
1,1,0,4,15,4,11,9,1,0,1,4,11,3,8,7,1,0,1,4,8,2,6,5
1,1,0,2,8,2,6,2,1,0,1,2,6,1,5,2,1,0,1,2,5,1,4,2
2,0,1,1,17,8,9,2,0,1,2,1,9,4,5,1,0,1,2,1,5,2,3,0
3,2,2,0,12,8,4,0,2,2,3,0,4,2,2,0,2,2,3,0,2,1,1,0
2,2,4,0,14,6,8,0,2,4,2,0,8,4,4,0,2,4,2,0,4,2,2,0
4,2,0,3,4,3,1,0,2,0,4,3,1,0,1,0,2,0,4,3,1,0,1,0
0,3,4,2,15,1,14,6,3,4,0,2,14,1,13,6,3,4,0,2,13,1,12,6
1,4,1,2,6,1,5,2,4,1,1,2,5,1,4,2,4,1,1,2,4,1,3,1
4,4,2,0,1,0,1,0,4,2,4,0,1,0,1,0,4,2,4,0,1,0,1,0
1,2,3,3,15,4,11,7,2,3,1,3,11,3,8,5,2,3,1,3,8,2,6,4
4,3,3,2,11,9,2,0,3,3,4,2,2,1,1,0,3,3,4,2,1,0,1,0
3,3,1,3,3,2,1,0,3,1,3,3,1,0,1,0,3,1,3,3,1,0,1,0
1,4,1,3,5,1,4,2,4,1,1,3,4,1,3,2,4,1,1,3,3,0,3,2
1,3,0,4,2,0,2,1,3,0,1,4,2,0,2,1,3,0,1,4,2,0,2,1
0,2,1,1,5,0,5,1,2,1,0,1,5,0,5,1,2,1,0,1,5,0,5,1
1,3,2,2,8,2,6,2,3,2,1,2,6,1,5,2,3,2,1,2,5,1,4,2
1,4,1,3,3,0,3,2,4,1,1,3,3,0,3,2,4,1,1,3,3,0,3,2
1,3,2,2,5,1,4,1,3,2,1,2,4,1,3,1,3,2,1,2,3,0,3,1
0,4,3,3,1,0,1,0,4,3,0,3,1,0,1,0,4,3,0,3,1,0,1,0
4,3,0,2,7,6,1,0,3,0,4,2,1,0,1,0,3,0,4,2,1,0,1,0
0,1,2,2,24,2,22,10,1,2,0,2,22,2,20,10,1,2,0,2,20,2,18,9
3,3,3,1,11,7,4,1,3,3,3,1,4,2,2,0,3,3,3,1,2,1,1,0
3,2,0,4,3,2,1,0,2,0,3,4,1,0,1,0,2,0,3,4,1,0,1,0
3,0,4,4,28,19,9,8,0,4,3,4,9,6,3,2,0,4,3,4,3,2,1,0
1,2,3,0,18,5,13,1,2,3,1,0,13,3,10,1,2,3,1,0,10,3,7,0
1,4,3,2,6,1,5,2,4,3,1,2,5,1,4,2,4,3,1,2,4,1,3,1
4,4,3,4,3,2,1,0,4,3,4,4,1,0,1,0,4,3,4,4,1,0,1,0
1,3,2,4,16,4,12,10,3,2,1,4,12,3,9,8,3,2,1,4,9,2,7,6
3,3,1,2,6,4,2,1,3,1,3,2,2,1,1,0,3,1,3,2,1,0,1,0
1,4,4,2,16,4,12,6,4,4,1,2,12,3,9,4,4,4,1,2,9,2,7,3
0,0,3,3,19,1,18,12,0,3,0,3,18,1,17,11,0,3,0,3,17,1,16,11
3,0,0,3,7,4,3,2,0,0,3,3,3,2,1,0,0,0,3,3,1,0,1,0
4,2,4,0,21,18,3,0,2,4,4,0,3,2,1,0,2,4,4,0,1,0,1,0
0,0,3,1,25,2,23,6,0,3,0,1,23,2,21,6,0,3,0,1,21,2,19,5
3,2,0,4,15,10,5,4,2,0,3,4,5,3,2,1,2,0,3,4,2,1,1,0
4,1,3,1,22,19,3,0,1,3,4,1,3,2,1,0,1,3,4,1,1,0,1,0
1,3,2,0,5,1,4,0,3,2,1,0,4,1,3,0,3,2,1,0,3,0,3,0
1,3,0,4,10,2,8,7,3,0,1,4,8,2,6,5,3,0,1,4,6,1,5,4
1,2,3,3,18,5,13,9,2,3,1,3,13,3,10,6,2,3,1,3,10,3,7,4
4,2,0,4,6,5,1,0,2,0,4,4,1,0,1,0,2,0,4,4,1,0,1,0
3,1,0,2,6,4,2,0,1,0,3,2,2,1,1,0,1,0,3,2,1,0,1,0
3,4,3,4,3,2,1,0,4,3,3,4,1,0,1,0,4,3,3,4,1,0,1,0
4,4,1,3,2,1,1,0,4,1,4,3,1,0,1,0,4,1,4,3,1,0,1,0
0,2,4,0,26,2,24,2,2,4,0,0,24,2,22,2,2,4,0,0,22,2,20,1
4,0,1,2,22,19,3,1,0,1,4,2,3,2,1,0,0,1,4,2,1,0,1,0
1,0,2,3,18,5,13,9,0,2,1,3,13,3,10,6,0,2,1,3,10,3,7,4
0,2,1,2,15,1,14,7,2,1,0,2,14,1,13,6,2,1,0,2,13,1,12,5
3,1,3,3,22,15,7,4,1,3,3,3,7,4,3,2,1,3,3,3,3,2,1,0
0,1,1,4,12,1,11,9,1,1,0,4,11,1,10,8,1,1,0,4,10,0,10,9
1,3,3,4,11,3,8,7,3,3,1,4,8,2,6,5,3,3,1,4,6,1,5,4
3,4,4,3,7,4,3,2,4,4,3,3,3,2,1,0,4,4,3,3,1,0,1,0
1,2,4,2,18,5,13,6,2,4,1,2,13,3,10,4,2,4,1,2,10,3,7,3
2,4,4,1,14,6,8,2,4,4,2,1,8,4,4,1,4,4,2,1,4,1,3,0
1,4,1,1,1,0,1,0,4,1,1,1,1,0,1,0,4,1,1,1,1,0,1,0
3,0,3,0,28,19,9,0,0,3,3,0,9,6,3,0,0,3,3,0,3,2,1,0
0,0,0,2,4,0,4,1,0,0,0,2,4,0,4,1,0,0,0,2,4,0,4,2
2,1,1,1,21,10,11,3,1,1,2,1,11,5,6,1,1,1,2,1,6,3,3,0
2,0,0,4,1,0,1,0,0,0,2,4,1,0,1,0,0,0,2,4,1,0,1,0
1,4,3,3,4,1,3,2,4,3,1,3,3,0,3,2,4,3,1,3,3,0,3,2
4,3,1,4,8,7,1,0,3,1,4,4,1,0,1,0,3,1,4,4,1,0,1,0
2,0,0,3,6,3,3,2,0,0,2,3,3,1,2,1,0,0,2,3,2,1,1,0
1,0,2,3,18,5,13,9,0,2,1,3,13,3,10,6,0,2,1,3,10,3,7,4
4,3,3,0,12,10,2,0,3,3,4,0,2,1,1,0,3,3,4,0,1,0,1,0
2,1,2,3,20,9,11,7,1,2,2,3,11,5,6,4,1,2,2,3,6,3,3,2
0,2,0,0,6,0,6,0,2,0,0,0,6,0,6,0,2,0,0,0,6,0,6,0
1,1,2,4,20,5,15,13,1,2,1,4,15,4,11,9,1,2,1,4,11,3,8,7
0,2,2,4,21,2,19,17,2,2,0,4,19,1,18,16,2,2,0,4,18,1,17,15
3,4,3,1,8,5,3,0,4,3,3,1,3,2,1,0,4,3,3,1,1,0,1,0
4,2,2,2,10,9,1,0,2,2,4,2,1,0,1,0,2,2,4,2,1,0,1,0
4,1,0,3,4,3,1,0,1,0,4,3,1,0,1,0,1,0,4,3,1,0,1,0
0,0,4,0,26,2,24,2,0,4,0,0,24,2,22,2,0,4,0,0,22,2,20,2
0,0,3,3,29,2,27,18,0,3,0,3,27,2,25,17,0,3,0,3,25,2,23,16
0,0,2,2,29,2,27,13,0,2,0,2,27,2,25,12,0,2,0,2,25,2,23,11
0,2,3,0,16,1,15,1,2,3,0,0,15,1,14,1,2,3,0,0,14,1,13,1
3,2,1,3,9,6,3,2,2,1,3,3,3,2,1,0,2,1,3,3,1,0,1,0
4,3,2,3,6,5,1,0,3,2,4,3,1,0,1,0,3,2,4,3,1,0,1,0
4,3,3,3,8,7,1,0,3,3,4,3,1,0,1,0,3,3,4,3,1,0,1,0
2,3,1,2,4,1,3,1,3,1,2,2,3,1,2,1,3,1,2,2,2,1,1,0
2,4,4,1,8,3,5,1,4,4,2,1,5,2,3,0,4,4,2,1,3,1,2,0
3,2,3,2,13,9,4,1,2,3,3,2,4,2,2,1,2,3,3,2,2,1,1,0
1,4,1,0,5,1,4,0,4,1,1,0,4,1,3,0,4,1,1,0,3,0,3,0
1,2,2,4,12,3,9,8,2,2,1,4,9,2,7,6,2,2,1,4,7,2,5,4
4,1,4,4,26,23,3,2,1,4,4,4,3,2,1,0,1,4,4,4,1,0,1,0
2,1,1,4,9,4,5,4,1,1,2,4,5,2,3,2,1,1,2,4,3,1,2,1
4,3,0,3,5,4,1,0,3,0,4,3,1,0,1,0,3,0,4,3,1,0,1,0
1,4,4,1,9,2,7,2,4,4,1,1,7,2,5,1,4,4,1,1,5,1,4,1
4,4,3,0,14,12,2,0,4,3,4,0,2,1,1,0,4,3,4,0,1,0,1,0
4,4,2,3,1,0,1,0,4,2,4,3,1,0,1,0,4,2,4,3,1,0,1,0
1,3,2,3,12,3,9,6,3,2,1,3,9,2,7,4,3,2,1,3,7,2,5,3
4,1,2,3,17,15,2,1,1,2,4,3,2,1,1,0,1,2,4,3,1,0,1,0
1,3,1,3,5,1,4,2,3,1,1,3,4,1,3,2,3,1,1,3,3,0,3,2
2,4,4,2,1,0,1,0,4,4,2,2,1,0,1,0,4,4,2,2,1,0,1,0
0,2,1,1,6,0,6,1,2,1,0,1,6,0,6,1,2,1,0,1,6,0,6,1
1,2,2,3,16,4,12,8,2,2,1,3,12,3,9,6,2,2,1,3,9,2,7,4
4,4,0,0,10,9,1,0,4,0,4,0,1,0,1,0,4,0,4,0,1,0,1,0
1,3,1,2,11,3,8,3,3,1,1,2,8,2,6,3,3,1,1,2,6,1,5,2
2,0,2,0,16,8,8,0,0,2,2,0,8,4,4,0,0,2,2,0,4,2,2,0
1,0,0,1,2,0,2,0,0,0,1,1,2,0,2,0,0,0,1,1,2,0,2,0
4,2,1,3,2,1,1,0,2,1,4,3,1,0,1,0,2,1,4,3,1,0,1,0
0,4,2,2,11,1,10,4,4,2,0,2,10,0,10,4,4,2,0,2,10,1,9,4
4,0,1,1,12,10,2,0,0,1,4,1,2,1,1,0,0,1,4,1,1,0,1,0
4,1,0,3,4,3,1,0,1,0,4,3,1,0,1,0,1,0,4,3,1,0,1,0
0,2,0,0,0,0,0,0,2,0,0,0,0,0,0,0,2,0,0,0,0,0,0,0
0,3,2,0,17,1,16,1,3,2,0,0,16,1,15,1,3,2,0,0,15,1,14,1
1,1,2,1,16,4,12,3,1,2,1,1,12,3,9,2,1,2,1,1,9,2,7,2
1,0,0,4,5,1,4,3,0,0,1,4,4,1,3,2,0,0,1,4,3,0,3,2
3,0,0,3,6,4,2,1,0,0,3,3,2,1,1,0,0,0,3,3,1,0,1,0
3,1,0,3,8,5,3,2,1,0,3,3,3,2,1,0,1,0,3,3,1,0,1,0
3,3,0,2,3,2,1,0,3,0,3,2,1,0,1,0,3,0,3,2,1,0,1,0
2,2,3,1,18,8,10,2,2,3,2,1,10,4,6,1,2,3,2,1,6,2,4,1
3,2,1,2,12,8,4,2,2,1,3,2,4,2,2,0,2,1,3,2,2,1,1,0
2,1,4,2,20,9,11,5,1,4,2,2,11,5,6,2,1,4,2,2,6,3,3,1
1,2,4,4,18,5,13,11,2,4,1,4,13,3,10,8,2,4,1,4,10,3,7,6
0,1,1,3,7,0,7,4,1,1,0,3,7,0,7,4,1,1,0,3,7,0,7,4
3,1,4,1,28,19,9,2,1,4,3,1,9,6,3,0,1,4,3,1,3,2,1,0
0,1,1,1,17,1,16,4,1,1,0,1,16,1,15,4,1,1,0,1,15,1,14,4
4,4,1,1,5,4,1,0,4,1,4,1,1,0,1,0,4,1,4,1,1,0,1,0
1,0,0,1,12,3,9,2,0,0,1,1,9,2,7,2,0,0,1,1,7,2,5,1
3,2,2,3,12,8,4,2,2,2,3,3,4,2,2,1,2,2,3,3,2,1,1,0
3,2,0,1,0,0,0,0,2,0,3,1,0,0,0,0,2,0,3,1,0,0,0,0
0,0,0,4,3,0,3,2,0,0,0,4,3,0,3,2,0,0,0,4,3,0,3,2
0,1,1,2,10,0,10,5,1,1,0,2,10,0,10,4,1,1,0,2,10,1,9,4
1,2,4,1,22,6,16,4,2,4,1,1,16,4,12,3,2,4,1,1,12,3,9,2
4,0,0,3,12,10,2,1,0,0,4,3,2,1,1,0,0,0,4,3,1,0,1,0
0,2,1,2,6,0,6,2,2,1,0,2,6,0,6,2,2,1,0,2,6,0,6,3
3,2,1,0,4,2,2,0,2,1,3,0,2,1,1,0,2,1,3,0,1,0,1,0
3,1,4,4,26,18,8,7,1,4,3,4,8,5,3,2,1,4,3,4,3,2,1,0
2,4,3,0,3,1,2,0,4,3,2,0,2,1,1,0,4,3,2,0,1,0,1,0
2,2,3,4,20,9,11,9,2,3,2,4,11,5,6,5,2,3,2,4,6,2,4,3
4,1,4,2,22,19,3,1,1,4,4,2,3,2,1,0,1,4,4,2,1,0,1,0
3,2,2,2,8,5,3,1,2,2,3,2,3,2,1,0,2,2,3,2,1,0,1,0
2,3,0,3,2,1,1,0,3,0,2,3,1,0,1,0,3,0,2,3,1,0,1,0
0,1,4,2,20,1,19,9,1,4,0,2,19,1,18,8,1,4,0,2,18,1,17,8
0,1,4,3,27,2,25,17,1,4,0,3,25,2,23,16,1,4,0,3,23,2,21,14
1,1,4,1,26,7,19,5,1,4,1,1,19,5,14,4,1,4,1,1,14,4,10,3
3,1,3,2,18,12,6,3,1,3,3,2,6,4,2,0,1,3,3,2,2,1,1,0
0,1,4,0,29,2,27,2,1,4,0,0,27,2,25,2,1,4,0,0,25,2,23,2
2,2,4,0,24,12,12,1,2,4,2,0,12,6,6,0,2,4,2,0,6,3,3,0
0,2,1,1,6,0,6,1,2,1,0,1,6,0,6,1,2,1,0,1,6,0,6,1
0,1,1,3,16,1,15,10,1,1,0,3,15,1,14,9,1,1,0,3,14,1,13,9
2,2,3,0,18,8,10,0,2,3,2,0,10,4,6,0,2,3,2,0,6,2,4,0
2,1,3,1,23,11,12,3,1,3,2,1,12,6,6,1,1,3,2,1,6,3,3,0
3,4,1,1,0,0,0,0,4,1,3,1,0,0,0,0,4,1,3,1,0,0,0,0
0,2,4,1,20,1,19,5,2,4,0,1,19,1,18,5,2,4,0,1,18,1,17,5
1,1,4,2,29,8,21,10,1,4,1,2,21,6,15,7,1,4,1,2,15,4,11,5
2,4,2,0,6,2,4,0,4,2,2,0,4,2,2,0,4,2,2,0,2,0,2,0
0,1,3,2,27,2,25,12,1,3,0,2,25,2,23,11,1,3,0,2,23,2,21,10
4,1,0,0,11,9,2,0,1,0,4,0,2,1,1,0,1,0,4,0,1,0,1,0
0,3,1,3,1,0,1,0,3,1,0,3,1,0,1,0,3,1,0,3,1,0,1,0
4,0,2,0,13,11,2,0,0,2,4,0,2,1,1,0,0,2,4,0,1,0,1,0
0,2,0,0,3,0,3,0,2,0,0,0,3,0,3,0,2,0,0,0,3,0,3,0
3,3,3,4,9,6,3,2,3,3,3,4,3,2,1,0,3,3,3,4,1,0,1,0
1,2,3,3,19,5,14,9,2,3,1,3,14,4,10,6,2,3,1,3,10,3,7,4
1,2,2,0,12,3,9,0,2,2,1,0,9,2,7,0,2,2,1,0,7,2,5,0
1,0,2,4,18,5,13,11,0,2,1,4,13,3,10,8,0,2,1,4,10,3,7,6
1,3,0,2,0,0,0,0,3,0,1,2,0,0,0,0,3,0,1,2,0,0,0,0
3,1,1,0,4,2,2,0,1,1,3,0,2,1,1,0,1,1,3,0,1,0,1,0
0,2,0,0,3,0,3,0,2,0,0,0,3,0,3,0,2,0,0,0,3,0,3,0
2,3,0,3,9,4,5,3,3,0,2,3,5,2,3,2,3,0,2,3,3,1,2,1
3,4,2,4,0,0,0,0,4,2,3,4,0,0,0,0,4,2,3,4,0,0,0,0
1,2,4,4,28,8,20,17,2,4,1,4,20,6,14,12,2,4,1,4,14,4,10,8
3,1,4,4,29,20,9,8,1,4,3,4,9,6,3,2,1,4,3,4,3,2,1,0
0,0,0,1,4,0,4,1,0,0,0,1,4,0,4,1,0,0,0,1,4,0,4,1
4,0,0,4,6,5,1,0,0,0,4,4,1,0,1,0,0,0,4,4,1,0,1,0
4,0,1,0,8,7,1,0,0,1,4,0,1,0,1,0,0,1,4,0,1,0,1,0
1,4,3,1,3,0,3,0,4,3,1,1,3,0,3,0,4,3,1,1,3,0,3,0
2,1,3,4,26,12,14,12,1,3,2,4,14,7,7,6,1,3,2,4,7,3,4,3
4,1,3,1,15,13,2,0,1,3,4,1,2,1,1,0,1,3,4,1,1,0,1,0
3,1,4,3,27,18,9,6,1,4,3,3,9,6,3,2,1,4,3,3,3,2,1,0
0,2,0,0,8,0,8,0,2,0,0,0,8,0,8,0,2,0,0,0,8,0,8,0
0,1,4,2,25,2,23,11,1,4,0,2,23,2,21,10,1,4,0,2,21,2,19,9
1,4,0,1,11,3,8,2,4,0,1,1,8,2,6,1,4,0,1,1,6,1,5,1
3,0,2,3,26,18,8,5,0,2,3,3,8,5,3,2,0,2,3,3,3,2,1,0
3,4,1,1,3,2,1,0,4,1,3,1,1,0,1,0,4,1,3,1,1,0,1,0
4,2,4,3,15,13,2,1,2,4,4,3,2,1,1,0,2,4,4,3,1,0,1,0
1,0,4,4,24,7,17,15,0,4,1,4,17,5,12,10,0,4,1,4,12,3,9,8
3,3,2,1,5,3,2,0,3,2,3,1,2,1,1,0,3,2,3,1,1,0,1,0
4,2,3,3,13,11,2,1,2,3,4,3,2,1,1,0,2,3,4,3,1,0,1,0
0,3,0,4,5,0,5,4,3,0,0,4,5,0,5,4,3,0,0,4,5,0,5,4
1,3,1,4,1,0,1,0,3,1,1,4,1,0,1,0,3,1,1,4,1,0,1,0
2,4,3,1,8,4,4,1,4,3,2,1,4,2,2,0,4,3,2,1,2,0,2,0
3,4,0,3,3,2,1,0,4,0,3,3,1,0,1,0,4,0,3,3,1,0,1,0
3,2,2,4,19,13,6,5,2,2,3,4,6,4,2,1,2,2,3,4,2,1,1,0
1,3,4,4,15,4,11,9,3,4,1,4,11,3,8,7,3,4,1,4,8,2,6,5
3,1,2,2,18,12,6,3,1,2,3,2,6,4,2,0,1,2,3,2,2,1,1,0
4,1,0,1,11,9,2,0,1,0,4,1,2,1,1,0,1,0,4,1,1,0,1,0
1,0,0,4,1,0,1,0,0,0,1,4,1,0,1,0,0,0,1,4,1,0,1,0
3,1,0,0,6,4,2,0,1,0,3,0,2,1,1,0,1,0,3,0,1,0,1,0
4,0,0,3,3,2,1,0,0,0,4,3,1,0,1,0,0,0,4,3,1,0,1,0
4,1,4,1,20,17,3,0,1,4,4,1,3,2,1,0,1,4,4,1,1,0,1,0
0,0,3,0,29,2,27,2,0,3,0,0,27,2,25,2,0,3,0,0,25,2,23,2
4,2,1,4,17,15,2,1,2,1,4,4,2,1,1,0,2,1,4,4,1,0,1,0
0,3,3,0,16,1,15,1,3,3,0,0,15,1,14,1,3,3,0,0,14,1,13,1
2,2,4,4,26,12,14,12,2,4,2,4,14,7,7,6,2,4,2,4,7,3,4,3
4,4,4,1,14,12,2,0,4,4,4,1,2,1,1,0,4,4,4,1,1,0,1,0
3,1,4,3,26,18,8,5,1,4,3,3,8,5,3,2,1,4,3,3,3,2,1,0
2,1,2,2,27,13,14,6,1,2,2,2,14,7,7,3,1,2,2,2,7,3,4,2
1,3,3,4,8,2,6,5,3,3,1,4,6,1,5,4,3,3,1,4,5,1,4,3
1,3,0,1,2,0,2,0,3,0,1,1,2,0,2,0,3,0,1,1,2,0,2,0
0,4,1,3,3,0,3,2,4,1,0,3,3,0,3,2,4,1,0,3,3,0,3,2
2,1,1,0,11,5,6,0,1,1,2,0,6,2,4,0,1,1,2,0,4,2,2,0
0,0,2,0,26,2,24,2,0,2,0,0,24,2,22,2,0,2,0,0,22,2,20,1
1,1,3,2,24,7,17,8,1,3,1,2,17,5,12,5,1,3,1,2,12,3,9,4
1,0,2,2,20,5,15,7,0,2,1,2,15,4,11,5,0,2,1,2,11,3,8,4
1,3,0,2,5,1,4,2,3,0,1,2,4,1,3,1,3,0,1,2,3,0,3,1
2,0,4,0,25,12,13,1,0,4,2,0,13,6,7,0,0,4,2,0,7,3,4,0
0,1,0,0,5,0,5,0,1,0,0,0,5,0,5,0,1,0,0,0,5,0,5,0
1,3,4,2,6,1,5,2,3,4,1,2,5,1,4,2,3,4,1,2,4,1,3,1
0,0,1,4,18,1,17,15,0,1,0,4,17,1,16,14,0,1,0,4,16,1,15,13
4,1,0,0,8,7,1,0,1,0,4,0,1,0,1,0,1,0,4,0,1,0,1,0
1,0,2,0,29,8,21,2,0,2,1,0,21,6,15,1,0,2,1,0,15,4,11,1
1,1,3,2,21,6,15,7,1,3,1,2,15,4,11,5,1,3,1,2,11,3,8,3
4,3,2,4,8,7,1,0,3,2,4,4,1,0,1,0,3,2,4,4,1,0,1,0
0,0,2,0,23,2,21,2,0,2,0,0,21,2,19,1,0,2,0,0,19,1,18,1
4,3,2,0,14,12,2,0,3,2,4,0,2,1,1,0,3,2,4,0,1,0,1,0
1,1,2,2,16,4,12,6,1,2,1,2,12,3,9,4,1,2,1,2,9,2,7,3
4,1,3,4,22,19,3,2,1,3,4,4,3,2,1,0,1,3,4,4,1,0,1,0
3,0,2,0,13,9,4,0,0,2,3,0,4,2,2,0,0,2,3,0,2,1,1,0
4,0,2,2,29,26,3,1,0,2,4,2,3,2,1,0,0,2,4,2,1,0,1,0
2,0,2,3,22,10,12,8,0,2,2,3,12,5,7,4,0,2,2,3,7,3,4,2
0,2,4,2,17,1,16,8,2,4,0,2,16,1,15,7,2,4,0,2,15,1,14,7
1,3,4,0,16,4,12,1,3,4,1,0,12,3,9,0,3,4,1,0,9,2,7,0
1,2,1,4,2,0,2,1,2,1,1,4,2,0,2,1,2,1,1,4,2,0,2,1
3,1,3,3,25,17,8,5,1,3,3,3,8,5,3,2,1,3,3,3,3,2,1,0
4,2,3,1,21,18,3,0,2,3,4,1,3,2,1,0,2,3,4,1,1,0,1,0
2,0,4,2,29,14,15,7,0,4,2,2,15,7,8,3,0,4,2,2,8,4,4,1
1,2,0,4,1,0,1,0,2,0,1,4,1,0,1,0,2,0,1,4,1,0,1,0
0,2,4,1,29,2,27,8,2,4,0,1,27,2,25,7,2,4,0,1,25,2,23,6
3,3,3,3,17,11,6,4,3,3,3,3,6,4,2,1,3,3,3,3,2,1,1,0
1,0,3,2,25,7,18,9,0,3,1,2,18,5,13,6,0,3,1,2,13,3,10,5
4,3,1,2,9,8,1,0,3,1,4,2,1,0,1,0,3,1,4,2,1,0,1,0
4,1,2,3,20,17,3,2,1,2,4,3,3,2,1,0,1,2,4,3,1,0,1,0
1,0,3,2,27,8,19,9,0,3,1,2,19,5,14,7,0,3,1,2,14,4,10,5
0,0,3,2,28,2,26,13,0,3,0,2,26,2,24,12,0,3,0,2,24,2,22,11
4,1,2,2,17,15,2,1,1,2,4,2,2,1,1,0,1,2,4,2,1,0,1,0
3,3,1,3,6,4,2,1,3,1,3,3,2,1,1,0,3,1,3,3,1,0,1,0
2,3,2,2,6,2,4,2,3,2,2,2,4,1,3,1,3,2,2,2,3,1,2,0
3,3,4,0,17,11,6,0,3,4,3,0,6,4,2,0,3,4,3,0,2,1,1,0
0,4,4,3,12,1,11,7,4,4,0,3,11,1,10,7,4,4,0,3,10,1,9,6
2,0,2,4,19,9,10,8,0,2,2,4,10,4,6,5,0,2,2,4,6,2,4,3
2,2,2,4,17,8,9,8,2,2,2,4,9,4,5,4,2,2,2,4,5,2,3,2
3,1,4,1,22,15,7,2,1,4,3,1,7,4,3,0,1,4,3,1,3,2,1,0
4,4,1,3,4,3,1,0,4,1,4,3,1,0,1,0,4,1,4,3,1,0,1,0
4,1,3,1,22,19,3,0,1,3,4,1,3,2,1,0,1,3,4,1,1,0,1,0
4,1,3,1,27,24,3,0,1,3,4,1,3,2,1,0,1,3,4,1,1,0,1,0
3,4,1,4,4,2,2,1,4,1,3,4,2,1,1,0,4,1,3,4,1,0,1,0
4,2,1,3,11,9,2,1,2,1,4,3,2,1,1,0,2,1,4,3,1,0,1,0
2,4,4,0,16,8,8,0,4,4,2,0,8,3,5,0,4,4,2,0,5,2,3,0
4,2,1,3,10,9,1,0,2,1,4,3,1,0,1,0,2,1,4,3,1,0,1,0
3,4,4,1,15,10,5,1,4,4,3,1,5,3,2,0,4,4,3,1,2,1,1,0
1,3,4,3,21,6,15,10,3,4,1,3,15,4,11,7,3,4,1,3,11,3,8,5
2,1,4,4,28,13,15,13,1,4,2,4,15,7,8,7,1,4,2,4,8,3,5,4
0,4,1,3,7,0,7,4,4,1,0,3,7,0,7,4,4,1,0,3,7,0,7,4
0,3,2,0,4,0,4,0,3,2,0,0,4,0,4,0,3,2,0,0,4,0,4,0
2,4,4,3,8,3,5,3,4,4,2,3,5,2,3,2,4,4,2,3,3,1,2,1
4,4,1,3,1,0,1,0,4,1,4,3,1,0,1,0,4,1,4,3,1,0,1,0
1,2,0,3,0,0,0,0,2,0,1,3,0,0,0,0,2,0,1,3,0,0,0,0
4,4,3,0,14,12,2,0,4,3,4,0,2,1,1,0,4,3,4,0,1,0,1,0
0,4,3,3,6,0,6,4,4,3,0,3,6,0,6,4,4,3,0,3,6,0,6,4
1,4,0,3,4,1,3,2,4,0,1,3,3,0,3,2,4,0,1,3,3,0,3,2
2,3,3,0,4,1,3,0,3,3,2,0,3,1,2,0,3,3,2,0,2,0,2,0
3,4,4,1,6,4,2,0,4,4,3,1,2,1,1,0,4,4,3,1,1,0,1,0
2,2,2,0,17,8,9,0,2,2,2,0,9,4,5,0,2,2,2,0,5,2,3,0
3,1,1,2,9,6,3,1,1,1,3,2,3,2,1,0,1,1,3,2,1,0,1,0
1,1,3,1,23,6,17,5,1,3,1,1,17,5,12,3,1,3,1,1,12,3,9,2
3,2,0,3,11,7,4,2,2,0,3,3,4,2,2,1,2,0,3,3,2,1,1,0
2,2,2,2,14,6,8,3,2,2,2,2,8,3,5,2,2,2,2,2,5,2,3,1
0,4,3,4,1,0,1,0,4,3,0,4,1,0,1,0,4,3,0,4,1,0,1,0
1,0,4,0,29,8,21,2,0,4,1,0,21,6,15,1,0,4,1,0,15,4,11,1
1,3,4,4,18,5,13,11,3,4,1,4,13,3,10,9,3,4,1,4,10,3,7,6
0,0,4,3,28,2,26,18,0,4,0,3,26,2,24,16,0,4,0,3,24,2,22,15
1,4,1,3,11,3,8,5,4,1,1,3,8,2,6,4,4,1,1,3,6,1,5,3
0,2,1,1,14,1,13,3,2,1,0,1,13,1,12,3,2,1,0,1,12,1,11,3
4,3,3,3,17,15,2,1,3,3,4,3,2,1,1,0,3,3,4,3,1,0,1,0
0,4,1,1,11,1,10,3,4,1,0,1,10,1,9,2,4,1,0,1,9,0,9,2
4,4,4,1,19,17,2,0,4,4,4,1,2,1,1,0,4,4,4,1,1,0,1,0
3,3,1,0,12,8,4,0,3,1,3,0,4,2,2,0,3,1,3,0,2,1,1,0
0,2,1,2,8,0,8,3,2,1,0,2,8,0,8,4,2,1,0,2,8,0,8,4
0,0,1,4,13,1,12,10,0,1,0,4,12,1,11,9,0,1,0,4,11,1,10,9
0,2,0,0,9,0,9,0,2,0,0,0,9,0,9,0,2,0,0,0,9,0,9,0
4,4,4,0,1,0,1,0,4,4,4,0,1,0,1,0,4,4,4,0,1,0,1,0
4,4,1,0,12,10,2,0,4,1,4,0,2,1,1,0,4,1,4,0,1,0,1,0
2,0,2,3,22,10,12,8,0,2,2,3,12,5,7,4,0,2,2,3,7,3,4,2
0,0,2,1,24,2,22,6,0,2,0,1,22,2,20,6,0,2,0,1,20,2,18,5
2,2,3,3,15,7,8,5,2,3,2,3,8,4,4,2,2,3,2,3,4,1,3,2
0,1,0,1,6,0,6,1,1,0,0,1,6,0,6,1,1,0,0,1,6,0,6,1
0,3,2,0,7,0,7,0,3,2,0,0,7,0,7,0,3,2,0,0,7,0,7,0
0,0,2,2,20,2,18,9,0,2,0,2,18,1,17,8,0,2,0,2,17,1,16,8
1,0,1,2,14,4,10,5,0,1,1,2,10,3,7,3,0,1,1,2,7,2,5,2
2,0,1,4,13,6,7,6,0,1,2,4,7,3,4,3,0,1,2,4,4,1,3,2
4,0,4,0,28,25,3,0,0,4,4,0,3,2,1,0,0,4,4,0,1,0,1,0
3,1,0,2,7,4,3,1,1,0,3,2,3,2,1,0,1,0,3,2,1,0,1,0
0,1,3,1,21,2,19,5,1,3,0,1,19,1,18,5,1,3,0,1,18,1,17,5
1,0,2,4,22,6,16,14,0,2,1,4,16,4,12,10,0,2,1,4,12,3,9,8
3,0,0,2,7,4,3,1,0,0,3,2,3,2,1,0,0,0,3,2,1,0,1,0
3,2,2,0,16,11,5,0,2,2,3,0,5,3,2,0,2,2,3,0,2,1,1,0
4,0,3,1,23,20,3,0,0,3,4,1,3,2,1,0,0,3,4,1,1,0,1,0
2,2,2,1,19,9,10,2,2,2,2,1,10,5,5,1,2,2,2,1,5,2,3,0
1,0,0,0,15,4,11,1,0,0,1,0,11,3,8,0,0,0,1,0,8,2,6,0
3,4,3,2,15,10,5,2,4,3,3,2,5,3,2,0,4,3,3,2,2,1,1,0
0,3,4,0,14,1,13,1,3,4,0,0,13,1,12,1,3,4,0,0,12,1,11,1
3,2,4,0,25,17,8,0,2,4,3,0,8,5,3,0,2,4,3,0,3,2,1,0
1,3,0,2,4,1,3,1,3,0,1,2,3,0,3,1,3,0,1,2,3,0,3,1
2,4,2,2,3,1,2,0,4,2,2,2,2,1,1,0,4,2,2,2,1,0,1,0
2,1,0,2,11,5,6,2,1,0,2,2,6,2,4,1,1,0,2,2,4,1,3,1
0,4,1,0,3,0,3,0,4,1,0,0,3,0,3,0,4,1,0,0,3,0,3,0
4,1,0,1,5,4,1,0,1,0,4,1,1,0,1,0,1,0,4,1,1,0,1,0
1,4,1,0,3,0,3,0,4,1,1,0,3,0,3,0,4,1,1,0,3,0,3,0
0,0,2,1,22,2,20,6,0,2,0,1,20,2,18,5,0,2,0,1,18,1,17,5
1,3,4,4,13,3,10,9,3,4,1,4,10,3,7,6,3,4,1,4,7,2,5,4
4,2,4,0,25,22,3,0,2,4,4,0,3,2,1,0,2,4,4,0,1,0,1,0
3,3,2,3,11,7,4,2,3,2,3,3,4,2,2,1,3,2,3,3,2,1,1,0
4,4,0,4,10,8,2,1,4,0,4,4,2,1,1,0,4,0,4,4,1,0,1,0
3,2,0,2,8,5,3,1,2,0,3,2,3,2,1,0,2,0,3,2,1,0,1,0
4,3,2,4,11,9,2,1,3,2,4,4,2,1,1,0,3,2,4,4,1,0,1,0
3,1,3,2,26,18,8,3,1,3,3,2,8,5,3,1,1,3,3,2,3,2,1,0
0,3,2,1,8,0,8,2,3,2,0,1,8,0,8,2,3,2,0,1,8,0,8,2
4,2,2,1,13,11,2,0,2,2,4,1,2,1,1,0,2,2,4,1,1,0,1,0
3,4,0,1,5,3,2,0,4,0,3,1,2,1,1,0,4,0,3,1,1,0,1,0
2,0,0,3,8,4,4,2,0,0,2,3,4,2,2,1,0,0,2,3,2,0,2,1
4,2,0,1,4,3,1,0,2,0,4,1,1,0,1,0,2,0,4,1,1,0,1,0
1,4,1,2,9,2,7,3,4,1,1,2,7,2,5,2,4,1,1,2,5,1,4,2
2,1,1,1,13,6,7,2,1,1,2,1,7,3,4,1,1,1,2,1,4,1,3,0
4,2,2,4,16,14,2,1,2,2,4,4,2,1,1,0,2,2,4,4,1,0,1,0
4,0,2,3,21,18,3,2,0,2,4,3,3,2,1,0,0,2,4,3,1,0,1,0
3,0,1,1,11,7,4,1,0,1,3,1,4,2,2,0,0,1,3,1,2,1,1,0
1,0,0,2,11,3,8,3,0,0,1,2,8,2,6,2,0,0,1,2,6,1,5,2
3,0,2,3,15,10,5,3,0,2,3,3,5,3,2,1,0,2,3,3,2,1,1,0
4,3,2,2,16,14,2,1,3,2,4,2,2,1,1,0,3,2,4,2,1,0,1,0
3,0,0,1,4,2,2,0,0,0,3,1,2,1,1,0,0,0,3,1,1,0,1,0
0,0,2,2,25,2,23,11,0,2,0,2,23,2,21,10,0,2,0,2,21,2,19,9
1,3,4,2,8,2,6,3,3,4,1,2,6,1,5,2,3,4,1,2,5,1,4,2
2,1,1,0,7,3,4,0,1,1,2,0,4,2,2,0,1,1,2,0,2,0,2,0
0,3,2,1,13,1,12,3,3,2,0,1,12,1,11,3,3,2,0,1,11,1,10,2
0,3,1,4,6,0,6,5,3,1,0,4,6,0,6,5,3,1,0,4,6,0,6,5
0,3,3,2,21,2,19,9,3,3,0,2,19,1,18,9,3,3,0,2,18,1,17,8
4,2,1,1,16,14,2,0,2,1,4,1,2,1,1,0,2,1,4,1,1,0,1,0
0,1,3,2,27,2,25,12,1,3,0,2,25,2,23,11,1,3,0,2,23,2,21,10
3,0,0,3,12,8,4,2,0,0,3,3,4,2,2,1,0,0,3,3,2,1,1,0
4,1,4,1,29,26,3,0,1,4,4,1,3,2,1,0,1,4,4,1,1,0,1,0
2,4,2,1,2,1,1,0,4,2,2,1,1,0,1,0,4,2,2,1,1,0,1,0
1,1,2,2,19,5,14,6,1,2,1,2,14,4,10,5,1,2,1,2,10,3,7,3
2,3,4,0,14,6,8,0,3,4,2,0,8,4,4,0,3,4,2,0,4,1,3,0
2,3,0,1,2,1,1,0,3,0,2,1,1,0,1,0,3,0,2,1,1,0,1,0
0,3,3,3,10,1,9,6,3,3,0,3,9,0,9,6,3,3,0,3,9,0,9,6
2,1,3,1,16,7,9,2,1,3,2,1,9,4,5,1,1,3,2,1,5,2,3,0
1,3,4,1,18,5,13,3,3,4,1,1,13,3,10,3,3,4,1,1,10,3,7,2
4,4,0,4,7,6,1,0,4,0,4,4,1,0,1,0,4,0,4,4,1,0,1,0
3,3,2,3,12,8,4,2,3,2,3,3,4,2,2,1,3,2,3,3,2,1,1,0
1,1,0,1,2,0,2,0,1,0,1,1,2,0,2,0,1,0,1,1,2,0,2,0
2,4,2,0,2,0,2,0,4,2,2,0,2,0,2,0,4,2,2,0,2,1,1,0
3,2,2,0,14,9,5,0,2,2,3,0,5,3,2,0,2,2,3,0,2,1,1,0
1,2,2,4,21,6,15,13,2,2,1,4,15,4,11,9,2,2,1,4,11,3,8,7
3,0,0,3,4,2,2,1,0,0,3,3,2,1,1,0,0,0,3,3,1,0,1,0
3,3,4,0,11,7,4,0,3,4,3,0,4,2,2,0,3,4,3,0,2,1,1,0
2,0,4,1,29,14,15,4,0,4,2,1,15,7,8,2,0,4,2,1,8,3,5,1
0,4,1,3,11,1,10,6,4,1,0,3,10,1,9,6,4,1,0,3,9,0,9,6
2,2,2,0,15,7,8,0,2,2,2,0,8,3,5,0,2,2,2,0,5,2,3,0
0,4,0,2,2,0,2,0,4,0,0,2,2,0,2,1,4,0,0,2,2,0,2,0
2,1,3,3,19,9,10,6,1,3,2,3,10,5,5,3,1,3,2,3,5,2,3,2
2,1,2,2,16,8,8,4,1,2,2,2,8,4,4,1,1,2,2,2,4,2,2,1
0,4,0,2,6,0,6,3,4,0,0,2,6,0,6,2,4,0,0,2,6,0,6,3
2,2,1,4,9,4,5,4,2,1,2,4,5,2,3,2,2,1,2,4,3,1,2,1
4,3,4,2,21,18,3,1,3,4,4,2,3,2,1,0,3,4,4,2,1,0,1,0
0,1,4,4,24,2,22,19,1,4,0,4,22,2,20,17,1,4,0,4,20,1,19,17
4,0,0,2,12,10,2,0,0,0,4,2,2,1,1,0,0,0,4,2,1,0,1,0
3,0,4,3,29,20,9,6,0,4,3,3,9,6,3,2,0,4,3,3,3,2,1,0
3,1,0,2,3,2,1,0,1,0,3,2,1,0,1,0,1,0,3,2,1,0,1,0
3,2,3,3,10,7,3,2,2,3,3,3,3,2,1,0,2,3,3,3,1,0,1,0
1,0,2,0,25,7,18,1,0,2,1,0,18,5,13,1,0,2,1,0,13,3,10,1
4,2,3,2,19,17,2,1,2,3,4,2,2,1,1,0,2,3,4,2,1,0,1,0
2,2,2,1,14,7,7,2,2,2,2,1,7,3,4,1,2,2,2,1,4,1,3,0
2,0,1,3,17,8,9,6,0,1,2,3,9,4,5,3,0,1,2,3,5,2,3,2
1,2,1,4,7,2,5,4,2,1,1,4,5,1,4,3,2,1,1,4,4,1,3,2
4,4,2,0,3,2,1,0,4,2,4,0,1,0,1,0,4,2,4,0,1,0,1,0
4,1,3,0,26,23,3,0,1,3,4,0,3,2,1,0,1,3,4,0,1,0,1,0
4,0,3,3,24,21,3,2,0,3,4,3,3,2,1,0,0,3,4,3,1,0,1,0
2,1,4,0,28,14,14,1,1,4,2,0,14,7,7,0,1,4,2,0,7,3,4,0
1,0,1,0,18,5,13,1,0,1,1,0,13,3,10,0,0,1,1,0,10,2,8,0
0,2,3,3,12,1,11,7,2,3,0,3,11,1,10,7,2,3,0,3,10,1,9,6
1,2,0,2,6,1,5,2,2,0,1,2,5,1,4,2,2,0,1,2,4,1,3,1
1,2,0,2,0,0,0,0,2,0,1,2,0,0,0,0,2,0,1,2,0,0,0,0
3,2,4,0,20,13,7,0,2,4,3,0,7,4,3,0,2,4,3,0,3,2,1,0
3,4,4,4,4,2,2,1,4,4,3,4,2,1,1,0,4,4,3,4,1,0,1,0
2,0,0,2,3,1,2,0,0,0,2,2,2,1,1,0,0,0,2,2,1,0,1,0
1,2,1,2,16,4,12,6,2,1,1,2,12,3,9,4,2,1,1,2,9,2,7,3
3,0,3,2,24,16,8,3,0,3,3,2,8,5,3,1,0,3,3,2,3,2,1,0
1,0,4,3,27,8,19,13,0,4,1,3,19,5,14,9,0,4,1,3,14,4,10,6
0,1,1,0,6,0,6,0,1,1,0,0,6,0,6,0,1,1,0,0,6,0,6,0
3,4,3,4,7,4,3,2,4,3,3,4,3,2,1,0,4,3,3,4,1,0,1,0
1,1,1,0,13,3,10,1,1,1,1,0,10,3,7,0,1,1,1,0,7,2,5,0
1,4,4,1,10,3,7,2,4,4,1,1,7,2,5,1,4,4,1,1,5,1,4,1
1,2,0,4,0,0,0,0,2,0,1,4,0,0,0,0,2,0,1,4,0,0,0,0
4,4,0,3,10,9,1,0,4,0,4,3,1,0,1,0,4,0,4,3,1,0,1,0
2,1,2,1,15,7,8,2,1,2,2,1,8,3,5,1,1,2,2,1,5,2,3,0
4,0,0,0,4,3,1,0,0,0,4,0,1,0,1,0,0,0,4,0,1,0,1,0
2,1,2,2,9,4,5,2,1,2,2,2,5,2,3,1,1,2,2,2,3,1,2,1
3,2,2,4,14,9,5,4,2,2,3,4,5,3,2,1,2,2,3,4,2,1,1,0
3,0,0,3,13,9,4,2,0,0,3,3,4,2,2,1,0,0,3,3,2,1,1,0
0,3,4,3,13,1,12,8,3,4,0,3,12,1,11,7,3,4,0,3,11,1,10,6
0,1,1,1,16,1,15,4,1,1,0,1,15,1,14,4,1,1,0,1,14,1,13,3
2,4,2,1,7,3,4,1,4,2,2,1,4,2,2,0,4,2,2,1,2,0,2,0
0,3,0,1,2,0,2,0,3,0,0,1,2,0,2,0,3,0,0,1,2,0,2,0
2,4,4,4,6,2,4,3,4,4,2,4,4,2,2,1,4,4,2,4,2,0,2,1
4,3,4,2,20,17,3,1,3,4,4,2,3,2,1,0,3,4,4,2,1,0,1,0
0,0,4,2,29,2,27,13,0,4,0,2,27,2,25,12,0,4,0,2,25,2,23,11
2,2,3,4,21,10,11,9,2,3,2,4,11,5,6,5,2,3,2,4,6,2,4,3
0,2,4,3,24,2,22,15,2,4,0,3,22,2,20,14,2,4,0,3,20,2,18,12
3,3,2,3,14,9,5,3,3,2,3,3,5,3,2,1,3,2,3,3,2,1,1,0
2,3,4,3,16,7,9,6,3,4,2,3,9,4,5,3,3,4,2,3,5,2,3,2
3,1,0,4,15,10,5,4,1,0,3,4,5,3,2,1,1,0,3,4,2,1,1,0
2,0,2,3,16,8,8,5,0,2,2,3,8,4,4,2,0,2,2,3,4,2,2,1
3,0,3,0,26,18,8,0,0,3,3,0,8,5,3,0,0,3,3,0,3,2,1,0
2,2,4,4,17,8,9,8,2,4,2,4,9,4,5,4,2,4,2,4,5,2,3,2
3,2,0,1,10,6,4,1,2,0,3,1,4,2,2,0,2,0,3,1,2,1,1,0
0,2,4,4,18,1,17,15,2,4,0,4,17,1,16,14,2,4,0,4,16,1,15,13
4,1,0,2,6,5,1,0,1,0,4,2,1,0,1,0,1,0,4,2,1,0,1,0
3,2,0,4,2,1,1,0,2,0,3,4,1,0,1,0,2,0,3,4,1,0,1,0
4,0,0,4,2,1,1,0,0,0,4,4,1,0,1,0,0,0,4,4,1,0,1,0
2,1,3,3,25,12,13,9,1,3,2,3,13,6,7,4,1,3,2,3,7,3,4,2
4,0,3,3,24,21,3,2,0,3,4,3,3,2,1,0,0,3,4,3,1,0,1,0
2,0,2,3,25,12,13,9,0,2,2,3,13,6,7,4,0,2,2,3,7,3,4,2
4,0,0,0,6,5,1,0,0,0,4,0,1,0,1,0,0,0,4,0,1,0,1,0
2,0,2,0,21,10,11,1,0,2,2,0,11,5,6,0,0,2,2,0,6,3,3,0
2,2,1,2,2,0,2,0,2,1,2,2,2,1,1,0,2,1,2,2,1,0,1,0
2,0,2,4,23,11,12,10,0,2,2,4,12,5,7,6,0,2,2,4,7,3,4,3
4,4,2,1,9,8,1,0,4,2,4,1,1,0,1,0,4,2,4,1,1,0,1,0
2,1,0,2,12,5,7,3,1,0,2,2,7,3,4,1,1,0,2,2,4,2,2,0
2,4,0,1,12,6,6,1,4,0,2,1,6,2,4,1,4,0,2,1,4,2,2,0
3,4,4,4,11,7,4,3,4,4,3,4,4,2,2,1,4,4,3,4,2,1,1,0
1,3,0,4,9,2,7,6,3,0,1,4,7,2,5,4,3,0,1,4,5,1,4,3
1,2,0,2,1,0,1,0,2,0,1,2,1,0,1,0,2,0,1,2,1,0,1,0
3,0,3,4,29,20,9,8,0,3,3,4,9,6,3,2,0,3,3,4,3,2,1,0
4,1,1,3,9,8,1,0,1,1,4,3,1,0,1,0,1,1,4,3,1,0,1,0
0,4,0,4,1,0,1,0,4,0,0,4,1,0,1,0,4,0,0,4,1,0,1,0
4,4,0,0,1,0,1,0,4,0,4,0,1,0,1,0,4,0,4,0,1,0,1,0
4,3,2,0,11,9,2,0,3,2,4,0,2,1,1,0,3,2,4,0,1,0,1,0
1,4,2,1,10,2,8,2,4,2,1,1,8,2,6,1,4,2,1,1,6,1,5,1
4,4,4,4,1,0,1,0,4,4,4,4,1,0,1,0,4,4,4,4,1,0,1,0
3,1,1,4,15,10,5,4,1,1,3,4,5,3,2,1,1,1,3,4,2,1,1,0
4,4,3,4,6,5,1,0,4,3,4,4,1,0,1,0,4,3,4,4,1,0,1,0
2,1,3,0,22,11,11,1,1,3,2,0,11,5,6,0,1,3,2,0,6,3,3,0
0,3,4,4,25,2,23,20,3,4,0,4,23,2,21,18,3,4,0,4,21,2,19,17
0,1,2,1,25,2,23,6,1,2,0,1,23,2,21,6,1,2,0,1,21,2,19,5
0,2,1,3,14,1,13,9,2,1,0,3,13,1,12,8,2,1,0,3,12,1,11,7
1,2,3,0,16,4,12,1,2,3,1,0,12,3,9,0,2,3,1,0,9,2,7,0
0,4,0,1,4,0,4,1,4,0,0,1,4,0,4,1,4,0,0,1,4,0,4,1
2,2,2,3,13,6,7,4,2,2,2,3,7,3,4,2,2,2,2,3,4,2,2,1
3,1,1,4,13,9,4,3,1,1,3,4,4,2,2,1,1,1,3,4,2,1,1,0
3,3,0,2,11,7,4,1,3,0,3,2,4,2,2,1,3,0,3,2,2,1,1,0
1,4,3,0,2,0,2,0,4,3,1,0,2,0,2,0,4,3,1,0,2,0,2,0
3,2,3,0,11,7,4,0,2,3,3,0,4,2,2,0,2,3,3,0,2,1,1,0
1,1,1,2,13,3,10,4,1,1,1,2,10,3,7,3,1,1,1,2,7,2,5,2
1,0,1,1,16,4,12,3,0,1,1,1,12,3,9,2,0,1,1,1,9,2,7,2
0,4,0,0,2,0,2,0,4,0,0,0,2,0,2,0,4,0,0,0,2,0,2,0
2,3,4,0,13,6,7,0,3,4,2,0,7,3,4,0,3,4,2,0,4,1,3,0
2,1,1,2,18,8,10,4,1,1,2,2,10,5,5,2,1,1,2,2,5,2,3,1
3,3,1,1,3,2,1,0,3,1,3,1,1,0,1,0,3,1,3,1,1,0,1,0
3,0,2,3,21,14,7,4,0,2,3,3,7,4,3,2,0,2,3,3,3,2,1,0
2,2,0,1,10,5,5,1,2,0,2,1,5,2,3,0,2,0,2,1,3,1,2,0
2,3,0,3,1,0,1,0,3,0,2,3,1,0,1,0,3,0,2,3,1,0,1,0
1,3,4,1,26,7,19,5,3,4,1,1,19,5,14,4,3,4,1,1,14,4,10,2
4,4,2,1,9,8,1,0,4,2,4,1,1,0,1,0,4,2,4,1,1,0,1,0
4,1,2,3,15,13,2,1,1,2,4,3,2,1,1,0,1,2,4,3,1,0,1,0
0,1,3,4,22,2,20,17,1,3,0,4,20,1,19,17,1,3,0,4,19,1,18,16
1,2,0,4,0,0,0,0,2,0,1,4,0,0,0,0,2,0,1,4,0,0,0,0
0,0,1,0,16,1,15,1,0,1,0,0,15,1,14,1,0,1,0,0,14,1,13,1
3,0,3,3,22,15,7,4,0,3,3,3,7,4,3,2,0,3,3,3,3,2,1,0
0,3,2,0,6,0,6,0,3,2,0,0,6,0,6,0,3,2,0,0,6,0,6,0
3,0,4,2,29,20,9,4,0,4,3,2,9,6,3,1,0,4,3,2,3,2,1,0
3,0,0,0,22,15,7,0,0,0,3,0,7,4,3,0,0,0,3,0,3,2,1,0
4,4,4,3,8,7,1,0,4,4,4,3,1,0,1,0,4,4,4,3,1,0,1,0
1,0,4,3,29,8,21,14,0,4,1,3,21,6,15,10,0,4,1,3,15,4,11,7
4,0,2,1,27,24,3,0,0,2,4,1,3,2,1,0,0,2,4,1,1,0,1,0
0,2,3,4,22,2,20,17,2,3,0,4,20,2,18,16,2,3,0,4,18,1,17,15
1,1,4,2,27,8,19,9,1,4,1,2,19,5,14,7,1,4,1,2,14,4,10,5
2,4,1,3,12,5,7,4,4,1,2,3,7,3,4,2,4,1,2,3,4,2,2,1
3,3,2,2,9,6,3,1,3,2,3,2,3,2,1,0,3,2,3,2,1,0,1,0
0,0,2,4,21,2,19,17,0,2,0,4,19,1,18,16,0,2,0,4,18,1,17,15
3,1,2,1,23,16,7,2,1,2,3,1,7,4,3,0,1,2,3,1,3,2,1,0
2,2,3,3,17,8,9,6,2,3,2,3,9,4,5,3,2,3,2,3,5,2,3,2
4,0,0,1,24,21,3,0,0,0,4,1,3,2,1,0,0,0,4,1,1,0,1,0
0,0,0,4,2,0,2,1,0,0,0,4,2,0,2,1,0,0,0,4,2,0,2,1
3,0,1,1,16,11,5,1,0,1,3,1,5,3,2,0,0,1,3,1,2,1,1,0
3,0,1,3,18,12,6,4,0,1,3,3,6,4,2,1,0,1,3,3,2,1,1,0
2,3,1,2,6,2,4,1,3,1,2,2,4,2,2,1,3,1,2,2,2,0,2,0
4,1,4,0,27,24,3,0,1,4,4,0,3,2,1,0,1,4,4,0,1,0,1,0
0,4,4,4,8,0,8,7,4,4,0,4,8,0,8,7,4,4,0,4,8,0,8,7
0,3,2,3,1,0,1,0,3,2,0,3,1,0,1,0,3,2,0,3,1,0,1,0
0,4,1,2,6,0,6,2,4,1,0,2,6,0,6,3,4,1,0,2,6,0,6,2
0,2,0,3,13,1,12,8,2,0,0,3,12,1,11,7,2,0,0,3,11,1,10,6
4,2,0,3,0,0,0,0,2,0,4,3,0,0,0,0,2,0,4,3,0,0,0,0
3,3,4,4,11,7,4,3,3,4,3,4,4,2,2,1,3,4,3,4,2,1,1,0
4,1,0,0,3,2,1,0,1,0,4,0,1,0,1,0,1,0,4,0,1,0,1,0
3,2,0,4,0,0,0,0,2,0,3,4,0,0,0,0,2,0,3,4,0,0,0,0
0,1,2,2,21,2,19,9,1,2,0,2,19,1,18,9,1,2,0,2,18,1,17,8
1,1,3,1,22,6,16,4,1,3,1,1,16,4,12,3,1,3,1,1,12,3,9,2
0,4,4,3,6,0,6,4,4,4,0,3,6,0,6,4,4,4,0,3,6,0,6,4
3,3,4,2,9,6,3,1,3,4,3,2,3,2,1,0,3,4,3,2,1,0,1,0
1,1,2,3,17,5,12,8,1,2,1,3,12,3,9,6,1,2,1,3,9,2,7,4
2,2,0,0,0,0,0,0,2,0,2,0,0,0,0,0,2,0,2,0,0,0,0,0
3,2,1,3,17,11,6,4,2,1,3,3,6,4,2,1,2,1,3,3,2,1,1,0
0,3,3,3,10,0,10,7,3,3,0,3,10,0,10,7,3,3,0,3,10,1,9,6
1,4,4,1,14,4,10,2,4,4,1,1,10,3,7,2,4,4,1,1,7,2,5,1
3,2,2,2,17,11,6,3,2,2,3,2,6,4,2,1,2,2,3,2,2,1,1,0
0,2,1,1,6,0,6,1,2,1,0,1,6,0,6,1,2,1,0,1,6,0,6,1
3,1,4,3,21,14,7,4,1,4,3,3,7,4,3,2,1,4,3,3,3,2,1,0
2,3,4,0,13,6,7,0,3,4,2,0,7,3,4,0,3,4,2,0,4,1,3,0
0,1,3,4,25,2,23,20,1,3,0,4,23,2,21,18,1,3,0,4,21,2,19,17
1,1,1,3,14,4,10,7,1,1,1,3,10,3,7,4,1,1,1,3,7,2,5,3
2,0,1,2,11,5,6,2,0,1,2,2,6,2,4,1,0,1,2,2,4,2,2,1
2,2,2,2,21,10,11,5,2,2,2,2,11,5,6,2,2,2,2,2,6,3,3,1
1,3,1,0,10,2,8,0,3,1,1,0,8,2,6,0,3,1,1,0,6,1,5,0
4,4,1,0,7,6,1,0,4,1,4,0,1,0,1,0,4,1,4,0,1,0,1,0
3,3,0,2,3,2,1,0,3,0,3,2,1,0,1,0,3,0,3,2,1,0,1,0
4,0,3,2,28,25,3,1,0,3,4,2,3,2,1,0,0,3,4,2,1,0,1,0
2,3,1,1,9,4,5,1,3,1,2,1,5,2,3,0,3,1,2,1,3,1,2,0
2,4,3,2,12,5,7,3,4,3,2,2,7,3,4,2,4,3,2,2,4,2,2,0
0,1,4,1,27,2,25,7,1,4,0,1,25,2,23,6,1,4,0,1,23,2,21,6
4,4,4,1,12,10,2,0,4,4,4,1,2,1,1,0,4,4,4,1,1,0,1,0
3,3,4,2,16,11,5,2,3,4,3,2,5,3,2,0,3,4,3,2,2,1,1,0
1,4,0,0,4,1,3,0,4,0,1,0,3,0,3,0,4,0,1,0,3,0,3,0
1,0,0,1,11,3,8,2,0,0,1,1,8,2,6,1,0,0,1,1,6,1,5,1
0,2,2,3,23,2,21,14,2,2,0,3,21,2,19,13,2,2,0,3,19,1,18,12
2,1,2,2,16,8,8,4,1,2,2,2,8,4,4,2,1,2,2,2,4,1,3,1
2,2,1,1,3,1,2,0,2,1,2,1,2,1,1,0,2,1,2,1,1,0,1,0
1,3,1,3,11,3,8,5,3,1,1,3,8,2,6,4,3,1,1,3,6,1,5,3
4,4,2,0,4,3,1,0,4,2,4,0,1,0,1,0,4,2,4,0,1,0,1,0
4,1,2,3,22,19,3,2,1,2,4,3,3,2,1,0,1,2,4,3,1,0,1,0
1,0,4,3,29,8,21,14,0,4,1,3,21,6,15,10,0,4,1,3,15,4,11,7
1,3,3,0,7,2,5,0,3,3,1,0,5,1,4,0,3,3,1,0,4,1,3,0
3,1,3,0,28,19,9,0,1,3,3,0,9,6,3,0,1,3,3,0,3,2,1,0
0,1,3,4,21,2,19,17,1,3,0,4,19,1,18,16,1,3,0,4,18,1,17,15
2,0,3,1,29,14,15,4,0,3,2,1,15,7,8,2,0,3,2,1,8,3,5,1
2,1,3,1,23,11,12,3,1,3,2,1,12,5,7,2,1,3,2,1,7,3,4,1
4,1,1,4,19,17,2,1,1,1,4,4,2,1,1,0,1,1,4,4,1,0,1,0
4,1,2,3,20,17,3,2,1,2,4,3,3,2,1,0,1,2,4,3,1,0,1,0
4,2,4,2,26,23,3,1,2,4,4,2,3,2,1,0,2,4,4,2,1,0,1,0
2,0,3,0,27,13,14,1,0,3,2,0,14,7,7,0,0,3,2,0,7,3,4,0
3,4,4,3,14,9,5,3,4,4,3,3,5,3,2,1,4,4,3,3,2,1,1,0
0,1,0,2,4,0,4,2,1,0,0,2,4,0,4,2,1,0,0,2,4,0,4,1
4,1,4,4,28,25,3,2,1,4,4,4,3,2,1,0,1,4,4,4,1,0,1,0
1,1,0,4,7,2,5,4,1,0,1,4,5,1,4,3,1,0,1,4,4,1,3,2
4,3,2,2,2,1,1,0,3,2,4,2,1,0,1,0,3,2,4,2,1,0,1,0
0,0,2,0,20,1,19,1,0,2,0,0,19,1,18,1,0,2,0,0,18,1,17,1
2,2,0,2,0,0,0,0,2,0,2,2,0,0,0,0,2,0,2,2,0,0,0,0
0,3,1,0,0,0,0,0,3,1,0,0,0,0,0,0,3,1,0,0,0,0,0,0
0,2,3,4,12,1,11,9,2,3,0,4,11,1,10,8,2,3,0,4,10,1,9,8
4,2,1,2,2,1,1,0,2,1,4,2,1,0,1,0,2,1,4,2,1,0,1,0
2,3,1,1,0,0,0,0,3,1,2,1,0,0,0,0,3,1,2,1,0,0,0,0
1,1,4,0,21,6,15,1,1,4,1,0,15,4,11,1,1,4,1,0,11,3,8,0
1,1,1,3,7,2,5,3,1,1,1,3,5,1,4,2,1,1,1,3,4,1,3,2
1,3,2,3,7,2,5,3,3,2,1,3,5,1,4,2,3,2,1,3,4,1,3,2
2,3,3,1,22,10,12,3,3,3,2,1,12,6,6,1,3,3,2,1,6,3,3,0
1,4,1,4,9,2,7,6,4,1,1,4,7,2,5,4,4,1,1,4,5,1,4,3
2,2,1,1,10,4,6,1,2,1,2,1,6,2,4,1,2,1,2,1,4,2,2,0
4,2,3,0,13,11,2,0,2,3,4,0,2,1,1,0,2,3,4,0,1,0,1,0
3,4,2,2,8,5,3,1,4,2,3,2,3,2,1,0,4,2,3,2,1,0,1,0
0,4,3,2,2,0,2,1,4,3,0,2,2,0,2,1,4,3,0,2,2,0,2,1
0,4,4,2,6,0,6,2,4,4,0,2,6,0,6,2,4,4,0,2,6,0,6,2
0,4,3,2,4,0,4,2,4,3,0,2,4,0,4,2,4,3,0,2,4,0,4,1
3,0,1,3,7,4,3,2,0,1,3,3,3,2,1,0,0,1,3,3,1,0,1,0
2,4,2,2,7,3,4,1,4,2,2,2,4,2,2,1,4,2,2,2,2,0,2,0
4,2,0,4,7,6,1,0,2,0,4,4,1,0,1,0,2,0,4,4,1,0,1,0
2,0,1,1,15,7,8,2,0,1,2,1,8,4,4,1,0,1,2,1,4,2,2,0
0,3,1,0,3,0,3,0,3,1,0,0,3,0,3,0,3,1,0,0,3,0,3,0
2,3,4,4,12,5,7,6,3,4,2,4,7,3,4,3,3,4,2,4,4,2,2,1
3,4,4,2,7,4,3,1,4,4,3,2,3,2,1,0,4,4,3,2,1,0,1,0
3,4,4,0,13,9,4,0,4,4,3,0,4,2,2,0,4,4,3,0,2,1,1,0
4,4,3,4,16,14,2,1,4,3,4,4,2,1,1,0,4,3,4,4,1,0,1,0
4,0,2,0,18,16,2,0,0,2,4,0,2,1,1,0,0,2,4,0,1,0,1,0
1,4,4,1,11,3,8,2,4,4,1,1,8,2,6,1,4,4,1,1,6,1,5,1
0,0,3,2,24,2,22,11,0,3,0,2,22,2,20,10,0,3,0,2,20,1,19,9
3,3,2,4,10,6,4,3,3,2,3,4,4,2,2,1,3,2,3,4,2,1,1,0
4,4,1,1,7,6,1,0,4,1,4,1,1,0,1,0,4,1,4,1,1,0,1,0
2,0,2,3,15,7,8,5,0,2,2,3,8,4,4,2,0,2,2,3,4,2,2,1
4,0,0,0,12,10,2,0,0,0,4,0,2,1,1,0,0,0,4,0,1,0,1,0
0,3,1,3,9,0,9,6,3,1,0,3,9,0,9,6,3,1,0,3,9,0,9,6
3,2,3,0,13,9,4,0,2,3,3,0,4,2,2,0,2,3,3,0,2,1,1,0
3,4,0,2,7,4,3,1,4,0,3,2,3,2,1,0,4,0,3,2,1,0,1,0
1,3,0,2,5,1,4,1,3,0,1,2,4,1,3,1,3,0,1,2,3,0,3,1
3,2,3,0,15,10,5,0,2,3,3,0,5,3,2,0,2,3,3,0,2,1,1,0
2,2,2,1,22,11,11,3,2,2,2,1,11,5,6,1,2,2,2,1,6,2,4,1
3,3,1,4,2,1,1,0,3,1,3,4,1,0,1,0,3,1,3,4,1,0,1,0
2,0,3,4,28,14,14,12,0,3,2,4,14,7,7,6,0,3,2,4,7,3,4,3
2,4,4,2,11,5,6,3,4,4,2,2,6,2,4,2,4,4,2,2,4,2,2,0
0,3,2,2,8,0,8,4,3,2,0,2,8,0,8,3,3,2,0,2,8,0,8,3
0,1,1,0,7,0,7,0,1,1,0,0,7,0,7,0,1,1,0,0,7,0,7,0
0,1,0,4,11,1,10,9,1,0,0,4,10,1,9,8,1,0,0,4,9,0,9,8
2,0,3,3,26,12,14,9,0,3,2,3,14,6,8,5,0,3,2,3,8,3,5,3
3,4,4,2,2,1,1,0,4,4,3,2,1,0,1,0,4,4,3,2,1,0,1,0
3,0,0,2,8,5,3,1,0,0,3,2,3,2,1,0,0,0,3,2,1,0,1,0
0,0,4,1,26,2,24,7,0,4,0,1,24,2,22,6,0,4,0,1,22,2,20,6
4,4,1,2,2,1,1,0,4,1,4,2,1,0,1,0,4,1,4,2,1,0,1,0
0,0,0,0,13,1,12,1,0,0,0,0,12,1,11,1,0,0,0,0,11,1,10,1
3,4,4,3,9,6,3,2,4,4,3,3,3,2,1,0,4,4,3,3,1,0,1,0
2,3,3,3,8,4,4,2,3,3,2,3,4,2,2,1,3,3,2,3,2,1,1,0
2,4,3,4,5,2,3,2,4,3,2,4,3,1,2,1,4,3,2,4,2,0,2,1
1,4,1,2,1,0,1,0,4,1,1,2,1,0,1,0,4,1,1,2,1,0,1,0
0,0,3,0,29,2,27,2,0,3,0,0,27,2,25,2,0,3,0,0,25,2,23,2
1,2,1,0,11,3,8,0,2,1,1,0,8,2,6,0,2,1,1,0,6,1,5,0
2,2,0,4,8,3,5,4,2,0,2,4,5,2,3,2,2,0,2,4,3,1,2,1
3,1,1,1,10,7,3,0,1,1,3,1,3,2,1,0,1,1,3,1,1,0,1,0
1,2,4,4,15,4,11,9,2,4,1,4,11,3,8,7,2,4,1,4,8,2,6,5
1,0,3,4,24,7,17,15,0,3,1,4,17,5,12,10,0,3,1,4,12,3,9,8
4,2,3,4,10,9,1,0,2,3,4,4,1,0,1,0,2,3,4,4,1,0,1,0
2,0,4,2,24,11,13,6,0,4,2,2,13,6,7,3,0,4,2,2,7,3,4,1
0,1,0,3,14,1,13,9,1,0,0,3,13,1,12,8,1,0,0,3,12,1,11,7
3,0,1,4,21,14,7,6,0,1,3,4,7,4,3,2,0,1,3,4,3,2,1,0
4,4,3,4,3,2,1,0,4,3,4,4,1,0,1,0,4,3,4,4,1,0,1,0
4,2,2,3,18,16,2,1,2,2,4,3,2,1,1,0,2,2,4,3,1,0,1,0
3,0,3,0,25,17,8,0,0,3,3,0,8,5,3,0,0,3,3,0,3,2,1,0
3,2,0,3,6,4,2,1,2,0,3,3,2,1,1,0,2,0,3,3,1,0,1,0
4,4,2,4,3,2,1,0,4,2,4,4,1,0,1,0,4,2,4,4,1,0,1,0
2,1,0,1,7,3,4,1,1,0,2,1,4,2,2,0,1,0,2,1,2,0,2,0
2,2,2,2,19,9,10,4,2,2,2,2,10,5,5,2,2,2,2,2,5,2,3,1
1,1,1,3,12,3,9,6,1,1,1,3,9,2,7,4,1,1,1,3,7,2,5,3
0,2,2,2,9,0,9,4,2,2,0,2,9,0,9,4,2,2,0,2,9,0,9,4
1,1,3,1,19,5,14,4,1,3,1,1,14,4,10,3,1,3,1,1,10,2,8,2
3,4,1,1,4,2,2,0,4,1,3,1,2,1,1,0,4,1,3,1,1,0,1,0
2,4,4,3,5,2,3,2,4,4,2,3,3,1,2,1,4,4,2,3,2,0,2,1
0,2,4,0,22,2,20,1,2,4,0,0,20,2,18,1,2,4,0,0,18,1,17,1
4,2,3,4,12,10,2,1,2,3,4,4,2,1,1,0,2,3,4,4,1,0,1,0
4,0,4,3,29,26,3,2,0,4,4,3,3,2,1,0,0,4,4,3,1,0,1,0
0,4,0,1,0,0,0,0,4,0,0,1,0,0,0,0,4,0,0,1,0,0,0,0
0,1,4,0,24,2,22,2,1,4,0,0,22,2,20,1,1,4,0,0,20,2,18,1
1,4,4,3,6,1,5,3,4,4,1,3,5,1,4,2,4,4,1,3,4,1,3,2
1,1,1,4,8,2,6,5,1,1,1,4,6,1,5,4,1,1,1,4,5,1,4,3
0,4,0,2,6,0,6,3,4,0,0,2,6,0,6,3,4,0,0,2,6,0,6,3
1,1,0,0,6,1,5,0,1,0,1,0,5,1,4,0,1,0,1,0,4,1,3,0
1,2,1,2,9,2,7,3,2,1,1,2,7,2,5,2,2,1,1,2,5,1,4,2
1,1,4,4,22,6,16,14,1,4,1,4,16,4,12,10,1,4,1,4,12,3,9,8
0,2,3,0,8,0,8,0,2,3,0,0,8,0,8,0,2,3,0,0,8,0,8,0
2,1,3,0,25,12,13,1,1,3,2,0,13,6,7,0,1,3,2,0,7,3,4,0
2,1,0,0,6,3,3,0,1,0,2,0,3,1,2,0,1,0,2,0,2,0,2,0
1,1,0,2,5,1,4,2,1,0,1,2,4,1,3,1,1,0,1,2,3,0,3,1
0,2,0,2,6,0,6,2,2,0,0,2,6,0,6,3,2,0,0,2,6,0,6,3
4,1,0,1,4,3,1,0,1,0,4,1,1,0,1,0,1,0,4,1,1,0,1,0
1,3,1,3,0,0,0,0,3,1,1,3,0,0,0,0,3,1,1,3,0,0,0,0
2,0,2,4,25,12,13,11,0,2,2,4,13,6,7,6,0,2,2,4,7,3,4,3
1,0,4,3,28,8,20,13,0,4,1,3,20,5,15,10,0,4,1,3,15,4,11,7
1,1,3,2,26,7,19,9,1,3,1,2,19,5,14,7,1,3,1,2,14,4,10,4
0,4,2,1,10,1,9,2,4,2,0,1,9,0,9,2,4,2,0,1,9,0,9,2
3,2,2,2,14,9,5,2,2,2,3,2,5,3,2,1,2,2,3,2,2,1,1,0
3,4,0,4,4,2,2,1,4,0,3,4,2,1,1,0,4,0,3,4,1,0,1,0
0,3,1,2,6,0,6,2,3,1,0,2,6,0,6,3,3,1,0,2,6,0,6,2
3,3,3,4,3,2,1,0,3,3,3,4,1,0,1,0,3,3,3,4,1,0,1,0
4,0,4,3,29,26,3,2,0,4,4,3,3,2,1,0,0,4,4,3,1,0,1,0
4,2,2,0,14,12,2,0,2,2,4,0,2,1,1,0,2,2,4,0,1,0,1,0
3,1,3,1,23,16,7,2,1,3,3,1,7,4,3,0,1,3,3,1,3,2,1,0
2,1,2,2,16,7,9,4,1,2,2,2,9,4,5,2,1,2,2,2,5,2,3,1
0,1,0,1,5,0,5,1,1,0,0,1,5,0,5,1,1,0,0,1,5,0,5,1
0,0,3,2,29,2,27,13,0,3,0,2,27,2,25,12,0,3,0,2,25,2,23,11
0,3,1,4,8,0,8,7,3,1,0,4,8,0,8,7,3,1,0,4,8,0,8,7
4,1,3,3,21,18,3,2,1,3,4,3,3,2,1,0,1,3,4,3,1,0,1,0
4,2,2,3,7,6,1,0,2,2,4,3,1,0,1,0,2,2,4,3,1,0,1,0
0,0,1,3,16,1,15,10,0,1,0,3,15,1,14,9,0,1,0,3,14,1,13,9
4,1,4,2,28,25,3,1,1,4,4,2,3,2,1,0,1,4,4,2,1,0,1,0
3,0,1,4,18,12,6,5,0,1,3,4,6,4,2,1,0,1,3,4,2,1,1,0
3,3,2,1,7,4,3,0,3,2,3,1,3,2,1,0,3,2,3,1,1,0,1,0
2,0,4,2,22,11,11,5,0,4,2,2,11,5,6,2,0,4,2,2,6,2,4,2
3,4,4,2,15,10,5,2,4,4,3,2,5,3,2,0,4,4,3,2,2,1,1,0
2,0,3,0,27,13,14,1,0,3,2,0,14,6,8,0,0,3,2,0,8,3,5,0
0,0,2,4,22,2,20,18,0,2,0,4,20,1,19,17,0,2,0,4,19,1,18,16
3,1,1,0,16,11,5,0,1,1,3,0,5,3,2,0,1,1,3,0,2,1,1,0
4,0,3,1,27,24,3,0,0,3,4,1,3,2,1,0,0,3,4,1,1,0,1,0
2,1,2,2,14,7,7,3,1,2,2,2,7,3,4,1,1,2,2,2,4,1,3,1
3,2,4,0,24,16,8,0,2,4,3,0,8,5,3,0,2,4,3,0,3,2,1,0
1,3,3,1,7,2,5,1,3,3,1,1,5,1,4,1,3,3,1,1,4,1,3,0
2,3,4,2,13,6,7,3,3,4,2,2,7,3,4,1,3,4,2,2,4,1,3,1
1,4,3,2,6,1,5,2,4,3,1,2,5,1,4,2,4,3,1,2,4,1,3,1
3,0,4,3,24,16,8,5,0,4,3,3,8,5,3,2,0,4,3,3,3,2,1,0
4,3,4,0,12,10,2,0,3,4,4,0,2,1,1,0,3,4,4,0,1,0,1,0
0,0,1,4,6,0,6,5,0,1,0,4,6,0,6,5,0,1,0,4,6,0,6,5
3,3,4,1,4,2,2,0,3,4,3,1,2,1,1,0,3,4,3,1,1,0,1,0
1,0,4,1,29,8,21,6,0,4,1,1,21,6,15,4,0,4,1,1,15,4,11,3
4,4,2,4,6,5,1,0,4,2,4,4,1,0,1,0,4,2,4,4,1,0,1,0
3,1,3,0,27,18,9,0,1,3,3,0,9,6,3,0,1,3,3,0,3,2,1,0
2,2,4,3,21,10,11,7,2,4,2,3,11,5,6,4,2,4,2,3,6,3,3,2
4,0,3,1,17,15,2,0,0,3,4,1,2,1,1,0,0,3,4,1,1,0,1,0
3,0,2,0,20,13,7,0,0,2,3,0,7,4,3,0,0,2,3,0,3,2,1,0
0,4,1,1,6,0,6,1,4,1,0,1,6,0,6,1,4,1,0,1,6,0,6,1
2,0,0,4,9,4,5,4,0,0,2,4,5,2,3,2,0,0,2,4,3,1,2,1
2,4,0,4,2,1,1,0,4,0,2,4,1,0,1,0,4,0,2,4,1,0,1,0
0,0,3,1,22,2,20,5,0,3,0,1,20,2,18,5,0,3,0,1,18,1,17,5
0,0,1,0,7,0,7,0,0,1,0,0,7,0,7,0,0,1,0,0,7,0,7,0
0,0,0,0,7,0,7,0,0,0,0,0,7,0,7,0,0,0,0,0,7,0,7,0
3,3,1,1,5,3,2,0,3,1,3,1,2,1,1,0,3,1,3,1,1,0,1,0
2,2,1,0,0,0,0,0,2,1,2,0,0,0,0,0,2,1,2,0,0,0,0,0
2,4,2,0,6,2,4,0,4,2,2,0,4,1,3,0,4,2,2,0,3,1,2,0
0,1,4,4,24,2,22,19,1,4,0,4,22,2,20,18,1,4,0,4,20,2,18,16
0,4,4,1,1,0,1,0,4,4,0,1,1,0,1,0,4,4,0,1,1,0,1,0
0,4,4,3,9,0,9,6,4,4,0,3,9,0,9,6,4,4,0,3,9,0,9,6
2,0,0,0,3,1,2,0,0,0,2,0,2,0,2,0,0,0,2,0,2,1,1,0
4,4,0,1,3,2,1,0,4,0,4,1,1,0,1,0,4,0,4,1,1,0,1,0
2,1,0,0,15,7,8,0,1,0,2,0,8,3,5,0,1,0,2,0,5,2,3,0
3,3,0,1,7,4,3,0,3,0,3,1,3,2,1,0,3,0,3,1,1,0,1,0
4,3,2,3,5,4,1,0,3,2,4,3,1,0,1,0,3,2,4,3,1,0,1,0
4,1,3,2,27,24,3,1,1,3,4,2,3,2,1,0,1,3,4,2,1,0,1,0
1,1,4,1,27,8,19,5,1,4,1,1,19,5,14,4,1,4,1,1,14,4,10,3
4,1,0,0,8,7,1,0,1,0,4,0,1,0,1,0,1,0,4,0,1,0,1,0
2,3,1,3,13,6,7,4,3,1,2,3,7,3,4,2,3,1,2,3,4,2,2,1
3,0,0,3,6,4,2,1,0,0,3,3,2,1,1,0,0,0,3,3,1,0,1,0
0,2,1,2,14,1,13,6,2,1,0,2,13,1,12,6,2,1,0,2,12,1,11,5
2,3,3,0,22,10,12,1,3,3,2,0,12,6,6,0,3,3,2,0,6,3,3,0
0,2,4,1,21,2,19,5,2,4,0,1,19,1,18,5,2,4,0,1,18,1,17,5
0,3,1,1,13,1,12,3,3,1,0,1,12,1,11,3,3,1,0,1,11,1,10,3
4,4,4,3,12,10,2,1,4,4,4,3,2,1,1,0,4,4,4,3,1,0,1,0
0,1,3,2,18,1,17,8,1,3,0,2,17,1,16,8,1,3,0,2,16,1,15,7
1,2,2,0,15,4,11,1,2,2,1,0,11,3,8,0,2,2,1,0,8,2,6,0
2,1,2,2,5,2,3,1,1,2,2,2,3,1,2,1,1,2,2,2,2,0,2,0
2,1,4,2,25,12,13,6,1,4,2,2,13,6,7,3,1,4,2,2,7,3,4,2
2,1,2,4,13,6,7,6,1,2,2,4,7,3,4,3,1,2,2,4,4,2,2,1
1,0,4,3,22,6,16,11,0,4,1,3,16,4,12,8,0,4,1,3,12,3,9,6
4,4,3,0,7,6,1,0,4,3,4,0,1,0,1,0,4,3,4,0,1,0,1,0
2,4,3,4,14,6,8,7,4,3,2,4,8,3,5,4,4,3,2,4,5,2,3,2
1,4,1,4,6,1,5,4,4,1,1,4,5,1,4,3,4,1,1,4,4,1,3,2
2,2,0,0,9,4,5,0,2,0,2,0,5,2,3,0,2,0,2,0,3,1,2,0
0,1,2,4,16,1,15,13,1,2,0,4,15,1,14,12,1,2,0,4,14,1,13,11
4,0,4,3,28,25,3,2,0,4,4,3,3,2,1,0,0,4,4,3,1,0,1,0
3,3,1,3,11,7,4,2,3,1,3,3,4,2,2,1,3,1,3,3,2,1,1,0
0,2,2,2,20,1,19,9,2,2,0,2,19,1,18,8,2,2,0,2,18,1,17,8
2,4,4,1,12,6,6,1,4,4,2,1,6,2,4,1,4,4,2,1,4,2,2,0
3,2,3,4,17,11,6,5,2,3,3,4,6,4,2,1,2,3,3,4,2,1,1,0
2,2,2,2,20,9,11,5,2,2,2,2,11,5,6,2,2,2,2,2,6,2,4,2
3,4,3,3,5,3,2,1,4,3,3,3,2,1,1,0,4,3,3,3,1,0,1,0
2,0,0,2,11,5,6,2,0,0,2,2,6,2,4,2,0,0,2,2,4,2,2,1
0,0,3,0,26,2,24,2,0,3,0,0,24,2,22,2,0,3,0,0,22,2,20,2
3,3,2,3,3,2,1,0,3,2,3,3,1,0,1,0,3,2,3,3,1,0,1,0
4,0,2,2,17,15,2,1,0,2,4,2,2,1,1,0,0,2,4,2,1,0,1,0
0,0,3,1,29,2,27,8,0,3,0,1,27,2,25,7,0,3,0,1,25,2,23,6
2,3,0,2,0,0,0,0,3,0,2,2,0,0,0,0,3,0,2,2,0,0,0,0
2,2,2,2,8,4,4,1,2,2,2,2,4,1,3,1,2,2,2,2,3,1,2,1
0,1,2,3,15,1,14,9,1,2,0,3,14,1,13,9,1,2,0,3,13,1,12,8
3,3,0,2,0,0,0,0,3,0,3,2,0,0,0,0,3,0,3,2,0,0,0,0
0,2,4,1,17,1,16,4,2,4,0,1,16,1,15,4,2,4,0,1,15,1,14,4
2,2,0,0,2,0,2,0,2,0,2,0,2,1,1,0,2,0,2,0,1,0,1,0
1,2,4,2,28,8,20,10,2,4,1,2,20,5,15,7,2,4,1,2,15,4,11,5
1,3,1,4,11,3,8,7,3,1,1,4,8,2,6,5,3,1,1,4,6,1,5,4
2,1,0,4,9,4,5,4,1,0,2,4,5,2,3,2,1,0,2,4,3,1,2,1
2,4,3,4,8,4,4,3,4,3,2,4,4,2,2,1,4,3,2,4,2,0,2,1
1,4,0,4,8,2,6,5,4,0,1,4,6,1,5,4,4,0,1,4,5,1,4,3
3,2,4,4,21,14,7,6,2,4,3,4,7,4,3,2,2,4,3,4,3,2,1,0
3,3,3,3,14,9,5,3,3,3,3,3,5,3,2,1,3,3,3,3,2,1,1,0
4,4,3,2,4,3,1,0,4,3,4,2,1,0,1,0,4,3,4,2,1,0,1,0
2,4,0,0,4,2,2,0,4,0,2,0,2,0,2,0,4,0,2,0,2,1,1,0
4,2,4,4,25,22,3,2,2,4,4,4,3,2,1,0,2,4,4,4,1,0,1,0
1,0,1,0,19,5,14,1,0,1,1,0,14,4,10,1,0,1,1,0,10,3,7,0
2,1,0,3,6,3,3,2,1,0,2,3,3,1,2,1,1,0,2,3,2,0,2,1
2,3,1,3,19,9,10,7,3,1,2,3,10,5,5,3,3,1,2,3,5,2,3,2
1,0,0,1,9,2,7,2,0,0,1,1,7,2,5,1,0,0,1,1,5,1,4,1
3,1,0,0,4,2,2,0,1,0,3,0,2,1,1,0,1,0,3,0,1,0,1,0
4,3,2,4,11,9,2,1,3,2,4,4,2,1,1,0,3,2,4,4,1,0,1,0
2,3,0,2,5,2,3,1,3,0,2,2,3,1,2,0,3,0,2,2,2,1,1,0
4,0,4,1,29,26,3,0,0,4,4,1,3,2,1,0,0,4,4,1,1,0,1,0
3,4,0,3,0,0,0,0,4,0,3,3,0,0,0,0,4,0,3,3,0,0,0,0
0,2,1,2,14,1,13,6,2,1,0,2,13,1,12,6,2,1,0,2,12,1,11,5
0,0,2,2,17,1,16,7,0,2,0,2,16,1,15,7,0,2,0,2,15,1,14,7
1,4,4,3,6,1,5,3,4,4,1,3,5,1,4,2,4,4,1,3,4,1,3,2
1,3,3,4,9,2,7,6,3,3,1,4,7,2,5,4,3,3,1,4,5,1,4,3
3,4,0,1,3,2,1,0,4,0,3,1,1,0,1,0,4,0,3,1,1,0,1,0
1,2,4,0,26,7,19,1,2,4,1,0,19,5,14,1,2,4,1,0,14,4,10,1
2,4,2,4,1,0,1,0,4,2,2,4,1,0,1,0,4,2,2,4,1,0,1,0
0,2,2,1,17,1,16,4,2,2,0,1,16,1,15,4,2,2,0,1,15,1,14,4
2,2,1,4,11,5,6,5,2,1,2,4,6,2,4,3,2,1,2,4,4,2,2,1
1,1,1,3,18,5,13,9,1,1,1,3,13,3,10,7,1,1,1,3,10,2,8,5
2,1,3,4,26,13,13,11,1,3,2,4,13,6,7,6,1,3,2,4,7,3,4,3
0,3,2,2,9,0,9,4,3,2,0,2,9,0,9,4,3,2,0,2,9,0,9,4
0,2,4,4,28,2,26,23,2,4,0,4,26,2,24,21,2,4,0,4,24,2,22,19
0,3,1,2,8,0,8,4,3,1,0,2,8,0,8,3,3,1,0,2,8,0,8,3
2,0,2,0,26,13,13,1,0,2,2,0,13,6,7,0,0,2,2,0,7,3,4,0
0,4,3,2,7,0,7,3,4,3,0,2,7,0,7,3,4,3,0,2,7,0,7,3
1,3,2,3,12,3,9,6,3,2,1,3,9,2,7,4,3,2,1,3,7,2,5,3
3,3,2,4,12,8,4,3,3,2,3,4,4,2,2,1,3,2,3,4,2,1,1,0
1,1,1,1,17,5,12,3,1,1,1,1,12,3,9,2,1,1,1,1,9,2,7,2
1,2,3,1,23,6,17,5,2,3,1,1,17,5,12,3,2,3,1,1,12,3,9,2
4,3,3,4,2,1,1,0,3,3,4,4,1,0,1,0,3,3,4,4,1,0,1,0
2,0,0,4,6,3,3,2,0,0,2,4,3,1,2,1,0,0,2,4,2,0,2,1
1,3,4,4,18,5,13,11,3,4,1,4,13,3,10,8,3,4,1,4,10,3,7,6
0,3,4,1,14,1,13,3,3,4,0,1,13,1,12,3,3,4,0,1,12,1,11,3
1,3,3,0,21,6,15,1,3,3,1,0,15,4,11,1,3,3,1,0,11,3,8,0
0,2,4,2,22,2,20,10,2,4,0,2,20,2,18,9,2,4,0,2,18,1,17,8
2,4,2,3,7,3,4,2,4,2,2,3,4,1,3,2,4,2,2,3,3,1,2,1
2,3,3,0,10,4,6,0,3,3,2,0,6,2,4,0,3,3,2,0,4,2,2,0
1,1,0,3,7,2,5,3,1,0,1,3,5,1,4,2,1,0,1,3,4,1,3,2
4,2,3,0,20,18,2,0,2,3,4,0,2,1,1,0,2,3,4,0,1,0,1,0
0,2,1,0,15,1,14,1,2,1,0,0,14,1,13,1,2,1,0,0,13,1,12,1
1,3,0,3,3,0,3,2,3,0,1,3,3,0,3,2,3,0,1,3,3,0,3,2
1,4,1,1,3,0,3,0,4,1,1,1,3,0,3,0,4,1,1,1,3,0,3,0
3,2,3,1,10,7,3,0,2,3,3,1,3,2,1,0,2,3,3,1,1,0,1,0
0,0,3,3,28,2,26,18,0,3,0,3,26,2,24,16,0,3,0,3,24,2,22,15
1,4,4,0,11,3,8,0,4,4,1,0,8,2,6,0,4,4,1,0,6,1,5,0
4,1,4,4,26,23,3,2,1,4,4,4,3,2,1,0,1,4,4,4,1,0,1,0
2,3,3,0,7,3,4,0,3,3,2,0,4,2,2,0,3,3,2,0,2,0,2,0
1,1,3,2,29,8,21,10,1,3,1,2,21,6,15,7,1,3,1,2,15,4,11,5
3,4,2,2,7,4,3,1,4,2,3,2,3,2,1,0,4,2,3,2,1,0,1,0
2,2,0,1,8,4,4,1,2,0,2,1,4,1,3,0,2,0,2,1,3,1,2,0
4,3,2,1,8,7,1,0,3,2,4,1,1,0,1,0,3,2,4,1,1,0,1,0
0,3,2,4,8,0,8,7,3,2,0,4,8,0,8,7,3,2,0,4,8,0,8,7
1,2,0,2,8,2,6,2,2,0,1,2,6,1,5,2,2,0,1,2,5,1,4,1
1,1,0,0,1,0,1,0,1,0,1,0,1,0,1,0,1,0,1,0,1,0,1,0
4,0,3,0,29,26,3,0,0,3,4,0,3,2,1,0,0,3,4,0,1,0,1,0
4,4,1,4,6,5,1,0,4,1,4,4,1,0,1,0,4,1,4,4,1,0,1,0
1,1,4,3,29,8,21,14,1,4,1,3,21,6,15,10,1,4,1,3,15,4,11,7
3,0,2,1,20,14,6,1,0,2,3,1,6,4,2,0,0,2,3,1,2,1,1,0
0,1,3,0,24,2,22,2,1,3,0,0,22,2,20,1,1,3,0,0,20,1,19,1
0,3,3,2,20,2,18,9,3,3,0,2,18,1,17,8,3,3,0,2,17,1,16,7
4,2,0,4,7,6,1,0,2,0,4,4,1,0,1,0,2,0,4,4,1,0,1,0
1,2,1,3,12,3,9,6,2,1,1,3,9,2,7,4,2,1,1,3,7,2,5,3
1,0,4,4,28,8,20,18,0,4,1,4,20,5,15,13,0,4,1,4,15,4,11,9
4,3,4,0,12,10,2,0,3,4,4,0,2,1,1,0,3,4,4,0,1,0,1,0
2,0,2,4,23,11,12,10,0,2,2,4,12,5,7,6,0,2,2,4,7,3,4,3
4,3,4,4,21,18,3,2,3,4,4,4,3,2,1,0,3,4,4,4,1,0,1,0
4,1,2,0,18,16,2,0,1,2,4,0,2,1,1,0,1,2,4,0,1,0,1,0
3,4,4,3,9,6,3,2,4,4,3,3,3,2,1,0,4,4,3,3,1,0,1,0
0,0,2,4,19,1,18,16,0,2,0,4,18,1,17,15,0,2,0,4,17,1,16,14
4,2,2,0,11,9,2,0,2,2,4,0,2,1,1,0,2,2,4,0,1,0,1,0
1,2,3,2,24,7,17,8,2,3,1,2,17,5,12,5,2,3,1,2,12,3,9,4
1,3,3,1,16,4,12,3,3,3,1,1,12,3,9,2,3,3,1,1,9,2,7,2
1,0,2,4,23,6,17,15,0,2,1,4,17,5,12,10,0,2,1,4,12,3,9,8
4,3,3,3,10,9,1,0,3,3,4,3,1,0,1,0,3,3,4,3,1,0,1,0
1,0,4,1,27,8,19,5,0,4,1,1,19,5,14,4,0,4,1,1,14,4,10,2
2,1,1,2,14,7,7,3,1,1,2,2,7,3,4,1,1,1,2,2,4,1,3,1
0,3,2,1,15,1,14,4,3,2,0,1,14,1,13,3,3,2,0,1,13,1,12,3
0,4,4,3,7,0,7,4,4,4,0,3,7,0,7,4,4,4,0,3,7,0,7,4
4,4,0,1,2,1,1,0,4,0,4,1,1,0,1,0,4,0,4,1,1,0,1,0
2,2,2,4,12,6,6,5,2,2,2,4,6,3,3,2,2,2,2,4,3,1,2,1
4,2,2,2,19,17,2,1,2,2,4,2,2,1,1,0,2,2,4,2,1,0,1,0
1,3,2,0,8,2,6,0,3,2,1,0,6,1,5,0,3,2,1,0,5,1,4,0
4,0,0,2,8,7,1,0,0,0,4,2,1,0,1,0,0,0,4,2,1,0,1,0
3,1,3,1,24,16,8,2,1,3,3,1,8,5,3,0,1,3,3,1,3,2,1,0
0,4,0,0,3,0,3,0,4,0,0,0,3,0,3,0,4,0,0,0,3,0,3,0
0,1,2,1,13,1,12,3,1,2,0,1,12,1,11,3,1,2,0,1,11,1,10,2
3,4,3,4,8,5,3,2,4,3,3,4,3,2,1,0,4,3,3,4,1,0,1,0
3,4,1,3,9,6,3,2,4,1,3,3,3,2,1,0,4,1,3,3,1,0,1,0
2,4,4,2,2,1,1,0,4,4,2,2,1,0,1,0,4,4,2,2,1,0,1,0
1,3,4,3,15,4,11,7,3,4,1,3,11,3,8,5,3,4,1,3,8,2,6,4
0,2,3,4,20,1,19,17,2,3,0,4,19,1,18,16,2,3,0,4,18,1,17,15
3,0,3,3,29,20,9,6,0,3,3,3,9,6,3,2,0,3,3,3,3,2,1,0
4,3,0,4,3,2,1,0,3,0,4,4,1,0,1,0,3,0,4,4,1,0,1,0
4,1,3,4,20,17,3,2,1,3,4,4,3,2,1,0,1,3,4,4,1,0,1,0
0,0,4,1,28,2,26,7,0,4,0,1,26,2,24,7,0,4,0,1,24,2,22,6
2,1,4,4,25,12,13,11,1,4,2,4,13,6,7,6,1,4,2,4,7,3,4,3
0,4,1,3,1,0,1,0,4,1,0,3,1,0,1,0,4,1,0,3,1,0,1,0
0,0,3,1,25,2,23,6,0,3,0,1,23,2,21,6,0,3,0,1,21,2,19,5
4,3,4,4,16,14,2,1,3,4,4,4,2,1,1,0,3,4,4,4,1,0,1,0
0,0,3,3,29,2,27,18,0,3,0,3,27,2,25,17,0,3,0,3,25,2,23,16
0,1,3,0,27,2,25,2,1,3,0,0,25,2,23,2,1,3,0,0,23,2,21,2
1,2,4,2,19,5,14,7,2,4,1,2,14,4,10,5,2,4,1,2,10,2,8,3
3,2,3,3,19,13,6,4,2,3,3,3,6,4,2,1,2,3,3,3,2,1,1,0
2,0,4,1,27,13,14,4,0,4,2,1,14,7,7,2,0,4,2,1,7,3,4,1
1,1,0,3,3,0,3,2,1,0,1,3,3,0,3,2,1,0,1,3,3,0,3,2
4,0,2,2,19,17,2,1,0,2,4,2,2,1,1,0,0,2,4,2,1,0,1,0
3,4,2,4,6,4,2,1,4,2,3,4,2,1,1,0,4,2,3,4,1,0,1,0
0,1,1,3,16,1,15,10,1,1,0,3,15,1,14,9,1,1,0,3,14,1,13,9
3,3,2,3,16,11,5,3,3,2,3,3,5,3,2,1,3,2,3,3,2,1,1,0
0,4,4,3,5,0,5,3,4,4,0,3,5,0,5,3,4,4,0,3,5,0,5,3
3,1,0,0,8,5,3,0,1,0,3,0,3,2,1,0,1,0,3,0,1,0,1,0
1,4,3,0,9,2,7,0,4,3,1,0,7,2,5,0,4,3,1,0,5,1,4,0
4,3,3,1,7,6,1,0,3,3,4,1,1,0,1,0,3,3,4,1,1,0,1,0
1,1,1,1,16,4,12,3,1,1,1,1,12,3,9,2,1,1,1,1,9,2,7,2
2,0,3,0,26,12,14,1,0,3,2,0,14,7,7,0,0,3,2,0,7,3,4,0
4,0,1,4,20,18,2,1,0,1,4,4,2,1,1,0,0,1,4,4,1,0,1,0
2,1,3,1,21,10,11,3,1,3,2,1,11,5,6,1,1,3,2,1,6,3,3,0
4,2,0,0,5,4,1,0,2,0,4,0,1,0,1,0,2,0,4,0,1,0,1,0
3,3,2,0,10,6,4,0,3,2,3,0,4,2,2,0,3,2,3,0,2,1,1,0
1,4,4,1,10,2,8,2,4,4,1,1,8,2,6,1,4,4,1,1,6,1,5,1
0,4,0,1,6,0,6,1,4,0,0,1,6,0,6,1,4,0,0,1,6,0,6,1
4,1,1,0,16,14,2,0,1,1,4,0,2,1,1,0,1,1,4,0,1,0,1,0
4,3,1,4,6,5,1,0,3,1,4,4,1,0,1,0,3,1,4,4,1,0,1,0
4,3,4,0,14,12,2,0,3,4,4,0,2,1,1,0,3,4,4,0,1,0,1,0
4,0,1,1,14,12,2,0,0,1,4,1,2,1,1,0,0,1,4,1,1,0,1,0
3,2,0,1,15,10,5,1,2,0,3,1,5,3,2,0,2,0,3,1,2,1,1,0
2,1,1,1,14,7,7,2,1,1,2,1,7,3,4,1,1,1,2,1,4,2,2,0
4,4,0,1,11,9,2,0,4,0,4,1,2,1,1,0,4,0,4,1,1,0,1,0
3,2,0,2,1,0,1,0,2,0,3,2,1,0,1,0,2,0,3,2,1,0,1,0
4,2,3,1,22,19,3,0,2,3,4,1,3,2,1,0,2,3,4,1,1,0,1,0
1,2,0,0,6,1,5,0,2,0,1,0,5,1,4,0,2,0,1,0,4,1,3,0
3,2,1,1,9,6,3,0,2,1,3,1,3,2,1,0,2,1,3,1,1,0,1,0
2,2,2,1,9,4,5,1,2,2,2,1,5,2,3,0,2,2,2,1,3,1,2,0
4,1,2,0,16,14,2,0,1,2,4,0,2,1,1,0,1,2,4,0,1,0,1,0
4,4,0,2,6,5,1,0,4,0,4,2,1,0,1,0,4,0,4,2,1,0,1,0
4,1,3,0,9,8,1,0,1,3,4,0,1,0,1,0,1,3,4,0,1,0,1,0
4,0,0,2,6,5,1,0,0,0,4,2,1,0,1,0,0,0,4,2,1,0,1,0
1,3,3,3,8,2,6,4,3,3,1,3,6,1,5,3,3,3,1,3,5,1,4,2
3,1,2,4,22,15,7,6,1,2,3,4,7,4,3,2,1,2,3,4,3,2,1,0
3,1,1,1,8,5,3,0,1,1,3,1,3,2,1,0,1,1,3,1,1,0,1,0
4,4,3,2,6,5,1,0,4,3,4,2,1,0,1,0,4,3,4,2,1,0,1,0
1,0,0,0,4,1,3,0,0,0,1,0,3,0,3,0,0,0,1,0,3,0,3,0
1,3,1,1,9,2,7,2,3,1,1,1,7,2,5,1,3,1,1,1,5,1,4,1
4,0,0,4,11,9,2,1,0,0,4,4,2,1,1,0,0,0,4,4,1,0,1,0
2,0,0,0,9,4,5,0,0,0,2,0,5,2,3,0,0,0,2,0,3,1,2,0
2,1,4,3,28,14,14,9,1,4,2,3,14,6,8,5,1,4,2,3,8,4,4,2
4,2,4,3,19,17,2,1,2,4,4,3,2,1,1,0,2,4,4,3,1,0,1,0
4,0,1,2,18,16,2,1,0,1,4,2,2,1,1,0,0,1,4,2,1,0,1,0
0,2,2,2,13,1,12,6,2,2,0,2,12,1,11,5,2,2,0,2,11,1,10,5
0,1,3,4,26,2,24,21,1,3,0,4,24,2,22,19,1,3,0,4,22,2,20,18
3,0,0,3,11,7,4,2,0,0,3,3,4,2,2,1,0,0,3,3,2,1,1,0
3,2,0,3,16,11,5,3,2,0,3,3,5,3,2,1,2,0,3,3,2,1,1,0
4,4,3,0,3,2,1,0,4,3,4,0,1,0,1,0,4,3,4,0,1,0,1,0
4,0,0,3,5,4,1,0,0,0,4,3,1,0,1,0,0,0,4,3,1,0,1,0
2,4,2,3,0,0,0,0,4,2,2,3,0,0,0,0,4,2,2,3,0,0,0,0
1,3,4,1,17,5,12,3,3,4,1,1,12,3,9,2,3,4,1,1,9,2,7,2
3,4,1,0,9,6,3,0,4,1,3,0,3,2,1,0,4,1,3,0,1,0,1,0
3,3,1,0,3,2,1,0,3,1,3,0,1,0,1,0,3,1,3,0,1,0,1,0
0,4,2,3,3,0,3,2,4,2,0,3,3,0,3,2,4,2,0,3,3,0,3,2
0,1,3,4,15,1,14,12,1,3,0,4,14,1,13,11,1,3,0,4,13,1,12,10
0,0,3,2,28,2,26,12,0,3,0,2,26,2,24,12,0,3,0,2,24,2,22,11
0,0,2,1,18,1,17,5,0,2,0,1,17,1,16,4,0,2,0,1,16,1,15,4
1,1,0,0,15,4,11,1,1,0,1,0,11,3,8,0,1,0,1,0,8,2,6,0
3,2,2,2,11,7,4,2,2,2,3,2,4,2,2,1,2,2,3,2,2,1,1,0
1,1,3,4,29,8,21,18,1,3,1,4,21,6,15,13,1,3,1,4,15,4,11,9
4,2,4,0,25,22,3,0,2,4,4,0,3,2,1,0,2,4,4,0,1,0,1,0
2,2,0,0,3,1,2,0,2,0,2,0,2,1,1,0,2,0,2,0,1,0,1,0
4,1,4,0,29,26,3,0,1,4,4,0,3,2,1,0,1,4,4,0,1,0,1,0
2,3,0,2,7,3,4,1,3,0,2,2,4,2,2,0,3,0,2,2,2,0,2,1
2,1,4,1,28,14,14,4,1,4,2,1,14,6,8,2,1,4,2,1,8,4,4,1
0,1,2,3,22,2,20,13,1,2,0,3,20,2,18,12,1,2,0,3,18,1,17,11
2,2,4,0,16,7,9,0,2,4,2,0,9,4,5,0,2,4,2,0,5,2,3,0
3,2,3,2,24,16,8,3,2,3,3,2,8,5,3,1,2,3,3,2,3,2,1,0
1,3,2,0,9,2,7,0,3,2,1,0,7,2,5,0,3,2,1,0,5,1,4,0
2,2,3,1,18,8,10,3,2,3,2,1,10,4,6,1,2,3,2,1,6,3,3,0
1,3,2,4,17,5,12,10,3,2,1,4,12,3,9,8,3,2,1,4,9,2,7,6
0,0,3,1,29,2,27,8,0,3,0,1,27,2,25,7,0,3,0,1,25,2,23,6
4,3,0,0,3,2,1,0,3,0,4,0,1,0,1,0,3,0,4,0,1,0,1,0
1,4,0,2,3,0,3,1,4,0,1,2,3,0,3,1,4,0,1,2,3,0,3,1
3,4,0,0,1,0,1,0,4,0,3,0,1,0,1,0,4,0,3,0,1,0,1,0
0,3,3,0,15,1,14,1,3,3,0,0,14,1,13,1,3,3,0,0,13,1,12,1
1,3,3,2,15,4,11,5,3,3,1,2,11,3,8,4,3,3,1,2,8,2,6,3
3,3,3,2,17,11,6,3,3,3,3,2,6,4,2,0,3,3,3,2,2,1,1,0
1,2,2,2,17,5,12,6,2,2,1,2,12,3,9,4,2,2,1,2,9,2,7,3
0,2,0,1,9,0,9,2,2,0,0,1,9,0,9,2,2,0,0,1,9,0,9,2
3,0,2,0,19,13,6,0,0,2,3,0,6,4,2,0,0,2,3,0,2,1,1,0
0,0,4,2,29,2,27,13,0,4,0,2,27,2,25,12,0,4,0,2,25,2,23,11
3,2,2,4,20,13,7,6,2,2,3,4,7,4,3,2,2,2,3,4,3,2,1,0
4,4,0,3,2,1,1,0,4,0,4,3,1,0,1,0,4,0,4,3,1,0,1,0
3,4,1,3,7,4,3,2,4,1,3,3,3,2,1,0,4,1,3,3,1,0,1,0
0,4,3,1,1,0,1,0,4,3,0,1,1,0,1,0,4,3,0,1,1,0,1,0
0,4,4,4,4,0,4,3,4,4,0,4,4,0,4,3,4,4,0,4,4,0,4,3
2,2,1,3,16,7,9,6,2,1,2,3,9,4,5,3,2,1,2,3,5,2,3,2
2,4,1,1,8,4,4,1,4,1,2,1,4,1,3,0,4,1,2,1,3,1,2,0
3,3,2,0,8,5,3,0,3,2,3,0,3,2,1,0,3,2,3,0,1,0,1,0
3,2,1,4,6,4,2,1,2,1,3,4,2,1,1,0,2,1,3,4,1,0,1,0
2,1,0,2,3,1,2,1,1,0,2,2,2,1,1,0,1,0,2,2,1,0,1,0
4,0,4,1,29,26,3,0,0,4,4,1,3,2,1,0,0,4,4,1,1,0,1,0
0,3,4,0,8,0,8,0,3,4,0,0,8,0,8,0,3,4,0,0,8,0,8,0
1,4,4,2,6,1,5,2,4,4,1,2,5,1,4,2,4,4,1,2,4,1,3,1
4,3,4,2,16,14,2,1,3,4,4,2,2,1,1,0,3,4,4,2,1,0,1,0
3,3,1,3,6,4,2,1,3,1,3,3,2,1,1,0,3,1,3,3,1,0,1,0
0,0,2,1,21,2,19,5,0,2,0,1,19,1,18,5,0,2,0,1,18,1,17,5
1,1,1,2,10,3,7,3,1,1,1,2,7,2,5,2,1,1,1,2,5,1,4,1
2,2,2,4,12,5,7,6,2,2,2,4,7,3,4,3,2,2,2,4,4,2,2,1
3,2,3,4,16,11,5,4,2,3,3,4,5,3,2,1,2,3,3,4,2,1,1,0
2,0,1,4,15,7,8,7,0,1,2,4,8,4,4,3,0,1,2,4,4,2,2,1
4,3,1,4,5,4,1,0,3,1,4,4,1,0,1,0,3,1,4,4,1,0,1,0
3,3,1,4,13,9,4,3,3,1,3,4,4,2,2,1,3,1,3,4,2,1,1,0
1,2,0,2,0,0,0,0,2,0,1,2,0,0,0,0,2,0,1,2,0,0,0,0
1,0,1,4,15,4,11,9,0,1,1,4,11,3,8,7,0,1,1,4,8,2,6,5
0,4,1,2,3,0,3,1,4,1,0,2,3,0,3,1,4,1,0,2,3,0,3,1
1,3,3,0,11,3,8,0,3,3,1,0,8,2,6,0,3,3,1,0,6,1,5,0
4,2,2,1,13,11,2,0,2,2,4,1,2,1,1,0,2,2,4,1,1,0,1,0
4,3,1,4,2,1,1,0,3,1,4,4,1,0,1,0,3,1,4,4,1,0,1,0
1,2,4,2,25,7,18,8,2,4,1,2,18,5,13,6,2,4,1,2,13,3,10,5
0,2,3,0,18,1,17,1,2,3,0,0,17,1,16,1,2,3,0,0,16,1,15,1
3,4,3,3,8,5,3,2,4,3,3,3,3,2,1,0,4,3,3,3,1,0,1,0
1,0,0,2,14,4,10,5,0,0,1,2,10,3,7,3,0,0,1,2,7,2,5,2
1,0,3,2,24,7,17,8,0,3,1,2,17,5,12,6,0,3,1,2,12,3,9,4
3,2,1,1,17,11,6,1,2,1,3,1,6,4,2,0,2,1,3,1,2,1,1,0
3,0,3,1,29,20,9,2,0,3,3,1,9,6,3,0,0,3,3,1,3,2,1,0
1,3,3,3,5,1,4,2,3,3,1,3,4,1,3,2,3,3,1,3,3,0,3,2
0,0,2,3,18,1,17,11,0,2,0,3,17,1,16,11,0,2,0,3,16,1,15,10
0,4,3,1,6,0,6,1,4,3,0,1,6,0,6,1,4,3,0,1,6,0,6,1
4,2,3,4,12,10,2,1,2,3,4,4,2,1,1,0,2,3,4,4,1,0,1,0
3,1,1,0,6,4,2,0,1,1,3,0,2,1,1,0,1,1,3,0,1,0,1,0
4,1,4,4,28,25,3,2,1,4,4,4,3,2,1,0,1,4,4,4,1,0,1,0
2,3,0,1,12,5,7,2,3,0,2,1,7,3,4,1,3,0,2,1,4,2,2,0
4,3,1,1,2,1,1,0,3,1,4,1,1,0,1,0,3,1,4,1,1,0,1,0
1,3,3,1,17,5,12,3,3,3,1,1,12,3,9,2,3,3,1,1,9,2,7,2
2,3,2,0,9,4,5,0,3,2,2,0,5,2,3,0,3,2,2,0,3,1,2,0
4,0,1,0,22,19,3,0,0,1,4,0,3,2,1,0,0,1,4,0,1,0,1,0
2,4,4,4,7,3,4,3,4,4,2,4,4,2,2,1,4,4,2,4,2,0,2,1
0,1,4,4,26,2,24,21,1,4,0,4,24,2,22,19,1,4,0,4,22,2,20,17
2,2,0,2,8,3,5,2,2,0,2,2,5,2,3,1,2,0,2,2,3,1,2,0
0,4,0,3,2,0,2,1,4,0,0,3,2,0,2,1,4,0,0,3,2,0,2,1
2,1,4,1,21,10,11,3,1,4,2,1,11,5,6,1,1,4,2,1,6,3,3,0
4,2,0,3,14,12,2,1,2,0,4,3,2,1,1,0,2,0,4,3,1,0,1,0
0,2,2,3,22,2,20,13,2,2,0,3,20,1,19,13,2,2,0,3,19,1,18,12
1,4,0,2,12,3,9,4,4,0,1,2,9,2,7,3,4,0,1,2,7,2,5,2
3,3,3,4,18,12,6,5,3,3,3,4,6,4,2,1,3,3,3,4,2,1,1,0
2,2,2,1,15,7,8,2,2,2,2,1,8,3,5,1,2,2,2,1,5,2,3,0
1,0,3,3,25,7,18,12,0,3,1,3,18,5,13,9,0,3,1,3,13,3,10,7
4,1,0,0,7,6,1,0,1,0,4,0,1,0,1,0,1,0,4,0,1,0,1,0
1,0,1,4,13,3,10,9,0,1,1,4,10,2,8,7,0,1,1,4,8,2,6,5
0,0,3,0,28,2,26,2,0,3,0,0,26,2,24,2,0,3,0,0,24,2,22,2
4,4,2,4,9,8,1,0,4,2,4,4,1,0,1,0,4,2,4,4,1,0,1,0
1,1,3,3,16,4,12,8,1,3,1,3,12,3,9,6,1,3,1,3,9,2,7,4
1,3,1,0,3,0,3,0,3,1,1,0,3,0,3,0,3,1,1,0,3,0,3,0
4,0,3,1,27,24,3,0,0,3,4,1,3,2,1,0,0,3,4,1,1,0,1,0
1,2,2,0,15,4,11,1,2,2,1,0,11,3,8,0,2,2,1,0,8,2,6,0
0,4,3,3,9,0,9,6,4,3,0,3,9,0,9,6,4,3,0,3,9,0,9,6
4,2,1,0,6,5,1,0,2,1,4,0,1,0,1,0,2,1,4,0,1,0,1,0
2,0,1,3,12,6,6,4,0,1,2,3,6,3,3,2,0,1,2,3,3,1,2,1
4,3,1,0,8,7,1,0,3,1,4,0,1,0,1,0,3,1,4,0,1,0,1,0
1,3,1,0,5,1,4,0,3,1,1,0,4,1,3,0,3,1,1,0,3,0,3,0
2,4,2,1,8,3,5,1,4,2,2,1,5,2,3,0,4,2,2,1,3,1,2,0
0,2,1,4,6,0,6,5,2,1,0,4,6,0,6,5,2,1,0,4,6,0,6,5
1,3,4,2,7,2,5,2,3,4,1,2,5,1,4,2,3,4,1,2,4,1,3,1
0,4,1,2,6,0,6,3,4,1,0,2,6,0,6,2,4,1,0,2,6,0,6,3
4,3,4,0,14,12,2,0,3,4,4,0,2,1,1,0,3,4,4,0,1,0,1,0
2,3,2,3,10,4,6,4,3,2,2,3,6,3,3,2,3,2,2,3,3,1,2,1
3,4,1,3,8,5,3,2,4,1,3,3,3,2,1,0,4,1,3,3,1,0,1,0
2,3,4,2,7,3,4,2,3,4,2,2,4,1,3,1,3,4,2,2,3,1,2,0
3,0,3,0,28,19,9,0,0,3,3,0,9,6,3,0,0,3,3,0,3,2,1,0
2,1,2,4,18,8,10,9,1,2,2,4,10,5,5,4,1,2,2,4,5,2,3,2
1,4,1,1,2,0,2,0,4,1,1,1,2,0,2,0,4,1,1,1,2,0,2,0
3,2,0,4,7,4,3,2,2,0,3,4,3,2,1,0,2,0,3,4,1,0,1,0
2,4,4,1,10,5,5,1,4,4,2,1,5,2,3,0,4,4,2,1,3,1,2,0
0,1,3,3,18,1,17,11,1,3,0,3,17,1,16,11,1,3,0,3,16,1,15,10
4,4,3,1,15,13,2,0,4,3,4,1,2,1,1,0,4,3,4,1,1,0,1,0
2,4,1,1,6,2,4,1,4,1,2,1,4,2,2,0,4,1,2,1,2,0,2,0
4,4,3,3,15,13,2,1,4,3,4,3,2,1,1,0,4,3,4,3,1,0,1,0
2,3,1,1,2,1,1,0,3,1,2,1,1,0,1,0,3,1,2,1,1,0,1,0
3,2,3,1,22,15,7,2,2,3,3,1,7,4,3,0,2,3,3,1,3,2,1,0
3,0,0,0,11,7,4,0,0,0,3,0,4,2,2,0,0,0,3,0,2,1,1,0
4,0,4,0,28,25,3,0,0,4,4,0,3,2,1,0,0,4,4,0,1,0,1,0
3,0,0,0,9,6,3,0,0,0,3,0,3,2,1,0,0,0,3,0,1,0,1,0
1,2,1,0,13,3,10,0,2,1,1,0,10,3,7,0,2,1,1,0,7,2,5,0
1,3,0,4,3,0,3,2,3,0,1,4,3,0,3,2,3,0,1,4,3,0,3,2
4,4,1,0,2,1,1,0,4,1,4,0,1,0,1,0,4,1,4,0,1,0,1,0
1,3,3,2,10,3,7,3,3,3,1,2,7,2,5,2,3,3,1,2,5,1,4,2
0,2,4,4,20,2,18,16,2,4,0,4,18,1,17,15,2,4,0,4,17,1,16,14
3,1,4,4,23,16,7,6,1,4,3,4,7,4,3,2,1,4,3,4,3,2,1,0
3,1,2,2,16,11,5,2,1,2,3,2,5,3,2,0,1,2,3,2,2,1,1,0
3,3,4,3,11,7,4,2,3,4,3,3,4,2,2,1,3,4,3,3,2,1,1,0
2,4,1,0,9,4,5,0,4,1,2,0,5,2,3,0,4,1,2,0,3,1,2,0
1,4,3,2,3,0,3,1,4,3,1,2,3,0,3,1,4,3,1,2,3,0,3,1
2,0,3,4,22,10,12,10,0,3,2,4,12,6,6,5,0,3,2,4,6,2,4,3
3,4,1,4,3,2,1,0,4,1,3,4,1,0,1,0,4,1,3,4,1,0,1,0
1,4,4,1,21,6,15,4,4,4,1,1,15,4,11,3,4,4,1,1,11,3,8,2
4,1,3,0,22,19,3,0,1,3,4,0,3,2,1,0,1,3,4,0,1,0,1,0
1,3,0,2,0,0,0,0,3,0,1,2,0,0,0,0,3,0,1,2,0,0,0,0
0,1,2,1,25,2,23,6,1,2,0,1,23,2,21,6,1,2,0,1,21,2,19,5
1,2,1,1,2,0,2,0,2,1,1,1,2,0,2,0,2,1,1,1,2,0,2,0
1,2,1,2,6,1,5,2,2,1,1,2,5,1,4,1,2,1,1,2,4,1,3,1
2,1,1,1,12,6,6,1,1,1,2,1,6,3,3,0,1,1,2,1,3,1,2,0
4,4,4,3,12,10,2,1,4,4,4,3,2,1,1,0,4,4,4,3,1,0,1,0
3,3,4,3,16,11,5,3,3,4,3,3,5,3,2,1,3,4,3,3,2,1,1,0
4,4,4,2,7,6,1,0,4,4,4,2,1,0,1,0,4,4,4,2,1,0,1,0
3,3,1,2,3,2,1,0,3,1,3,2,1,0,1,0,3,1,3,2,1,0,1,0
4,4,0,0,2,1,1,0,4,0,4,0,1,0,1,0,4,0,4,0,1,0,1,0
4,4,2,2,7,6,1,0,4,2,4,2,1,0,1,0,4,2,4,2,1,0,1,0
4,1,4,2,29,26,3,1,1,4,4,2,3,2,1,0,1,4,4,2,1,0,1,0
1,3,4,3,17,5,12,8,3,4,1,3,12,3,9,6,3,4,1,3,9,2,7,4
4,4,0,3,1,0,1,0,4,0,4,3,1,0,1,0,4,0,4,3,1,0,1,0
4,1,0,0,6,5,1,0,1,0,4,0,1,0,1,0,1,0,4,0,1,0,1,0
1,3,0,2,2,0,2,1,3,0,1,2,2,0,2,0,3,0,1,2,2,0,2,0
2,2,4,4,19,9,10,8,2,4,2,4,10,4,6,5,2,4,2,4,6,2,4,3
4,0,3,2,20,17,3,1,0,3,4,2,3,2,1,0,0,3,4,2,1,0,1,0
2,1,1,1,9,4,5,1,1,1,2,1,5,2,3,0,1,1,2,1,3,1,2,0
3,0,0,1,7,4,3,0,0,0,3,1,3,2,1,0,0,0,3,1,1,0,1,0
0,2,0,1,4,0,4,1,2,0,0,1,4,0,4,1,2,0,0,1,4,0,4,1
2,4,1,4,11,5,6,5,4,1,2,4,6,2,4,3,4,1,2,4,4,1,3,2
0,4,0,1,6,0,6,1,4,0,0,1,6,0,6,1,4,0,0,1,6,0,6,1
1,4,4,4,8,2,6,5,4,4,1,4,6,1,5,4,4,4,1,4,5,1,4,3
3,4,2,2,16,11,5,2,4,2,3,2,5,3,2,0,4,2,3,2,2,1,1,0
0,4,0,4,9,0,9,8,4,0,0,4,9,0,9,8,4,0,0,4,9,0,9,8
4,3,1,3,7,6,1,0,3,1,4,3,1,0,1,0,3,1,4,3,1,0,1,0
2,4,3,2,9,4,5,2,4,3,2,2,5,2,3,1,4,3,2,2,3,1,2,1
2,4,1,1,2,0,2,0,4,1,2,1,2,1,1,0,4,1,2,1,1,0,1,0
0,1,0,3,11,1,10,6,1,0,0,3,10,0,10,6,1,0,0,3,10,1,9,6
1,0,2,3,19,5,14,9,0,2,1,3,14,4,10,6,0,2,1,3,10,3,7,4
4,1,3,0,20,17,3,0,1,3,4,0,3,2,1,0,1,3,4,0,1,0,1,0
0,1,4,2,26,2,24,11,1,4,0,2,24,2,22,10,1,4,0,2,22,2,20,10
4,0,2,1,20,18,2,0,0,2,4,1,2,1,1,0,0,2,4,1,1,0,1,0
2,0,1,1,20,9,11,3,0,1,2,1,11,5,6,1,0,1,2,1,6,3,3,0
4,4,3,3,8,7,1,0,4,3,4,3,1,0,1,0,4,3,4,3,1,0,1,0
4,0,0,0,10,8,2,0,0,0,4,0,2,1,1,0,0,0,4,0,1,0,1,0
1,0,2,3,26,7,19,13,0,2,1,3,19,5,14,9,0,2,1,3,14,4,10,7
2,4,3,1,16,7,9,2,4,3,2,1,9,4,5,1,4,3,2,1,5,2,3,0
4,2,1,2,8,7,1,0,2,1,4,2,1,0,1,0,2,1,4,2,1,0,1,0
3,0,1,1,18,12,6,1,0,1,3,1,6,4,2,0,0,1,3,1,2,1,1,0
0,3,3,3,15,1,14,9,3,3,0,3,14,1,13,9,3,3,0,3,13,1,12,8
3,3,0,3,0,0,0,0,3,0,3,3,0,0,0,0,3,0,3,3,0,0,0,0
3,0,3,0,28,19,9,0,0,3,3,0,9,6,3,0,0,3,3,0,3,2,1,0
0,2,1,1,7,0,7,2,2,1,0,1,7,0,7,2,2,1,0,1,7,0,7,2
3,3,3,2,18,12,6,3,3,3,3,2,6,4,2,1,3,3,3,2,2,1,1,0
1,1,4,2,25,7,18,8,1,4,1,2,18,5,13,6,1,4,1,2,13,3,10,5
4,4,4,3,10,9,1,0,4,4,4,3,1,0,1,0,4,4,4,3,1,0,1,0
4,3,1,3,3,2,1,0,3,1,4,3,1,0,1,0,3,1,4,3,1,0,1,0
3,4,0,1,0,0,0,0,4,0,3,1,0,0,0,0,4,0,3,1,0,0,0,0
3,4,1,0,2,1,1,0,4,1,3,0,1,0,1,0,4,1,3,0,1,0,1,0
1,3,4,1,22,6,16,4,3,4,1,1,16,4,12,3,3,4,1,1,12,3,9,2
2,2,2,4,17,8,9,8,2,2,2,4,9,4,5,4,2,2,2,4,5,2,3,2
4,2,1,3,3,2,1,0,2,1,4,3,1,0,1,0,2,1,4,3,1,0,1,0
1,0,1,1,18,5,13,3,0,1,1,1,13,3,10,3,0,1,1,1,10,3,7,2
0,2,1,2,12,1,11,5,2,1,0,2,11,1,10,4,2,1,0,2,10,0,10,5
4,2,2,2,9,8,1,0,2,2,4,2,1,0,1,0,2,2,4,2,1,0,1,0
3,0,3,3,28,19,9,6,0,3,3,3,9,6,3,2,0,3,3,3,3,2,1,0
2,3,3,0,16,8,8,0,3,3,2,0,8,4,4,0,3,3,2,0,4,2,2,0
4,3,2,4,8,7,1,0,3,2,4,4,1,0,1,0,3,2,4,4,1,0,1,0
4,0,1,3,2,1,1,0,0,1,4,3,1,0,1,0,0,1,4,3,1,0,1,0
2,4,0,0,1,0,1,0,4,0,2,0,1,0,1,0,4,0,2,0,1,0,1,0
0,0,3,2,29,2,27,13,0,3,0,2,27,2,25,12,0,3,0,2,25,2,23,11
1,0,3,3,20,6,14,9,0,3,1,3,14,4,10,7,0,3,1,3,10,2,8,5
0,2,3,2,18,1,17,8,2,3,0,2,17,1,16,7,2,3,0,2,16,1,15,7
3,2,3,3,13,9,4,2,2,3,3,3,4,2,2,1,2,3,3,3,2,1,1,0
4,0,4,2,29,26,3,1,0,4,4,2,3,2,1,0,0,4,4,2,1,0,1,0
0,1,0,0,9,0,9,0,1,0,0,0,9,0,9,0,1,0,0,0,9,0,9,0
4,1,3,1,27,24,3,0,1,3,4,1,3,2,1,0,1,3,4,1,1,0,1,0
0,3,2,2,4,0,4,1,3,2,0,2,4,0,4,2,3,2,0,2,4,0,4,2
2,3,1,2,12,5,7,3,3,1,2,2,7,3,4,2,3,1,2,2,4,1,3,1
0,1,4,3,16,1,15,10,1,4,0,3,15,1,14,9,1,4,0,3,14,1,13,9
1,3,1,4,1,0,1,0,3,1,1,4,1,0,1,0,3,1,1,4,1,0,1,0
0,3,1,3,9,0,9,6,3,1,0,3,9,0,9,6,3,1,0,3,9,0,9,6
0,2,2,0,12,1,11,1,2,2,0,0,11,1,10,1,2,2,0,0,10,0,10,0
1,1,3,0,22,6,16,1,1,3,1,0,16,4,12,1,1,3,1,0,12,3,9,0
0,1,2,1,26,2,24,7,1,2,0,1,24,2,22,6,1,2,0,1,22,2,20,6
0,0,4,3,28,2,26,18,0,4,0,3,26,2,24,16,0,4,0,3,24,2,22,15
1,1,1,0,8,2,6,0,1,1,1,0,6,1,5,0,1,1,1,0,5,1,4,0
3,0,1,4,15,10,5,4,0,1,3,4,5,3,2,1,0,1,3,4,2,1,1,0
2,0,1,4,19,9,10,9,0,1,2,4,10,5,5,4,0,1,2,4,5,2,3,2
4,2,4,4,22,19,3,2,2,4,4,4,3,2,1,0,2,4,4,4,1,0,1,0
4,1,3,0,19,17,2,0,1,3,4,0,2,1,1,0,1,3,4,0,1,0,1,0
4,1,0,4,4,3,1,0,1,0,4,4,1,0,1,0,1,0,4,4,1,0,1,0
1,3,4,3,16,4,12,8,3,4,1,3,12,3,9,6,3,4,1,3,9,2,7,4
3,3,2,3,7,4,3,2,3,2,3,3,3,2,1,0,3,2,3,3,1,0,1,0
4,2,2,4,13,11,2,1,2,2,4,4,2,1,1,0,2,2,4,4,1,0,1,0
1,0,2,3,15,4,11,7,0,2,1,3,11,3,8,5,0,2,1,3,8,2,6,4
3,1,2,1,17,11,6,1,1,2,3,1,6,4,2,0,1,2,3,1,2,1,1,0
2,4,0,1,2,1,1,0,4,0,2,1,1,0,1,0,4,0,2,1,1,0,1,0
0,4,3,2,11,1,10,5,4,3,0,2,10,1,9,4,4,3,0,2,9,0,9,4
1,3,1,4,5,1,4,3,3,1,1,4,4,1,3,2,3,1,1,4,3,0,3,2
3,3,1,1,9,6,3,0,3,1,3,1,3,2,1,0,3,1,3,1,1,0,1,0
2,1,4,0,28,14,14,1,1,4,2,0,14,6,8,0,1,4,2,0,8,4,4,0
0,2,1,4,10,1,9,8,2,1,0,4,9,0,9,8,2,1,0,4,9,0,9,8
4,0,1,2,14,12,2,1,0,1,4,2,2,1,1,0,0,1,4,2,1,0,1,0
4,4,0,3,6,5,1,0,4,0,4,3,1,0,1,0,4,0,4,3,1,0,1,0
2,3,1,3,3,1,2,1,3,1,2,3,2,1,1,0,3,1,2,3,1,0,1,0
2,4,2,4,9,4,5,4,4,2,2,4,5,2,3,2,4,2,2,4,3,1,2,1
0,3,4,1,8,0,8,2,3,4,0,1,8,0,8,2,3,4,0,1,8,0,8,2
1,1,2,3,22,6,16,11,1,2,1,3,16,4,12,8,1,2,1,3,12,3,9,6
3,4,3,4,5,3,2,1,4,3,3,4,2,1,1,0,4,3,3,4,1,0,1,0
2,2,3,0,12,6,6,0,2,3,2,0,6,3,3,0,2,3,2,0,3,1,2,0
0,3,2,0,4,0,4,0,3,2,0,0,4,0,4,0,3,2,0,0,4,0,4,0
0,0,2,1,22,2,20,6,0,2,0,1,20,2,18,5,0,2,0,1,18,1,17,5
2,3,3,4,12,6,6,5,3,3,2,4,6,3,3,2,3,3,2,4,3,1,2,1
4,2,0,0,0,0,0,0,2,0,4,0,0,0,0,0,2,0,4,0,0,0,0,0
4,4,1,2,6,5,1,0,4,1,4,2,1,0,1,0,4,1,4,2,1,0,1,0
1,4,1,4,5,1,4,3,4,1,1,4,4,1,3,2,4,1,1,4,3,0,3,2
3,2,1,4,12,8,4,3,2,1,3,4,4,2,2,1,2,1,3,4,2,1,1,0
2,1,4,4,27,13,14,12,1,4,2,4,14,6,8,7,1,4,2,4,8,4,4,3
2,4,0,1,1,0,1,0,4,0,2,1,1,0,1,0,4,0,2,1,1,0,1,0
3,0,3,2,26,18,8,3,0,3,3,2,8,5,3,1,0,3,3,2,3,2,1,0
2,2,3,1,18,8,10,3,2,3,2,1,10,5,5,1,2,3,2,1,5,2,3,0
2,3,2,2,10,5,5,2,3,2,2,2,5,2,3,1,3,2,2,2,3,1,2,0
2,3,0,2,2,1,1,0,3,0,2,2,1,0,1,0,3,0,2,2,1,0,1,0
0,3,4,2,21,2,19,9,3,4,0,2,19,1,18,8,3,4,0,2,18,1,17,8
2,1,0,2,12,6,6,3,1,0,2,2,6,3,3,1,1,0,2,2,3,1,2,0
4,1,3,1,26,23,3,0,1,3,4,1,3,2,1,0,1,3,4,1,1,0,1,0
1,1,1,3,12,3,9,6,1,1,1,3,9,2,7,4,1,1,1,3,7,2,5,3
0,0,0,1,14,1,13,3,0,0,0,1,13,1,12,3,0,0,0,1,12,1,11,3
4,0,2,1,25,22,3,0,0,2,4,1,3,2,1,0,0,2,4,1,1,0,1,0
4,3,2,1,13,11,2,0,3,2,4,1,2,1,1,0,3,2,4,1,1,0,1,0
0,2,0,1,9,0,9,2,2,0,0,1,9,0,9,2,2,0,0,1,9,0,9,2
4,3,1,2,2,1,1,0,3,1,4,2,1,0,1,0,3,1,4,2,1,0,1,0
2,2,1,0,7,3,4,0,2,1,2,0,4,2,2,0,2,1,2,0,2,0,2,0
2,4,2,1,3,1,2,0,4,2,2,1,2,0,2,0,4,2,2,1,2,1,1,0
1,0,0,2,8,2,6,2,0,0,1,2,6,1,5,2,0,0,1,2,5,1,4,1
2,3,3,1,7,3,4,1,3,3,2,1,4,1,3,0,3,3,2,1,3,1,2,0
1,2,0,0,1,0,1,0,2,0,1,0,1,0,1,0,2,0,1,0,1,0,1,0
0,0,3,2,25,2,23,11,0,3,0,2,23,2,21,10,0,3,0,2,21,2,19,9
1,0,0,0,5,1,4,0,0,0,1,0,4,1,3,0,0,0,1,0,3,0,3,0
2,1,1,3,6,3,3,2,1,1,2,3,3,1,2,1,1,1,2,3,2,1,1,0
0,3,0,4,11,1,10,9,3,0,0,4,10,1,9,8,3,0,0,4,9,0,9,8
2,4,3,0,11,5,6,0,4,3,2,0,6,3,3,0,4,3,2,0,3,1,2,0
2,1,2,0,12,5,7,0,1,2,2,0,7,3,4,0,1,2,2,0,4,1,3,0
0,2,4,3,17,1,16,11,2,4,0,3,16,1,15,10,2,4,0,3,15,1,14,9
4,4,4,0,9,8,1,0,4,4,4,0,1,0,1,0,4,4,4,0,1,0,1,0
3,3,3,1,12,8,4,1,3,3,3,1,4,2,2,0,3,3,3,1,2,1,1,0
4,4,3,2,7,6,1,0,4,3,4,2,1,0,1,0,4,3,4,2,1,0,1,0
2,4,2,1,1,0,1,0,4,2,2,1,1,0,1,0,4,2,2,1,1,0,1,0
3,2,0,2,12,8,4,1,2,0,3,2,4,2,2,0,2,0,3,2,2,1,1,0
1,3,1,1,2,0,2,0,3,1,1,1,2,0,2,0,3,1,1,1,2,0,2,0
0,2,4,1,20,2,18,5,2,4,0,1,18,1,17,5,2,4,0,1,17,1,16,4
4,0,4,2,29,26,3,1,0,4,4,2,3,2,1,0,0,4,4,2,1,0,1,0
0,0,0,3,8,0,8,5,0,0,0,3,8,0,8,5,0,0,0,3,8,0,8,5
3,4,1,1,3,2,1,0,4,1,3,1,1,0,1,0,4,1,3,1,1,0,1,0
0,1,4,4,26,2,24,21,1,4,0,4,24,2,22,19,1,4,0,4,22,2,20,18
4,2,1,1,13,11,2,0,2,1,4,1,2,1,1,0,2,1,4,1,1,0,1,0
2,2,0,1,13,6,7,2,2,0,2,1,7,3,4,1,2,0,2,1,4,2,2,0
1,3,2,2,7,2,5,2,3,2,1,2,5,1,4,2,3,2,1,2,4,1,3,1
2,2,4,1,22,11,11,3,2,4,2,1,11,5,6,1,2,4,2,1,6,2,4,1
2,3,3,2,15,7,8,4,3,3,2,2,8,4,4,2,3,3,2,2,4,1,3,1
2,1,1,1,9,4,5,1,1,1,2,1,5,2,3,0,1,1,2,1,3,1,2,0
2,2,4,2,15,7,8,3,2,4,2,2,8,3,5,2,2,4,2,2,5,2,3,1
4,1,0,4,7,6,1,0,1,0,4,4,1,0,1,0,1,0,4,4,1,0,1,0
4,2,0,3,7,6,1,0,2,0,4,3,1,0,1,0,2,0,4,3,1,0,1,0
3,3,3,1,10,7,3,0,3,3,3,1,3,2,1,0,3,3,3,1,1,0,1,0
0,3,0,3,4,0,4,2,3,0,0,3,4,0,4,2,3,0,0,3,4,0,4,2
1,0,2,3,27,8,19,13,0,2,1,3,19,5,14,9,0,2,1,3,14,4,10,6
2,4,0,2,12,6,6,3,4,0,2,2,6,2,4,1,4,0,2,2,4,2,2,0
0,2,1,3,11,1,10,6,2,1,0,3,10,1,9,6,2,1,0,3,9,0,9,6
4,4,4,3,8,7,1,0,4,4,4,3,1,0,1,0,4,4,4,3,1,0,1,0
1,2,3,3,17,5,12,8,2,3,1,3,12,3,9,6,2,3,1,3,9,2,7,4
1,2,0,4,5,1,4,3,2,0,1,4,4,1,3,2,2,0,1,4,3,0,3,2
2,1,3,3,23,11,12,8,1,3,2,3,12,6,6,4,1,3,2,3,6,2,4,2
2,4,2,4,6,3,3,2,4,2,2,4,3,1,2,1,4,2,2,4,2,1,1,0
0,4,4,3,1,0,1,0,4,4,0,3,1,0,1,0,4,4,0,3,1,0,1,0
1,2,1,1,7,2,5,1,2,1,1,1,5,1,4,1,2,1,1,1,4,1,3,0
0,3,2,2,11,1,10,4,3,2,0,2,10,1,9,4,3,2,0,2,9,0,9,4
0,4,0,0,1,0,1,0,4,0,0,0,1,0,1,0,4,0,0,0,1,0,1,0
4,3,2,4,6,5,1,0,3,2,4,4,1,0,1,0,3,2,4,4,1,0,1,0
1,3,1,2,0,0,0,0,3,1,1,2,0,0,0,0,3,1,1,2,0,0,0,0
3,2,0,3,5,3,2,1,2,0,3,3,2,1,1,0,2,0,3,3,1,0,1,0
3,3,3,1,8,5,3,0,3,3,3,1,3,2,1,0,3,3,3,1,1,0,1,0
2,2,4,4,22,10,12,10,2,4,2,4,12,5,7,6,2,4,2,4,7,3,4,3
2,3,1,0,11,5,6,0,3,1,2,0,6,3,3,0,3,1,2,0,3,1,2,0
4,1,0,3,9,8,1,0,1,0,4,3,1,0,1,0,1,0,4,3,1,0,1,0
4,4,0,2,0,0,0,0,4,0,4,2,0,0,0,0,4,0,4,2,0,0,0,0
1,1,1,4,12,3,9,8,1,1,1,4,9,2,7,6,1,1,1,4,7,2,5,4
4,1,2,1,22,19,3,0,1,2,4,1,3,2,1,0,1,2,4,1,1,0,1,0
4,4,1,0,11,9,2,0,4,1,4,0,2,1,1,0,4,1,4,0,1,0,1,0
2,2,0,2,5,2,3,1,2,0,2,2,3,1,2,0,2,0,2,2,2,0,2,1
0,4,3,1,12,1,11,3,4,3,0,1,11,1,10,3,4,3,0,1,10,1,9,2
1,4,0,2,1,0,1,0,4,0,1,2,1,0,1,0,4,0,1,2,1,0,1,0
0,2,2,2,14,1,13,6,2,2,0,2,13,1,12,5,2,2,0,2,12,1,11,5
0,2,0,4,2,0,2,1,2,0,0,4,2,0,2,1,2,0,0,4,2,0,2,1
4,0,2,1,18,16,2,0,0,2,4,1,2,1,1,0,0,2,4,1,1,0,1,0
3,3,3,0,8,5,3,0,3,3,3,0,3,2,1,0,3,3,3,0,1,0,1,0
3,1,1,2,22,15,7,3,1,1,3,2,7,4,3,1,1,1,3,2,3,2,1,0
0,2,1,4,14,1,13,11,2,1,0,4,13,1,12,10,2,1,0,4,12,1,11,9
0,0,4,1,29,2,27,8,0,4,0,1,27,2,25,7,0,4,0,1,25,2,23,6
4,2,0,3,1,0,1,0,2,0,4,3,1,0,1,0,2,0,4,3,1,0,1,0
3,1,1,0,10,6,4,0,1,1,3,0,4,2,2,0,1,1,3,0,2,1,1,0
1,3,4,4,9,2,7,6,3,4,1,4,7,2,5,4,3,4,1,4,5,1,4,3
2,3,3,2,4,2,2,0,3,3,2,2,2,0,2,0,3,3,2,2,2,1,1,0
2,0,0,1,6,2,4,1,0,0,2,1,4,2,2,0,0,0,2,1,2,0,2,0
4,0,2,2,17,15,2,0,0,2,4,2,2,1,1,0,0,2,4,2,1,0,1,0
2,1,0,3,11,5,6,4,1,0,2,3,6,2,4,2,1,0,2,3,4,1,3,2
2,0,3,0,29,14,15,1,0,3,2,0,15,7,8,0,0,3,2,0,8,4,4,0
2,4,4,2,1,0,1,0,4,4,2,2,1,0,1,0,4,4,2,2,1,0,1,0
0,0,3,4,28,2,26,23,0,3,0,4,26,2,24,21,0,3,0,4,24,2,22,19
3,4,4,4,11,7,4,3,4,4,3,4,4,2,2,1,4,4,3,4,2,1,1,0
2,4,1,1,8,3,5,1,4,1,2,1,5,2,3,0,4,1,2,1,3,1,2,0
1,1,3,3,19,5,14,9,1,3,1,3,14,4,10,7,1,3,1,3,10,2,8,5
0,0,1,2,24,2,22,10,0,1,0,2,22,2,20,9,0,1,0,2,20,1,19,9
4,0,0,1,3,2,1,0,0,0,4,1,1,0,1,0,0,0,4,1,1,0,1,0
1,0,1,4,9,2,7,6,0,1,1,4,7,2,5,4,0,1,1,4,5,1,4,3
3,3,2,2,13,9,4,2,3,2,3,2,4,2,2,0,3,2,3,2,2,1,1,0
1,3,2,2,14,4,10,5,3,2,1,2,10,3,7,3,3,2,1,2,7,2,5,2
0,1,4,4,29,2,27,24,1,4,0,4,27,2,25,22,1,4,0,4,25,2,23,20
3,4,4,2,5,3,2,1,4,4,3,2,2,1,1,0,4,4,3,2,1,0,1,0
3,2,3,2,23,16,7,3,2,3,3,2,7,4,3,1,2,3,3,2,3,2,1,0
2,1,1,0,4,1,3,0,1,1,2,0,3,1,2,0,1,1,2,0,2,0,2,0
2,0,0,1,8,3,5,1,0,0,2,1,5,2,3,0,0,0,2,1,3,1,2,0
3,3,0,4,4,2,2,1,3,0,3,4,2,1,1,0,3,0,3,4,1,0,1,0
1,0,1,0,18,5,13,1,0,1,1,0,13,3,10,1,0,1,1,0,10,2,8,0
3,0,3,0,28,19,9,0,0,3,3,0,9,6,3,0,0,3,3,0,3,2,1,0
1,3,1,4,10,2,8,7,3,1,1,4,8,2,6,5,3,1,1,4,6,1,5,4
4,2,4,0,28,25,3,0,2,4,4,0,3,2,1,0,2,4,4,0,1,0,1,0
2,4,0,3,3,1,2,1,4,0,2,3,2,1,1,0,4,0,2,3,1,0,1,0
1,0,0,0,9,2,7,0,0,0,1,0,7,2,5,0,0,0,1,0,5,1,4,0
0,3,2,1,1,0,1,0,3,2,0,1,1,0,1,0,3,2,0,1,1,0,1,0
2,0,2,4,19,9,10,8,0,2,2,4,10,4,6,5,0,2,2,4,6,2,4,3
4,1,4,2,27,24,3,1,1,4,4,2,3,2,1,0,1,4,4,2,1,0,1,0
0,3,4,2,16,1,15,7,3,4,0,2,15,1,14,6,3,4,0,2,14,1,13,6
2,1,4,3,26,12,14,9,1,4,2,3,14,6,8,5,1,4,2,3,8,3,5,3
0,0,1,1,8,0,8,2,0,1,0,1,8,0,8,2,0,1,0,1,8,0,8,2
1,1,4,3,29,8,21,14,1,4,1,3,21,6,15,10,1,4,1,3,15,4,11,7
3,4,3,2,2,1,1,0,4,3,3,2,1,0,1,0,4,3,3,2,1,0,1,0
0,0,4,0,25,2,23,2,0,4,0,0,23,2,21,2,0,4,0,0,21,2,19,1
1,0,4,3,25,7,18,12,0,4,1,3,18,5,13,9,0,4,1,3,13,3,10,6
3,2,1,2,11,7,4,2,2,1,3,2,4,2,2,0,2,1,3,2,2,1,1,0
2,3,1,4,9,4,5,4,3,1,2,4,5,2,3,2,3,1,2,4,3,1,2,1
2,0,2,1,15,7,8,2,0,2,2,1,8,3,5,1,0,2,2,1,5,2,3,0
3,0,4,4,29,20,9,8,0,4,3,4,9,6,3,2,0,4,3,4,3,2,1,0
3,2,1,4,5,3,2,1,2,1,3,4,2,1,1,0,2,1,3,4,1,0,1,0
0,4,4,2,0,0,0,0,4,4,0,2,0,0,0,0,4,4,0,2,0,0,0,0
1,0,4,0,24,7,17,1,0,4,1,0,17,5,12,1,0,4,1,0,12,3,9,0
2,3,2,2,10,5,5,2,3,2,2,2,5,2,3,1,3,2,2,2,3,1,2,1
4,0,1,3,7,6,1,0,0,1,4,3,1,0,1,0,0,1,4,3,1,0,1,0
3,3,2,4,11,7,4,3,3,2,3,4,4,2,2,1,3,2,3,4,2,1,1,0
2,2,2,3,19,9,10,7,2,2,2,3,10,5,5,3,2,2,2,3,5,2,3,2
2,1,0,1,16,7,9,2,1,0,2,1,9,4,5,1,1,0,2,1,5,2,3,0
2,4,0,2,4,1,3,1,4,0,2,2,3,1,2,0,4,0,2,2,2,0,2,0
4,1,2,3,19,17,2,1,1,2,4,3,2,1,1,0,1,2,4,3,1,0,1,0
1,4,2,4,6,1,5,4,4,2,1,4,5,1,4,3,4,2,1,4,4,1,3,2
1,4,2,4,9,2,7,6,4,2,1,4,7,2,5,4,4,2,1,4,5,1,4,3
3,4,0,4,1,0,1,0,4,0,3,4,1,0,1,0,4,0,3,4,1,0,1,0
2,4,3,4,1,0,1,0,4,3,2,4,1,0,1,0,4,3,2,4,1,0,1,0
2,4,2,0,0,0,0,0,4,2,2,0,0,0,0,0,4,2,2,0,0,0,0,0
0,3,3,1,6,0,6,1,3,3,0,1,6,0,6,1,3,3,0,1,6,0,6,1
2,1,0,3,9,4,5,3,1,0,2,3,5,2,3,2,1,0,2,3,3,1,2,1
1,2,3,1,24,7,17,5,2,3,1,1,17,5,12,3,2,3,1,1,12,3,9,2
3,0,2,2,24,16,8,3,0,2,3,2,8,5,3,1,0,2,3,2,3,2,1,0
0,3,0,1,11,1,10,2,3,0,0,1,10,1,9,2,3,0,0,1,9,0,9,2
3,3,0,0,2,1,1,0,3,0,3,0,1,0,1,0,3,0,3,0,1,0,1,0
2,2,1,2,9,4,5,2,2,1,2,2,5,2,3,1,2,1,2,2,3,1,2,0
0,4,2,0,4,0,4,0,4,2,0,0,4,0,4,0,4,2,0,0,4,0,4,0
1,0,4,1,29,8,21,6,0,4,1,1,21,6,15,4,0,4,1,1,15,4,11,3
0,4,1,2,1,0,1,0,4,1,0,2,1,0,1,0,4,1,0,2,1,0,1,0
4,4,2,1,6,5,1,0,4,2,4,1,1,0,1,0,4,2,4,1,1,0,1,0
0,3,0,3,16,1,15,10,3,0,0,3,15,1,14,9,3,0,0,3,14,1,13,9
4,4,4,2,0,0,0,0,4,4,4,2,0,0,0,0,4,4,4,2,0,0,0,0
1,2,1,1,7,2,5,1,2,1,1,1,5,1,4,1,2,1,1,1,4,1,3,0
1,3,4,2,15,4,11,5,3,4,1,2,11,3,8,3,3,4,1,2,8,2,6,2
2,3,0,3,2,0,2,1,3,0,2,3,2,0,2,1,3,0,2,3,2,0,2,1
2,4,2,0,13,6,7,0,4,2,2,0,7,3,4,0,4,2,2,0,4,1,3,0
0,3,3,1,16,1,15,4,3,3,0,1,15,1,14,4,3,3,0,1,14,1,13,3
0,2,0,1,7,0,7,2,2,0,0,1,7,0,7,2,2,0,0,1,7,0,7,2
4,0,2,4,25,22,3,2,0,2,4,4,3,2,1,0,0,2,4,4,1,0,1,0
0,0,3,2,22,2,20,10,0,3,0,2,20,1,19,9,0,3,0,2,19,1,18,8
3,4,1,4,15,10,5,4,4,1,3,4,5,3,2,1,4,1,3,4,2,1,1,0
3,3,1,4,8,5,3,2,3,1,3,4,3,2,1,0,3,1,3,4,1,0,1,0
1,0,0,0,5,1,4,0,0,0,1,0,4,1,3,0,0,0,1,0,3,0,3,0
3,0,1,1,16,11,5,1,0,1,3,1,5,3,2,0,0,1,3,1,2,1,1,0
4,3,4,4,24,21,3,2,3,4,4,4,3,2,1,0,3,4,4,4,1,0,1,0
1,0,2,4,23,6,17,15,0,2,1,4,17,5,12,10,0,2,1,4,12,3,9,8
4,0,0,3,10,9,1,0,0,0,4,3,1,0,1,0,0,0,4,3,1,0,1,0
3,1,4,2,25,17,8,3,1,4,3,2,8,5,3,1,1,4,3,2,3,2,1,0
2,3,3,1,10,5,5,1,3,3,2,1,5,2,3,0,3,3,2,1,3,1,2,0
2,4,2,0,0,0,0,0,4,2,2,0,0,0,0,0,4,2,2,0,0,0,0,0
0,3,2,4,6,0,6,5,3,2,0,4,6,0,6,5,3,2,0,4,6,0,6,5
0,4,0,0,7,0,7,0,4,0,0,0,7,0,7,0,4,0,0,0,7,0,7,0
0,1,2,1,13,1,12,3,1,2,0,1,12,1,11,3,1,2,0,1,11,1,10,3
0,0,2,3,23,2,21,14,0,2,0,3,21,2,19,13,0,2,0,3,19,1,18,12
1,3,3,3,26,7,19,13,3,3,1,3,19,5,14,9,3,3,1,3,14,4,10,7
2,3,4,4,18,9,9,8,3,4,2,4,9,4,5,4,3,4,2,4,5,2,3,2
1,0,4,2,29,8,21,10,0,4,1,2,21,6,15,7,0,4,1,2,15,4,11,5
0,2,1,2,15,1,14,7,2,1,0,2,14,1,13,6,2,1,0,2,13,1,12,6
0,3,3,2,13,1,12,6,3,3,0,2,12,1,11,5,3,3,0,2,11,1,10,5
4,4,2,1,2,1,1,0,4,2,4,1,1,0,1,0,4,2,4,1,1,0,1,0
3,2,4,4,26,18,8,7,2,4,3,4,8,5,3,2,2,4,3,4,3,2,1,0
4,3,3,1,14,12,2,0,3,3,4,1,2,1,1,0,3,3,4,1,1,0,1,0
2,3,4,1,13,6,7,2,3,4,2,1,7,3,4,1,3,4,2,1,4,1,3,0
4,2,4,4,18,16,2,1,2,4,4,4,2,1,1,0,2,4,4,4,1,0,1,0
3,0,3,3,23,16,7,4,0,3,3,3,7,4,3,2,0,3,3,3,3,2,1,0
0,0,2,4,24,2,22,19,0,2,0,4,22,2,20,18,0,2,0,4,20,2,18,16
3,2,4,2,12,8,4,2,2,4,3,2,4,2,2,1,2,4,3,2,2,1,1,0
1,3,0,0,6,1,5,0,3,0,1,0,5,1,4,0,3,0,1,0,4,1,3,0
2,0,1,4,23,11,12,10,0,1,2,4,12,6,6,5,0,1,2,4,6,2,4,3
2,4,2,3,1,0,1,0,4,2,2,3,1,0,1,0,4,2,2,3,1,0,1,0
2,0,3,0,22,10,12,1,0,3,2,0,12,6,6,0,0,3,2,0,6,3,3,0
4,3,2,1,8,7,1,0,3,2,4,1,1,0,1,0,3,2,4,1,1,0,1,0
0,4,3,1,6,0,6,1,4,3,0,1,6,0,6,1,4,3,0,1,6,0,6,1
1,0,3,0,27,8,19,1,0,3,1,0,19,5,14,1,0,3,1,0,14,4,10,1
0,0,0,0,12,1,11,1,0,0,0,0,11,1,10,0,0,0,0,0,10,1,9,0
1,0,0,4,6,1,5,4,0,0,1,4,5,1,4,3,0,0,1,4,4,1,3,2
0,4,4,1,10,0,10,3,4,4,0,1,10,0,10,3,4,4,0,1,10,0,10,2
1,2,1,4,4,1,3,2,2,1,1,4,3,0,3,2,2,1,1,4,3,0,3,2
0,1,0,2,7,0,7,3,1,0,0,2,7,0,7,3,1,0,0,2,7,0,7,3
1,2,3,0,15,4,11,1,2,3,1,0,11,3,8,0,2,3,1,0,8,2,6,0
4,2,1,4,5,4,1,0,2,1,4,4,1,0,1,0,2,1,4,4,1,0,1,0
1,4,4,4,13,3,10,8,4,4,1,4,10,3,7,6,4,4,1,4,7,2,5,4
2,1,0,2,7,3,4,1,1,0,2,2,4,1,3,1,1,0,2,2,3,1,2,1
4,4,0,1,5,4,1,0,4,0,4,1,1,0,1,0,4,0,4,1,1,0,1,0
2,1,3,3,27,13,14,9,1,3,2,3,14,6,8,5,1,3,2,3,8,4,4,2
0,0,4,3,26,2,24,16,0,4,0,3,24,2,22,15,0,4,0,3,22,2,20,13
3,4,4,3,12,8,4,2,4,4,3,3,4,2,2,1,4,4,3,3,2,1,1,0
0,2,4,2,22,2,20,10,2,4,0,2,20,2,18,9,2,4,0,2,18,1,17,8
0,0,0,0,11,1,10,0,0,0,0,0,10,1,9,0,0,0,0,0,9,0,9,0
2,4,1,0,3,1,2,0,4,1,2,0,2,0,2,0,4,1,2,0,2,0,2,0
4,0,0,0,3,2,1,0,0,0,4,0,1,0,1,0,0,0,4,0,1,0,1,0
3,0,0,2,2,1,1,0,0,0,3,2,1,0,1,0,0,0,3,2,1,0,1,0
0,1,3,4,16,1,15,13,1,3,0,4,15,1,14,12,1,3,0,4,14,1,13,11
3,1,4,4,24,16,8,7,1,4,3,4,8,5,3,2,1,4,3,4,3,2,1,0
2,3,1,1,6,2,4,1,3,1,2,1,4,1,3,0,3,1,2,1,3,1,2,0
4,0,4,0,27,24,3,0,0,4,4,0,3,2,1,0,0,4,4,0,1,0,1,0
1,0,2,0,25,7,18,1,0,2,1,0,18,5,13,1,0,2,1,0,13,3,10,0
2,2,1,2,5,2,3,1,2,1,2,2,3,1,2,0,2,1,2,2,2,1,1,0
1,2,1,0,6,1,5,0,2,1,1,0,5,1,4,0,2,1,1,0,4,1,3,0
3,1,1,3,17,11,6,4,1,1,3,3,6,4,2,1,1,1,3,3,2,1,1,0
0,3,2,1,12,1,11,3,3,2,0,1,11,1,10,3,3,2,0,1,10,0,10,3
3,3,1,3,6,4,2,1,3,1,3,3,2,1,1,0,3,1,3,3,1,0,1,0
1,4,1,3,7,2,5,3,4,1,1,3,5,1,4,2,4,1,1,3,4,1,3,2
3,4,2,3,2,1,1,0,4,2,3,3,1,0,1,0,4,2,3,3,1,0,1,0
3,0,1,3,11,7,4,2,0,1,3,3,4,2,2,1,0,1,3,3,2,1,1,0
1,1,2,4,21,6,15,13,1,2,1,4,15,4,11,9,1,2,1,4,11,3,8,7
4,2,4,1,21,18,3,0,2,4,4,1,3,2,1,0,2,4,4,1,1,0,1,0
0,3,3,2,7,0,7,3,3,3,0,2,7,0,7,3,3,3,0,2,7,0,7,3
0,2,4,1,23,2,21,6,2,4,0,1,21,2,19,5,2,4,0,1,19,1,18,5
4,0,2,3,22,19,3,2,0,2,4,3,3,2,1,0,0,2,4,3,1,0,1,0
0,3,3,3,7,0,7,4,3,3,0,3,7,0,7,4,3,3,0,3,7,0,7,4
3,4,4,4,2,1,1,0,4,4,3,4,1,0,1,0,4,4,3,4,1,0,1,0
0,4,4,4,7,0,7,6,4,4,0,4,7,0,7,6,4,4,0,4,7,0,7,6
0,0,0,2,11,1,10,4,0,0,0,2,10,0,10,4,0,0,0,2,10,1,9,4
4,3,2,4,7,6,1,0,3,2,4,4,1,0,1,0,3,2,4,4,1,0,1,0
2,3,4,4,14,6,8,7,3,4,2,4,8,4,4,3,3,4,2,4,4,1,3,2
1,0,4,0,28,8,20,1,0,4,1,0,20,5,15,1,0,4,1,0,15,4,11,1
3,3,4,4,11,7,4,3,3,4,3,4,4,2,2,1,3,4,3,4,2,1,1,0
4,2,0,4,7,6,1,0,2,0,4,4,1,0,1,0,2,0,4,4,1,0,1,0
0,3,0,0,2,0,2,0,3,0,0,0,2,0,2,0,3,0,0,0,2,0,2,0
2,2,1,0,11,5,6,0,2,1,2,0,6,2,4,0,2,1,2,0,4,2,2,0
4,3,2,2,4,3,1,0,3,2,4,2,1,0,1,0,3,2,4,2,1,0,1,0
2,3,2,0,13,6,7,0,3,2,2,0,7,3,4,0,3,2,2,0,4,2,2,0
1,3,2,1,11,3,8,2,3,2,1,1,8,2,6,1,3,2,1,1,6,1,5,1
3,3,4,1,15,10,5,1,3,4,3,1,5,3,2,0,3,4,3,1,2,1,1,0
2,2,3,2,15,7,8,4,2,3,2,2,8,4,4,1,2,3,2,2,4,2,2,0
3,3,3,0,21,14,7,0,3,3,3,0,7,4,3,0,3,3,3,0,3,2,1,0
1,1,1,4,9,2,7,6,1,1,1,4,7,2,5,4,1,1,1,4,5,1,4,3
1,0,1,2,20,6,14,6,0,1,1,2,14,4,10,5,0,1,1,2,10,2,8,4
3,2,3,4,19,13,6,5,2,3,3,4,6,4,2,1,2,3,3,4,2,1,1,0
3,3,4,2,6,4,2,0,3,4,3,2,2,1,1,0,3,4,3,2,1,0,1,0
2,3,2,3,14,6,8,5,3,2,2,3,8,3,5,3,3,2,2,3,5,2,3,2
2,4,4,0,11,5,6,0,4,4,2,0,6,3,3,0,4,4,2,0,3,1,2,0
0,0,0,2,7,0,7,3,0,0,0,2,7,0,7,3,0,0,0,2,7,0,7,3
1,1,2,1,14,4,10,3,1,2,1,1,10,2,8,2,1,2,1,1,8,2,6,1
3,1,4,1,25,17,8,2,1,4,3,1,8,5,3,0,1,4,3,1,3,2,1,0
4,3,1,4,0,0,0,0,3,1,4,4,0,0,0,0,3,1,4,4,0,0,0,0
1,3,2,0,7,2,5,0,3,2,1,0,5,1,4,0,3,2,1,0,4,1,3,0
3,4,3,3,9,6,3,2,4,3,3,3,3,2,1,0,4,3,3,3,1,0,1,0
1,4,2,2,6,1,5,2,4,2,1,2,5,1,4,1,4,2,1,2,4,1,3,1
0,2,3,2,16,1,15,7,2,3,0,2,15,1,14,6,2,3,0,2,14,1,13,6
2,1,0,0,6,2,4,0,1,0,2,0,4,1,3,0,1,0,2,0,3,1,2,0
2,3,3,4,6,3,3,2,3,3,2,4,3,1,2,1,3,3,2,4,2,1,1,0
2,1,4,0,27,13,14,1,1,4,2,0,14,6,8,0,1,4,2,0,8,4,4,0
4,3,3,3,12,10,2,1,3,3,4,3,2,1,1,0,3,3,4,3,1,0,1,0
2,0,1,2,11,5,6,2,0,1,2,2,6,2,4,2,0,1,2,2,4,1,3,1
3,3,3,0,18,12,6,0,3,3,3,0,6,4,2,0,3,3,3,0,2,1,1,0
0,3,1,0,2,0,2,0,3,1,0,0,2,0,2,0,3,1,0,0,2,0,2,0
2,1,3,2,23,11,12,6,1,3,2,2,12,5,7,3,1,3,2,2,7,3,4,2
4,1,1,1,17,15,2,0,1,1,4,1,2,1,1,0,1,1,4,1,1,0,1,0
0,0,3,1,27,2,25,7,0,3,0,1,25,2,23,6,0,3,0,1,23,2,21,6
2,3,1,2,15,7,8,3,3,1,2,2,8,3,5,2,3,1,2,2,5,2,3,1
3,1,2,2,13,9,4,1,1,2,3,2,4,2,2,0,1,2,3,2,2,1,1,0
4,0,3,1,28,25,3,0,0,3,4,1,3,2,1,0,0,3,4,1,1,0,1,0
0,0,4,2,29,2,27,13,0,4,0,2,27,2,25,12,0,4,0,2,25,2,23,11
0,4,0,1,0,0,0,0,4,0,0,1,0,0,0,0,4,0,0,1,0,0,0,0
0,3,3,1,11,1,10,2,3,3,0,1,10,1,9,2,3,3,0,1,9,0,9,2
1,0,4,0,28,8,20,2,0,4,1,0,20,6,14,1,0,4,1,0,14,4,10,1
3,3,4,3,12,8,4,2,3,4,3,3,4,2,2,1,3,4,3,3,2,1,1,0
3,2,3,1,22,15,7,2,2,3,3,1,7,4,3,0,2,3,3,1,3,2,1,0
1,0,0,1,15,4,11,3,0,0,1,1,11,3,8,2,0,0,1,1,8,2,6,1
0,0,3,2,25,2,23,11,0,3,0,2,23,2,21,10,0,3,0,2,21,2,19,9
4,0,1,0,9,8,1,0,0,1,4,0,1,0,1,0,0,1,4,0,1,0,1,0
2,1,1,2,16,7,9,4,1,1,2,2,9,4,5,2,1,1,2,2,5,2,3,1
1,2,1,1,4,1,3,0,2,1,1,1,3,0,3,0,2,1,1,1,3,0,3,0
0,0,0,2,3,0,3,1,0,0,0,2,3,0,3,1,0,0,0,2,3,0,3,1
2,1,4,1,26,13,13,3,1,4,2,1,13,6,7,2,1,4,2,1,7,3,4,1
4,2,1,0,15,13,2,0,2,1,4,0,2,1,1,0,2,1,4,0,1,0,1,0
2,4,0,2,7,3,4,2,4,0,2,2,4,2,2,0,4,0,2,2,2,0,2,1
1,2,0,2,0,0,0,0,2,0,1,2,0,0,0,0,2,0,1,2,0,0,0,0
4,3,4,3,18,16,2,1,3,4,4,3,2,1,1,0,3,4,4,3,1,0,1,0
2,1,4,4,26,12,14,12,1,4,2,4,14,6,8,7,1,4,2,4,8,3,5,4
4,3,0,3,1,0,1,0,3,0,4,3,1,0,1,0,3,0,4,3,1,0,1,0
0,4,4,1,9,0,9,2,4,4,0,1,9,0,9,2,4,4,0,1,9,0,9,2
2,2,1,3,6,2,4,2,2,1,2,3,4,2,2,1,2,1,2,3,2,1,1,0
3,2,1,3,10,6,4,2,2,1,3,3,4,2,2,1,2,1,3,3,2,1,1,0
2,2,1,0,10,4,6,0,2,1,2,0,6,3,3,0,2,1,2,0,3,1,2,0
2,0,3,3,27,13,14,9,0,3,2,3,14,7,7,4,0,3,2,3,7,3,4,2
3,2,3,0,21,14,7,0,2,3,3,0,7,4,3,0,2,3,3,0,3,2,1,0
2,1,3,1,23,11,12,3,1,3,2,1,12,6,6,1,1,3,2,1,6,3,3,0
2,0,2,1,19,9,10,2,0,2,2,1,10,4,6,1,0,2,2,1,6,3,3,0
3,3,4,3,11,7,4,2,3,4,3,3,4,2,2,1,3,4,3,3,2,1,1,0
1,4,2,4,4,1,3,2,4,2,1,4,3,0,3,2,4,2,1,4,3,0,3,2
0,1,1,4,16,1,15,13,1,1,0,4,15,1,14,12,1,1,0,4,14,1,13,11
2,4,1,1,5,2,3,0,4,1,2,1,3,1,2,0,4,1,2,1,2,0,2,0
0,2,0,2,5,0,5,2,2,0,0,2,5,0,5,2,2,0,0,2,5,0,5,2
2,2,2,4,16,7,9,8,2,2,2,4,9,4,5,4,2,2,2,4,5,2,3,2
2,1,1,0,12,6,6,0,1,1,2,0,6,3,3,0,1,1,2,0,3,1,2,0
3,2,4,4,25,17,8,7,2,4,3,4,8,5,3,2,2,4,3,4,3,2,1,0
0,1,1,0,21,2,19,1,1,1,0,0,19,1,18,1,1,1,0,0,18,1,17,1
3,2,1,0,4,2,2,0,2,1,3,0,2,1,1,0,2,1,3,0,1,0,1,0
4,3,1,0,12,10,2,0,3,1,4,0,2,1,1,0,3,1,4,0,1,0,1,0
1,4,4,4,18,5,13,11,4,4,1,4,13,3,10,9,4,4,1,4,10,3,7,6
1,4,1,0,9,2,7,0,4,1,1,0,7,2,5,0,4,1,1,0,5,1,4,0
0,0,1,1,21,2,19,5,0,1,0,1,19,1,18,5,0,1,0,1,18,1,17,5
2,1,4,1,22,11,11,3,1,4,2,1,11,5,6,1,1,4,2,1,6,3,3,0
4,2,4,4,16,14,2,1,2,4,4,4,2,1,1,0,2,4,4,4,1,0,1,0
0,2,2,1,18,1,17,5,2,2,0,1,17,1,16,4,2,2,0,1,16,1,15,4
0,1,3,1,27,2,25,7,1,3,0,1,25,2,23,6,1,3,0,1,23,2,21,6
4,2,0,4,7,6,1,0,2,0,4,4,1,0,1,0,2,0,4,4,1,0,1,0
3,1,1,3,9,6,3,2,1,1,3,3,3,2,1,0,1,1,3,3,1,0,1,0
2,0,3,1,23,11,12,3,0,3,2,1,12,5,7,2,0,3,2,1,7,3,4,1
3,3,3,2,11,7,4,2,3,3,3,2,4,2,2,1,3,3,3,2,2,1,1,0
0,0,0,0,4,0,4,0,0,0,0,0,4,0,4,0,0,0,0,0,4,0,4,0
3,2,0,0,6,4,2,0,2,0,3,0,2,1,1,0,2,0,3,0,1,0,1,0
4,1,1,4,12,10,2,1,1,1,4,4,2,1,1,0,1,1,4,4,1,0,1,0
3,0,0,4,6,4,2,1,0,0,3,4,2,1,1,0,0,0,3,4,1,0,1,0
0,3,4,3,11,1,10,7,3,4,0,3,10,1,9,6,3,4,0,3,9,0,9,6
1,0,3,1,26,7,19,5,0,3,1,1,19,5,14,4,0,3,1,1,14,4,10,3
1,0,2,2,16,4,12,6,0,2,1,2,12,3,9,4,0,2,1,2,9,2,7,3
1,2,2,2,17,5,12,5,2,2,1,2,12,3,9,4,2,2,1,2,9,2,7,3
3,3,0,3,3,2,1,0,3,0,3,3,1,0,1,0,3,0,3,3,1,0,1,0
4,1,2,2,15,13,2,1,1,2,4,2,2,1,1,0,1,2,4,2,1,0,1,0
3,2,2,0,19,13,6,0,2,2,3,0,6,4,2,0,2,2,3,0,2,1,1,0
0,0,4,0,28,2,26,2,0,4,0,0,26,2,24,2,0,4,0,0,24,2,22,2
3,2,4,3,18,12,6,4,2,4,3,3,6,4,2,1,2,4,3,3,2,1,1,0
4,2,2,2,8,7,1,0,2,2,4,2,1,0,1,0,2,2,4,2,1,0,1,0
3,3,1,2,13,9,4,2,3,1,3,2,4,2,2,1,3,1,3,2,2,1,1,0
1,1,2,1,16,4,12,3,1,2,1,1,12,3,9,2,1,2,1,1,9,2,7,2
3,4,0,0,2,1,1,0,4,0,3,0,1,0,1,0,4,0,3,0,1,0,1,0
3,4,3,1,7,4,3,0,4,3,3,1,3,2,1,0,4,3,3,1,1,0,1,0
2,0,4,4,28,13,15,13,0,4,2,4,15,7,8,7,0,4,2,4,8,3,5,4
1,0,2,2,17,5,12,5,0,2,1,2,12,3,9,4,0,2,1,2,9,2,7,3
3,3,0,1,10,6,4,1,3,0,3,1,4,2,2,0,3,0,3,1,2,1,1,0
3,0,3,3,28,19,9,6,0,3,3,3,9,6,3,2,0,3,3,3,3,2,1,0
0,4,3,2,0,0,0,0,4,3,0,2,0,0,0,0,4,3,0,2,0,0,0,0
0,4,1,4,6,0,6,5,4,1,0,4,6,0,6,5,4,1,0,4,6,0,6,5
3,0,3,0,26,18,8,0,0,3,3,0,8,5,3,0,0,3,3,0,3,2,1,0
4,4,1,0,6,5,1,0,4,1,4,0,1,0,1,0,4,1,4,0,1,0,1,0
4,2,1,4,4,3,1,0,2,1,4,4,1,0,1,0,2,1,4,4,1,0,1,0
0,3,2,3,12,1,11,7,3,2,0,3,11,1,10,6,3,2,0,3,10,0,10,7
3,3,4,2,24,16,8,3,3,4,3,2,8,5,3,1,3,4,3,2,3,2,1,0
1,1,3,1,27,8,19,5,1,3,1,1,19,5,14,4,1,3,1,1,14,4,10,3
0,4,2,1,1,0,1,0,4,2,0,1,1,0,1,0,4,2,0,1,1,0,1,0
3,4,0,4,2,1,1,0,4,0,3,4,1,0,1,0,4,0,3,4,1,0,1,0
1,0,1,2,13,3,10,4,0,1,1,2,10,3,7,3,0,1,1,2,7,2,5,2
2,0,0,3,2,1,1,0,0,0,2,3,1,0,1,0,0,0,2,3,1,0,1,0
2,1,4,0,13,6,7,0,1,4,2,0,7,3,4,0,1,4,2,0,4,2,2,0
2,1,4,0,24,12,12,1,1,4,2,0,12,6,6,0,1,4,2,0,6,2,4,0
0,1,2,3,11,1,10,7,1,2,0,3,10,0,10,7,1,2,0,3,10,0,10,7
4,1,2,2,25,22,3,1,1,2,4,2,3,2,1,0,1,2,4,2,1,0,1,0
2,2,1,3,0,0,0,0,2,1,2,3,0,0,0,0,2,1,2,3,0,0,0,0
2,1,4,4,24,11,13,11,1,4,2,4,13,6,7,6,1,4,2,4,7,3,4,3
1,0,3,3,29,8,21,14,0,3,1,3,21,6,15,10,0,3,1,3,15,4,11,7
0,3,0,3,3,0,3,2,3,0,0,3,3,0,3,2,3,0,0,3,3,0,3,2
4,4,3,3,8,7,1,0,4,3,4,3,1,0,1,0,4,3,4,3,1,0,1,0
1,0,2,0,22,6,16,1,0,2,1,0,16,4,12,1,0,2,1,0,12,3,9,0
3,3,1,2,6,4,2,0,3,1,3,2,2,1,1,0,3,1,3,2,1,0,1,0
3,4,4,4,2,1,1,0,4,4,3,4,1,0,1,0,4,4,3,4,1,0,1,0
4,1,1,3,10,9,1,0,1,1,4,3,1,0,1,0,1,1,4,3,1,0,1,0
3,2,1,1,10,7,3,0,2,1,3,1,3,2,1,0,2,1,3,1,1,0,1,0
0,4,3,4,13,1,12,10,4,3,0,4,12,1,11,9,4,3,0,4,11,1,10,8
2,4,2,2,4,2,2,1,4,2,2,2,2,0,2,0,4,2,2,2,2,1,1,0
4,1,1,3,9,8,1,0,1,1,4,3,1,0,1,0,1,1,4,3,1,0,1,0
0,4,4,0,12,1,11,1,4,4,0,0,11,1,10,1,4,4,0,0,10,0,10,0
4,1,3,1,29,26,3,0,1,3,4,1,3,2,1,0,1,3,4,1,1,0,1,0
4,3,3,2,12,10,2,0,3,3,4,2,2,1,1,0,3,3,4,2,1,0,1,0
0,4,0,1,5,0,5,1,4,0,0,1,5,0,5,1,4,0,0,1,5,0,5,1
2,0,1,1,18,9,9,2,0,1,2,1,9,4,5,1,0,1,2,1,5,2,3,0
4,0,3,2,25,22,3,1,0,3,4,2,3,2,1,0,0,3,4,2,1,0,1,0
0,0,4,2,25,2,23,11,0,4,0,2,23,2,21,10,0,4,0,2,21,2,19,9
2,2,0,2,7,3,4,2,2,0,2,2,4,1,3,1,2,0,2,2,3,1,2,1
3,1,2,0,15,10,5,0,1,2,3,0,5,3,2,0,1,2,3,0,2,1,1,0
1,3,3,4,15,4,11,9,3,3,1,4,11,3,8,7,3,3,1,4,8,2,6,5
2,1,2,0,17,8,9,0,1,2,2,0,9,4,5,0,1,2,2,0,5,2,3,0
2,2,2,0,13,6,7,0,2,2,2,0,7,3,4,0,2,2,2,0,4,1,3,0
3,0,3,4,23,16,7,6,0,3,3,4,7,4,3,2,0,3,3,4,3,2,1,0
3,1,1,2,18,12,6,3,1,1,3,2,6,4,2,0,1,1,3,2,2,1,1,0
3,2,3,1,14,9,5,1,2,3,3,1,5,3,2,0,2,3,3,1,2,1,1,0
3,4,2,0,2,1,1,0,4,2,3,0,1,0,1,0,4,2,3,0,1,0,1,0
1,4,2,1,7,2,5,1,4,2,1,1,5,1,4,1,4,2,1,1,4,1,3,0
2,0,0,0,6,3,3,0,0,0,2,0,3,1,2,0,0,0,2,0,2,0,2,0
2,0,1,2,25,12,13,6,0,1,2,2,13,6,7,3,0,1,2,2,7,3,4,2
4,3,4,3,24,21,3,2,3,4,4,3,3,2,1,0,3,4,4,3,1,0,1,0
4,4,2,2,18,16,2,0,4,2,4,2,2,1,1,0,4,2,4,2,1,0,1,0
0,2,0,3,5,0,5,3,2,0,0,3,5,0,5,3,2,0,0,3,5,0,5,3
0,0,3,1,24,2,22,6,0,3,0,1,22,2,20,5,0,3,0,1,20,2,18,5
2,3,0,2,2,1,1,0,3,0,2,2,1,0,1,0,3,0,2,2,1,0,1,0
4,0,0,2,6,5,1,0,0,0,4,2,1,0,1,0,0,0,4,2,1,0,1,0
0,1,2,3,15,1,14,9,1,2,0,3,14,1,13,9,1,2,0,3,13,1,12,8
1,3,3,1,12,3,9,2,3,3,1,1,9,2,7,2,3,3,1,1,7,2,5,1
2,4,0,2,7,3,4,2,4,0,2,2,4,1,3,1,4,0,2,2,3,1,2,0
3,4,1,2,10,7,3,1,4,1,3,2,3,2,1,0,4,1,3,2,1,0,1,0
0,0,1,0,17,1,16,1,0,1,0,0,16,1,15,1,0,1,0,0,15,1,14,1
3,2,2,2,17,11,6,3,2,2,3,2,6,4,2,1,2,2,3,2,2,1,1,0
3,2,3,1,19,13,6,1,2,3,3,1,6,4,2,0,2,3,3,1,2,1,1,0
4,4,3,3,11,9,2,1,4,3,4,3,2,1,1,0,4,3,4,3,1,0,1,0
2,1,0,0,1,0,1,0,1,0,2,0,1,0,1,0,1,0,2,0,1,0,1,0
1,0,3,2,28,8,20,10,0,3,1,2,20,5,15,7,0,3,1,2,15,4,11,5
2,2,3,2,21,10,11,5,2,3,2,2,11,5,6,3,2,3,2,2,6,3,3,1
1,4,4,3,6,1,5,3,4,4,1,3,5,1,4,2,4,4,1,3,4,1,3,2
0,0,2,4,18,1,17,15,0,2,0,4,17,1,16,14,0,2,0,4,16,1,15,13
0,3,4,3,24,2,22,15,3,4,0,3,22,2,20,14,3,4,0,3,20,1,19,13
3,0,2,3,20,13,7,4,0,2,3,3,7,4,3,2,0,2,3,3,3,2,1,0
0,2,2,2,4,0,4,2,2,2,0,2,4,0,4,1,2,2,0,2,4,0,4,2
4,0,0,4,4,3,1,0,0,0,4,4,1,0,1,0,0,0,4,4,1,0,1,0
1,4,4,3,6,1,5,3,4,4,1,3,5,1,4,2,4,4,1,3,4,1,3,2
2,2,2,4,11,5,6,5,2,2,2,4,6,2,4,3,2,2,2,4,4,2,2,1
0,1,1,1,20,2,18,5,1,1,0,1,18,1,17,5,1,1,0,1,17,1,16,4
3,4,0,0,1,0,1,0,4,0,3,0,1,0,1,0,4,0,3,0,1,0,1,0
3,4,2,0,11,7,4,0,4,2,3,0,4,2,2,0,4,2,3,0,2,1,1,0
3,0,4,0,21,14,7,0,0,4,3,0,7,4,3,0,0,4,3,0,3,2,1,0
0,0,2,4,14,1,13,11,0,2,0,4,13,1,12,10,0,2,0,4,12,1,11,9
2,4,4,2,8,3,5,2,4,4,2,2,5,2,3,1,4,4,2,2,3,1,2,0
3,3,0,4,0,0,0,0,3,0,3,4,0,0,0,0,3,0,3,4,0,0,0,0
2,4,4,4,1,0,1,0,4,4,2,4,1,0,1,0,4,4,2,4,1,0,1,0
0,3,3,1,11,1,10,2,3,3,0,1,10,1,9,2,3,3,0,1,9,0,9,2
2,3,1,1,10,5,5,1,3,1,2,1,5,2,3,0,3,1,2,1,3,1,2,0
3,4,2,1,4,2,2,0,4,2,3,1,2,1,1,0,4,2,3,1,1,0,1,0
2,2,4,1,22,10,12,3,2,4,2,1,12,6,6,1,2,4,2,1,6,3,3,0
4,2,2,0,12,10,2,0,2,2,4,0,2,1,1,0,2,2,4,0,1,0,1,0
1,1,4,0,27,8,19,1,1,4,1,0,19,5,14,1,1,4,1,0,14,4,10,1
2,4,0,1,0,0,0,0,4,0,2,1,0,0,0,0,4,0,2,1,0,0,0,0
4,3,0,1,6,5,1,0,3,0,4,1,1,0,1,0,3,0,4,1,1,0,1,0
1,1,1,4,13,3,10,9,1,1,1,4,10,2,8,7,1,1,1,4,8,2,6,5
4,4,2,4,11,9,2,1,4,2,4,4,2,1,1,0,4,2,4,4,1,0,1,0
4,0,0,4,2,1,1,0,0,0,4,4,1,0,1,0,0,0,4,4,1,0,1,0
3,2,3,0,18,12,6,0,2,3,3,0,6,4,2,0,2,3,3,0,2,1,1,0
1,3,4,3,6,1,5,3,3,4,1,3,5,1,4,2,3,4,1,3,4,1,3,2
1,2,3,3,16,4,12,8,2,3,1,3,12,3,9,6,2,3,1,3,9,2,7,4
2,2,4,3,21,10,11,7,2,4,2,3,11,5,6,4,2,4,2,3,6,2,4,2
0,3,4,3,1,0,1,0,3,4,0,3,1,0,1,0,3,4,0,3,1,0,1,0
3,4,0,1,5,3,2,0,4,0,3,1,2,1,1,0,4,0,3,1,1,0,1,0
3,2,3,2,18,12,6,3,2,3,3,2,6,4,2,1,2,3,3,2,2,1,1,0
0,3,2,4,7,0,7,6,3,2,0,4,7,0,7,6,3,2,0,4,7,0,7,6
4,4,1,1,12,10,2,0,4,1,4,1,2,1,1,0,4,1,4,1,1,0,1,0
1,1,3,2,24,7,17,8,1,3,1,2,17,5,12,5,1,3,1,2,12,3,9,4
3,1,2,0,15,10,5,0,1,2,3,0,5,3,2,0,1,2,3,0,2,1,1,0
4,3,0,3,5,4,1,0,3,0,4,3,1,0,1,0,3,0,4,3,1,0,1,0
2,3,4,3,12,6,6,4,3,4,2,3,6,2,4,2,3,4,2,3,4,2,2,1
3,0,0,3,11,7,4,2,0,0,3,3,4,2,2,1,0,0,3,3,2,1,1,0
0,3,2,3,2,0,2,1,3,2,0,3,2,0,2,1,3,2,0,3,2,0,2,1
4,0,0,2,2,1,1,0,0,0,4,2,1,0,1,0,0,0,4,2,1,0,1,0
3,3,4,3,12,8,4,2,3,4,3,3,4,2,2,1,3,4,3,3,2,1,1,0
4,1,1,3,16,14,2,1,1,1,4,3,2,1,1,0,1,1,4,3,1,0,1,0
1,0,4,0,26,7,19,1,0,4,1,0,19,5,14,1,0,4,1,0,14,4,10,0
1,4,3,2,11,3,8,3,4,3,1,2,8,2,6,2,4,3,1,2,6,1,5,2
2,1,1,0,9,4,5,0,1,1,2,0,5,2,3,0,1,1,2,0,3,1,2,0
0,1,1,1,9,0,9,2,1,1,0,1,9,0,9,2,1,1,0,1,9,0,9,2
3,3,1,0,12,8,4,0,3,1,3,0,4,2,2,0,3,1,3,0,2,1,1,0
3,1,4,2,26,18,8,4,1,4,3,2,8,5,3,1,1,4,3,2,3,2,1,0
1,1,2,4,22,6,16,14,1,2,1,4,16,4,12,10,1,2,1,4,12,3,9,8
0,3,3,1,15,1,14,4,3,3,0,1,14,1,13,3,3,3,0,1,13,1,12,3
0,4,4,3,11,1,10,7,4,4,0,3,10,0,10,6,4,4,0,3,10,0,10,7
1,1,4,3,29,8,21,14,1,4,1,3,21,6,15,10,1,4,1,3,15,4,11,7
0,1,3,1,27,2,25,7,1,3,0,1,25,2,23,6,1,3,0,1,23,2,21,6
0,2,1,0,8,0,8,0,2,1,0,0,8,0,8,0,2,1,0,0,8,0,8,0
0,0,2,3,21,2,19,13,0,2,0,3,19,1,18,12,0,2,0,3,18,1,17,11
1,0,3,4,29,8,21,18,0,3,1,4,21,6,15,13,0,3,1,4,15,4,11,9
1,3,2,4,11,3,8,7,3,2,1,4,8,2,6,5,3,2,1,4,6,1,5,4
4,2,0,0,8,7,1,0,2,0,4,0,1,0,1,0,2,0,4,0,1,0,1,0
3,0,3,4,29,20,9,8,0,3,3,4,9,6,3,2,0,3,3,4,3,2,1,0
3,0,3,0,20,13,7,0,0,3,3,0,7,4,3,0,0,3,3,0,3,2,1,0
0,3,1,3,1,0,1,0,3,1,0,3,1,0,1,0,3,1,0,3,1,0,1,0
0,1,2,2,22,2,20,9,1,2,0,2,20,2,18,8,1,2,0,2,18,1,17,8
4,3,1,4,12,10,2,1,3,1,4,4,2,1,1,0,3,1,4,4,1,0,1,0
4,2,3,4,11,9,2,1,2,3,4,4,2,1,1,0,2,3,4,4,1,0,1,0
2,3,2,2,8,3,5,2,3,2,2,2,5,2,3,1,3,2,2,2,3,1,2,1
4,0,2,4,25,22,3,2,0,2,4,4,3,2,1,0,0,2,4,4,1,0,1,0
4,4,0,1,0,0,0,0,4,0,4,1,0,0,0,0,4,0,4,1,0,0,0,0
1,2,0,0,12,3,9,0,2,0,1,0,9,2,7,0,2,0,1,0,7,2,5,0
2,2,3,0,20,10,10,1,2,3,2,0,10,5,5,0,2,3,2,0,5,2,3,0
1,1,0,2,7,2,5,2,1,0,1,2,5,1,4,1,1,0,1,2,4,1,3,1
2,1,4,3,29,14,15,10,1,4,2,3,15,7,8,5,1,4,2,3,8,3,5,3
3,2,2,4,15,10,5,4,2,2,3,4,5,3,2,1,2,2,3,4,2,1,1,0
3,1,0,0,8,5,3,0,1,0,3,0,3,2,1,0,1,0,3,0,1,0,1,0
2,1,2,1,18,8,10,3,1,2,2,1,10,5,5,1,1,2,2,1,5,2,3,0
1,4,1,4,3,0,3,2,4,1,1,4,3,0,3,2,4,1,1,4,3,0,3,2
2,1,3,4,22,11,11,9,1,3,2,4,11,5,6,5,1,3,2,4,6,2,4,3
1,0,0,3,14,4,10,7,0,0,1,3,10,2,8,5,0,0,1,3,8,2,6,4
2,4,0,1,3,1,2,0,4,0,2,1,2,0,2,0,4,0,2,1,2,1,1,0
3,3,4,3,17,11,6,4,3,4,3,3,6,4,2,1,3,4,3,3,2,1,1,0
1,4,0,0,4,1,3,0,4,0,1,0,3,0,3,0,4,0,1,0,3,0,3,0
0,4,0,2,1,0,1,0,4,0,0,2,1,0,1,0,4,0,0,2,1,0,1,0
0,3,3,2,11,1,10,4,3,3,0,2,10,0,10,5,3,3,0,2,10,1,9,4
4,1,2,3,25,22,3,2,1,2,4,3,3,2,1,0,1,2,4,3,1,0,1,0
2,2,0,4,4,2,2,1,2,0,2,4,2,1,1,0,2,0,2,4,1,0,1,0
1,2,1,2,10,3,7,3,2,1,1,2,7,2,5,2,2,1,1,2,5,1,4,1
0,4,0,2,5,0,5,2,4,0,0,2,5,0,5,2,4,0,0,2,5,0,5,2
0,4,0,1,6,0,6,1,4,0,0,1,6,0,6,1,4,0,0,1,6,0,6,1
4,0,2,0,16,14,2,0,0,2,4,0,2,1,1,0,0,2,4,0,1,0,1,0
4,0,3,0,26,23,3,0,0,3,4,0,3,2,1,0,0,3,4,0,1,0,1,0
2,0,2,3,19,9,10,7,0,2,2,3,10,5,5,3,0,2,2,3,5,2,3,2
0,4,4,0,2,0,2,0,4,4,0,0,2,0,2,0,4,4,0,0,2,0,2,0
4,3,3,2,12,10,2,0,3,3,4,2,2,1,1,0,3,3,4,2,1,0,1,0
1,2,3,0,16,4,12,1,2,3,1,0,12,3,9,0,2,3,1,0,9,2,7,0
1,0,0,4,4,1,3,2,0,0,1,4,3,0,3,2,0,0,1,4,3,0,3,2
3,1,2,2,8,5,3,1,1,2,3,2,3,2,1,0,1,2,3,2,1,0,1,0
0,1,2,4,19,1,18,16,1,2,0,4,18,1,17,15,1,2,0,4,17,1,16,14
3,1,2,0,23,16,7,0,1,2,3,0,7,4,3,0,1,2,3,0,3,2,1,0
1,3,1,4,3,0,3,2,3,1,1,4,3,0,3,2,3,1,1,4,3,0,3,2
3,4,3,1,12,8,4,1,4,3,3,1,4,2,2,0,4,3,3,1,2,1,1,0
2,1,4,4,26,12,14,12,1,4,2,4,14,7,7,6,1,4,2,4,7,3,4,3
2,3,0,4,4,1,3,2,3,0,2,4,3,1,2,1,3,0,2,4,2,0,2,1
0,4,1,1,6,0,6,1,4,1,0,1,6,0,6,1,4,1,0,1,6,0,6,1
2,2,2,0,10,5,5,0,2,2,2,0,5,2,3,0,2,2,2,0,3,1,2,0
2,0,1,1,8,4,4,1,0,1,2,1,4,2,2,0,0,1,2,1,2,0,2,0
1,2,1,3,12,3,9,6,2,1,1,3,9,2,7,4,2,1,1,3,7,2,5,3
4,2,3,0,17,15,2,0,2,3,4,0,2,1,1,0,2,3,4,0,1,0,1,0
1,3,1,0,4,1,3,0,3,1,1,0,3,0,3,0,3,1,1,0,3,0,3,0
2,4,2,2,1,0,1,0,4,2,2,2,1,0,1,0,4,2,2,2,1,0,1,0
3,3,2,1,5,3,2,0,3,2,3,1,2,1,1,0,3,2,3,1,1,0,1,0
1,1,2,0,15,4,11,1,1,2,1,0,11,3,8,0,1,2,1,0,8,2,6,0
4,0,2,3,17,15,2,1,0,2,4,3,2,1,1,0,0,2,4,3,1,0,1,0
1,4,0,1,3,0,3,0,4,0,1,1,3,0,3,0,4,0,1,1,3,0,3,0
2,0,4,1,29,14,15,4,0,4,2,1,15,7,8,2,0,4,2,1,8,3,5,1
2,1,2,1,18,9,9,2,1,2,2,1,9,4,5,1,1,2,2,1,5,2,3,0
1,1,1,4,20,5,15,13,1,1,1,4,15,4,11,9,1,1,1,4,11,3,8,7
1,4,1,2,7,2,5,2,4,1,1,2,5,1,4,2,4,1,1,2,4,1,3,1
4,3,2,4,2,1,1,0,3,2,4,4,1,0,1,0,3,2,4,4,1,0,1,0
1,4,3,2,4,1,3,1,4,3,1,2,3,0,3,1,4,3,1,2,3,0,3,1
2,4,1,4,8,3,5,4,4,1,2,4,5,2,3,2,4,1,2,4,3,1,2,1
3,2,2,0,15,10,5,0,2,2,3,0,5,3,2,0,2,2,3,0,2,1,1,0
3,3,1,2,5,3,2,0,3,1,3,2,2,1,1,0,3,1,3,2,1,0,1,0
3,0,3,1,29,20,9,2,0,3,3,1,9,6,3,0,0,3,3,1,3,2,1,0
0,3,2,4,2,0,2,1,3,2,0,4,2,0,2,1,3,2,0,4,2,0,2,1
0,3,2,2,8,0,8,4,3,2,0,2,8,0,8,4,3,2,0,2,8,0,8,3
2,1,4,2,26,12,14,7,1,4,2,2,14,6,8,3,1,4,2,2,8,3,5,2
3,0,4,1,29,20,9,2,0,4,3,1,9,6,3,0,0,4,3,1,3,2,1,0
1,2,3,1,15,4,11,3,2,3,1,1,11,3,8,2,2,3,1,1,8,2,6,1
2,3,3,0,9,4,5,0,3,3,2,0,5,2,3,0,3,3,2,0,3,1,2,0
2,1,4,2,29,14,15,7,1,4,2,2,15,7,8,4,1,4,2,2,8,4,4,2
2,1,2,3,20,10,10,7,1,2,2,3,10,5,5,3,1,2,2,3,5,2,3,2
0,2,4,3,17,1,16,11,2,4,0,3,16,1,15,10,2,4,0,3,15,1,14,9
1,2,2,1,13,3,10,2,2,2,1,1,10,3,7,2,2,2,1,1,7,2,5,1
0,1,3,2,29,2,27,13,1,3,0,2,27,2,25,12,1,3,0,2,25,2,23,11
0,1,4,4,27,2,25,22,1,4,0,4,25,2,23,20,1,4,0,4,23,2,21,18
3,1,4,2,29,20,9,4,1,4,3,2,9,6,3,1,1,4,3,2,3,2,1,0
4,1,4,3,27,24,3,2,1,4,4,3,3,2,1,0,1,4,4,3,1,0,1,0
4,2,3,4,19,17,2,1,2,3,4,4,2,1,1,0,2,3,4,4,1,0,1,0
4,3,4,1,15,13,2,0,3,4,4,1,2,1,1,0,3,4,4,1,1,0,1,0
4,4,1,0,7,6,1,0,4,1,4,0,1,0,1,0,4,1,4,0,1,0,1,0
2,4,2,0,6,3,3,0,4,2,2,0,3,1,2,0,4,2,2,0,2,1,1,0
0,4,1,4,5,0,5,4,4,1,0,4,5,0,5,4,4,1,0,4,5,0,5,4
3,0,1,2,21,14,7,3,0,1,3,2,7,4,3,1,0,1,3,2,3,2,1,0
0,4,4,3,5,0,5,3,4,4,0,3,5,0,5,3,4,4,0,3,5,0,5,3
0,2,1,1,3,0,3,0,2,1,0,1,3,0,3,0,2,1,0,1,3,0,3,0
0,0,3,1,27,2,25,7,0,3,0,1,25,2,23,6,0,3,0,1,23,2,21,6
0,0,3,0,25,2,23,2,0,3,0,0,23,2,21,2,0,3,0,0,21,2,19,1
1,3,2,2,12,3,9,4,3,2,1,2,9,2,7,3,3,2,1,2,7,2,5,2
3,1,3,2,18,12,6,3,1,3,3,2,6,4,2,1,1,3,3,2,2,1,1,0
2,1,2,2,25,12,13,6,1,2,2,2,13,6,7,3,1,2,2,2,7,3,4,2
1,0,2,4,19,5,14,12,0,2,1,4,14,4,10,9,0,2,1,4,10,3,7,6
0,1,0,3,0,0,0,0,1,0,0,3,0,0,0,0,1,0,0,3,0,0,0,0
2,2,2,3,14,7,7,4,2,2,2,3,7,3,4,2,2,2,2,3,4,2,2,1
4,3,2,3,17,15,2,1,3,2,4,3,2,1,1,0,3,2,4,3,1,0,1,0
4,4,2,0,17,15,2,0,4,2,4,0,2,1,1,0,4,2,4,0,1,0,1,0
4,1,0,0,5,4,1,0,1,0,4,0,1,0,1,0,1,0,4,0,1,0,1,0
4,4,0,3,4,3,1,0,4,0,4,3,1,0,1,0,4,0,4,3,1,0,1,0
4,3,0,3,7,6,1,0,3,0,4,3,1,0,1,0,3,0,4,3,1,0,1,0
2,2,1,2,10,5,5,2,2,1,2,2,5,2,3,1,2,1,2,2,3,1,2,1
2,4,2,4,8,3,5,4,4,2,2,4,5,2,3,2,4,2,2,4,3,1,2,1
0,4,3,4,5,0,5,4,4,3,0,4,5,0,5,4,4,3,0,4,5,0,5,4
1,1,4,1,23,6,17,5,1,4,1,1,17,5,12,3,1,4,1,1,12,3,9,2
4,4,2,2,3,2,1,0,4,2,4,2,1,0,1,0,4,2,4,2,1,0,1,0
0,0,2,4,25,2,23,20,0,2,0,4,23,2,21,18,0,2,0,4,21,2,19,17
1,3,3,4,12,3,9,8,3,3,1,4,9,2,7,6,3,3,1,4,7,2,5,4
0,1,4,4,21,2,19,17,1,4,0,4,19,1,18,16,1,4,0,4,18,1,17,15
2,2,1,3,7,3,4,2,2,1,2,3,4,1,3,2,2,1,2,3,3,1,2,1
3,0,0,3,12,8,4,2,0,0,3,3,4,2,2,1,0,0,3,3,2,1,1,0
4,0,2,3,26,23,3,2,0,2,4,3,3,2,1,0,0,2,4,3,1,0,1,0
4,4,1,4,4,3,1,0,4,1,4,4,1,0,1,0,4,1,4,4,1,0,1,0
0,1,3,1,18,1,17,5,1,3,0,1,17,1,16,4,1,3,0,1,16,1,15,4
1,3,0,0,6,1,5,0,3,0,1,0,5,1,4,0,3,0,1,0,4,1,3,0
3,1,3,0,24,16,8,0,1,3,3,0,8,5,3,0,1,3,3,0,3,2,1,0
3,1,0,3,4,2,2,1,1,0,3,3,2,1,1,0,1,0,3,3,1,0,1,0
3,0,1,0,12,8,4,0,0,1,3,0,4,2,2,0,0,1,3,0,2,1,1,0
4,3,4,1,7,6,1,0,3,4,4,1,1,0,1,0,3,4,4,1,1,0,1,0
2,3,1,3,3,1,2,1,3,1,2,3,2,1,1,0,3,1,2,3,1,0,1,0
0,4,0,4,0,0,0,0,4,0,0,4,0,0,0,0,4,0,0,4,0,0,0,0
4,4,3,1,13,11,2,0,4,3,4,1,2,1,1,0,4,3,4,1,1,0,1,0
4,4,1,0,4,3,1,0,4,1,4,0,1,0,1,0,4,1,4,0,1,0,1,0
3,3,0,1,2,1,1,0,3,0,3,1,1,0,1,0,3,0,3,1,1,0,1,0
0,0,4,2,29,2,27,13,0,4,0,2,27,2,25,12,0,4,0,2,25,2,23,11
4,0,4,4,27,24,3,2,0,4,4,4,3,2,1,0,0,4,4,4,1,0,1,0
4,1,1,2,9,8,1,0,1,1,4,2,1,0,1,0,1,1,4,2,1,0,1,0
0,3,4,4,12,1,11,9,3,4,0,4,11,1,10,8,3,4,0,4,10,0,10,8
1,2,3,4,23,6,17,15,2,3,1,4,17,5,12,10,2,3,1,4,12,3,9,8
2,3,1,1,7,3,4,1,3,1,2,1,4,1,3,0,3,1,2,1,3,1,2,0
1,0,4,1,27,8,19,5,0,4,1,1,19,5,14,4,0,4,1,1,14,4,10,3
1,4,3,2,11,3,8,4,4,3,1,2,8,2,6,2,4,3,1,2,6,1,5,2
0,2,1,0,9,0,9,0,2,1,0,0,9,0,9,0,2,1,0,0,9,0,9,0
2,1,0,3,11,5,6,4,1,0,2,3,6,3,3,2,1,0,2,3,3,1,2,1
4,3,2,2,4,3,1,0,3,2,4,2,1,0,1,0,3,2,4,2,1,0,1,0
2,0,3,1,22,11,11,3,0,3,2,1,11,5,6,1,0,3,2,1,6,3,3,0
3,1,2,1,17,11,6,1,1,2,3,1,6,4,2,0,1,2,3,1,2,1,1,0
2,0,0,1,7,3,4,1,0,0,2,1,4,2,2,0,0,0,2,1,2,0,2,0
0,1,4,2,23,2,21,10,1,4,0,2,21,2,19,9,1,4,0,2,19,1,18,8
3,0,3,0,26,18,8,0,0,3,3,0,8,5,3,0,0,3,3,0,3,2,1,0
3,0,3,1,25,17,8,2,0,3,3,1,8,5,3,0,0,3,3,1,3,2,1,0
2,2,3,1,13,6,7,2,2,3,2,1,7,3,4,1,2,3,2,1,4,2,2,0
3,0,4,1,26,18,8,2,0,4,3,1,8,5,3,0,0,4,3,1,3,2,1,0
4,0,0,0,7,6,1,0,0,0,4,0,1,0,1,0,0,0,4,0,1,0,1,0
2,2,3,4,14,6,8,7,2,3,2,4,8,3,5,4,2,3,2,4,5,2,3,2
3,1,3,3,24,16,8,5,1,3,3,3,8,5,3,2,1,3,3,3,3,2,1,0
3,2,0,1,17,11,6,1,2,0,3,1,6,4,2,0,2,0,3,1,2,1,1,0
1,2,1,2,15,4,11,5,2,1,1,2,11,3,8,3,2,1,1,2,8,2,6,3
3,1,0,3,12,8,4,2,1,0,3,3,4,2,2,1,1,0,3,3,2,1,1,0
3,0,1,4,19,13,6,5,0,1,3,4,6,4,2,1,0,1,3,4,2,1,1,0
2,0,3,4,20,10,10,9,0,3,2,4,10,4,6,5,0,3,2,4,6,3,3,2
3,4,0,4,8,5,3,2,4,0,3,4,3,2,1,0,4,0,3,4,1,0,1,0
0,4,4,3,10,1,9,6,4,4,0,3,9,0,9,6,4,4,0,3,9,0,9,6
4,0,4,4,25,22,3,2,0,4,4,4,3,2,1,0,0,4,4,4,1,0,1,0
4,4,1,0,0,0,0,0,4,1,4,0,0,0,0,0,4,1,4,0,0,0,0,0
3,1,0,1,3,2,1,0,1,0,3,1,1,0,1,0,1,0,3,1,1,0,1,0
2,3,3,0,8,4,4,0,3,3,2,0,4,1,3,0,3,3,2,0,3,1,2,0
2,2,2,3,19,9,10,6,2,2,2,3,10,4,6,4,2,2,2,3,6,2,4,2
3,4,0,1,1,0,1,0,4,0,3,1,1,0,1,0,4,0,3,1,1,0,1,0
3,3,1,3,7,4,3,2,3,1,3,3,3,2,1,0,3,1,3,3,1,0,1,0
2,1,3,2,27,13,14,6,1,3,2,2,14,7,7,3,1,3,2,2,7,3,4,1
4,0,3,2,26,23,3,1,0,3,4,2,3,2,1,0,0,3,4,2,1,0,1,0
4,0,0,2,10,8,2,1,0,0,4,2,2,1,1,0,0,0,4,2,1,0,1,0
0,1,1,1,5,0,5,1,1,1,0,1,5,0,5,1,1,1,0,1,5,0,5,1
0,3,4,0,20,1,19,1,3,4,0,0,19,1,18,1,3,4,0,0,18,1,17,1
1,2,2,3,13,3,10,7,2,2,1,3,10,2,8,5,2,2,1,3,8,2,6,4
0,2,3,4,21,2,19,17,2,3,0,4,19,1,18,16,2,3,0,4,18,1,17,15
2,2,0,3,3,1,2,1,2,0,2,3,2,1,1,0,2,0,2,3,1,0,1,0
4,2,4,2,13,11,2,0,2,4,4,2,2,1,1,0,2,4,4,2,1,0,1,0
4,4,0,4,9,8,1,0,4,0,4,4,1,0,1,0,4,0,4,4,1,0,1,0
2,4,3,1,1,0,1,0,4,3,2,1,1,0,1,0,4,3,2,1,1,0,1,0
1,4,3,1,0,0,0,0,4,3,1,1,0,0,0,0,4,3,1,1,0,0,0,0
3,4,2,3,0,0,0,0,4,2,3,3,0,0,0,0,4,2,3,3,0,0,0,0
4,0,2,3,15,13,2,1,0,2,4,3,2,1,1,0,0,2,4,3,1,0,1,0
3,0,0,1,0,0,0,0,0,0,3,1,0,0,0,0,0,0,3,1,0,0,0,0
3,2,2,0,8,5,3,0,2,2,3,0,3,2,1,0,2,2,3,0,1,0,1,0
4,4,1,4,3,2,1,0,4,1,4,4,1,0,1,0,4,1,4,4,1,0,1,0
2,1,2,2,11,5,6,2,1,2,2,2,6,2,4,1,1,2,2,2,4,2,2,0
1,0,2,1,27,8,19,5,0,2,1,1,19,5,14,4,0,2,1,1,14,4,10,2
4,4,0,0,1,0,1,0,4,0,4,0,1,0,1,0,4,0,4,0,1,0,1,0
1,3,2,1,11,3,8,2,3,2,1,1,8,2,6,1,3,2,1,1,6,1,5,1
3,1,3,4,24,16,8,7,1,3,3,4,8,5,3,2,1,3,3,4,3,2,1,0
2,3,4,2,17,8,9,4,3,4,2,2,9,4,5,2,3,4,2,2,5,2,3,1
3,1,0,2,6,4,2,1,1,0,3,2,2,1,1,0,1,0,3,2,1,0,1,0
0,2,0,0,0,0,0,0,2,0,0,0,0,0,0,0,2,0,0,0,0,0,0,0
0,2,4,3,20,2,18,12,2,4,0,3,18,1,17,11,2,4,0,3,17,1,16,11
0,4,3,3,6,0,6,4,4,3,0,3,6,0,6,4,4,3,0,3,6,0,6,4
1,2,2,4,17,5,12,10,2,2,1,4,12,3,9,8,2,2,1,4,9,2,7,6
1,0,3,2,22,6,16,8,0,3,1,2,16,4,12,5,0,3,1,2,12,3,9,4
0,1,1,0,18,1,17,1,1,1,0,0,17,1,16,1,1,1,0,0,16,1,15,1
2,2,3,3,12,5,7,4,2,3,2,3,7,3,4,2,2,3,2,3,4,1,3,2
2,2,2,3,14,7,7,4,2,2,2,3,7,3,4,2,2,2,2,3,4,1,3,2
3,1,1,4,3,2,1,0,1,1,3,4,1,0,1,0,1,1,3,4,1,0,1,0
1,2,0,1,2,0,2,0,2,0,1,1,2,0,2,0,2,0,1,1,2,0,2,0
1,0,3,0,22,6,16,1,0,3,1,0,16,4,12,1,0,3,1,0,12,3,9,0
0,3,0,2,1,0,1,0,3,0,0,2,1,0,1,0,3,0,0,2,1,0,1,0
2,4,4,1,7,3,4,1,4,4,2,1,4,1,3,0,4,4,2,1,3,1,2,0
2,0,0,2,9,4,5,2,0,0,2,2,5,2,3,1,0,0,2,2,3,1,2,1
0,4,4,0,9,0,9,0,4,4,0,0,9,0,9,0,4,4,0,0,9,0,9,0
4,2,3,3,22,19,3,2,2,3,4,3,3,2,1,0,2,3,4,3,1,0,1,0
0,4,1,2,0,0,0,0,4,1,0,2,0,0,0,0,4,1,0,2,0,0,0,0
1,4,0,3,8,2,6,4,4,0,1,3,6,1,5,3,4,0,1,3,5,1,4,2
0,4,1,2,2,0,2,1,4,1,0,2,2,0,2,1,4,1,0,2,2,0,2,0
2,2,2,3,20,10,10,6,2,2,2,3,10,5,5,3,2,2,2,3,5,2,3,2
0,0,3,4,24,2,22,19,0,3,0,4,22,2,20,17,0,3,0,4,20,2,18,16
3,3,4,4,5,3,2,1,3,4,3,4,2,1,1,0,3,4,3,4,1,0,1,0
3,4,0,4,3,2,1,0,4,0,3,4,1,0,1,0,4,0,3,4,1,0,1,0
1,0,4,2,24,7,17,8,0,4,1,2,17,5,12,6,0,4,1,2,12,3,9,4
4,3,2,3,11,9,2,1,3,2,4,3,2,1,1,0,3,2,4,3,1,0,1,0
1,2,2,0,10,3,7,0,2,2,1,0,7,2,5,0,2,2,1,0,5,1,4,0
3,1,3,1,27,18,9,2,1,3,3,1,9,6,3,0,1,3,3,1,3,2,1,0
1,2,4,2,23,6,17,8,2,4,1,2,17,5,12,6,2,4,1,2,12,3,9,4
2,2,4,1,19,9,10,3,2,4,2,1,10,4,6,1,2,4,2,1,6,3,3,0
0,4,2,4,8,0,8,7,4,2,0,4,8,0,8,7,4,2,0,4,8,0,8,7
2,2,1,0,8,4,4,0,2,1,2,0,4,1,3,0,2,1,2,0,3,1,2,0
2,2,3,1,18,9,9,2,2,3,2,1,9,4,5,1,2,3,2,1,5,2,3,0
3,3,1,3,10,6,4,2,3,1,3,3,4,2,2,1,3,1,3,3,2,1,1,0
4,2,1,2,3,2,1,0,2,1,4,2,1,0,1,0,2,1,4,2,1,0,1,0
2,4,3,0,2,1,1,0,4,3,2,0,1,0,1,0,4,3,2,0,1,0,1,0
0,1,1,4,9,0,9,8,1,1,0,4,9,0,9,8,1,1,0,4,9,0,9,8
3,0,2,2,19,13,6,3,0,2,3,2,6,4,2,0,0,2,3,2,2,1,1,0
0,1,3,4,24,2,22,19,1,3,0,4,22,2,20,17,1,3,0,4,20,2,18,16
4,1,1,3,20,17,3,2,1,1,4,3,3,2,1,0,1,1,4,3,1,0,1,0
4,1,0,2,12,10,2,1,1,0,4,2,2,1,1,0,1,0,4,2,1,0,1,0
0,1,3,0,22,2,20,1,1,3,0,0,20,1,19,1,1,3,0,0,19,1,18,1
2,4,2,0,8,4,4,0,4,2,2,0,4,1,3,0,4,2,2,0,3,1,2,0
1,1,2,3,17,5,12,8,1,2,1,3,12,3,9,6,1,2,1,3,9,2,7,4
1,1,0,2,4,1,3,1,1,0,1,2,3,0,3,1,1,0,1,2,3,0,3,1
2,1,3,1,24,12,12,3,1,3,2,1,12,5,7,2,1,3,2,1,7,3,4,1
2,3,1,4,2,0,2,1,3,1,2,4,2,1,1,0,3,1,2,4,1,0,1,0
4,1,2,4,17,15,2,1,1,2,4,4,2,1,1,0,1,2,4,4,1,0,1,0
3,0,3,1,29,20,9,2,0,3,3,1,9,6,3,0,0,3,3,1,3,2,1,0
2,2,1,4,11,5,6,5,2,1,2,4,6,2,4,3,2,1,2,4,4,1,3,2
3,2,0,0,2,1,1,0,2,0,3,0,1,0,1,0,2,0,3,0,1,0,1,0
1,1,1,3,4,1,3,2,1,1,1,3,3,0,3,2,1,1,1,3,3,0,3,2
1,0,0,0,7,2,5,0,0,0,1,0,5,1,4,0,0,0,1,0,4,1,3,0
4,3,2,4,9,8,1,0,3,2,4,4,1,0,1,0,3,2,4,4,1,0,1,0
1,1,4,2,22,6,16,7,1,4,1,2,16,4,12,6,1,4,1,2,12,3,9,4
2,0,3,4,29,14,15,13,0,3,2,4,15,7,8,7,0,3,2,4,8,4,4,3
3,3,2,0,11,7,4,0,3,2,3,0,4,2,2,0,3,2,3,0,2,1,1,0
0,3,3,0,18,1,17,1,3,3,0,0,17,1,16,1,3,3,0,0,16,1,15,1
4,4,1,0,0,0,0,0,4,1,4,0,0,0,0,0,4,1,4,0,0,0,0,0
3,1,4,2,23,16,7,3,1,4,3,2,7,4,3,1,1,4,3,2,3,2,1,0
2,2,1,1,3,1,2,0,2,1,2,1,2,1,1,0,2,1,2,1,1,0,1,0
1,3,2,1,6,1,5,1,3,2,1,1,5,1,4,1,3,2,1,1,4,1,3,0
1,0,4,1,29,8,21,6,0,4,1,1,21,6,15,4,0,4,1,1,15,4,11,3
0,2,3,2,10,1,9,4,2,3,0,2,9,0,9,4,2,3,0,2,9,0,9,4
3,4,2,2,7,4,3,1,4,2,3,2,3,2,1,0,4,2,3,2,1,0,1,0
1,2,4,0,19,5,14,1,2,4,1,0,14,4,10,0,2,4,1,0,10,3,7,0
0,3,2,2,8,0,8,3,3,2,0,2,8,0,8,3,3,2,0,2,8,0,8,4
1,0,4,4,27,8,19,17,0,4,1,4,19,5,14,12,0,4,1,4,14,4,10,8
2,4,0,0,7,3,4,0,4,0,2,0,4,2,2,0,4,0,2,0,2,0,2,0
4,3,2,0,4,3,1,0,3,2,4,0,1,0,1,0,3,2,4,0,1,0,1,0
4,4,2,3,6,5,1,0,4,2,4,3,1,0,1,0,4,2,4,3,1,0,1,0
1,3,1,0,9,2,7,0,3,1,1,0,7,2,5,0,3,1,1,0,5,1,4,0
3,4,4,1,11,7,4,1,4,4,3,1,4,2,2,0,4,4,3,1,2,1,1,0
4,4,0,0,3,2,1,0,4,0,4,0,1,0,1,0,4,0,4,0,1,0,1,0
4,1,3,2,21,18,3,1,1,3,4,2,3,2,1,0,1,3,4,2,1,0,1,0
1,1,4,3,28,8,20,13,1,4,1,3,20,6,14,9,1,4,1,3,14,4,10,7
0,3,4,3,12,1,11,7,3,4,0,3,11,1,10,6,3,4,0,3,10,0,10,7
0,1,1,3,9,0,9,6,1,1,0,3,9,0,9,6,1,1,0,3,9,0,9,6
0,4,4,3,11,1,10,6,4,4,0,3,10,1,9,6,4,4,0,3,9,0,9,6
1,3,3,0,14,4,10,0,3,3,1,0,10,3,7,0,3,3,1,0,7,2,5,0
3,3,1,4,9,6,3,2,3,1,3,4,3,2,1,0,3,1,3,4,1,0,1,0
2,3,1,3,7,3,4,2,3,1,2,3,4,1,3,2,3,1,2,3,3,1,2,1
4,3,0,4,1,0,1,0,3,0,4,4,1,0,1,0,3,0,4,4,1,0,1,0
2,4,0,4,2,0,2,1,4,0,2,4,2,1,1,0,4,0,2,4,1,0,1,0
2,1,3,4,21,10,11,9,1,3,2,4,11,5,6,5,1,3,2,4,6,3,3,2
0,0,2,0,24,2,22,2,0,2,0,0,22,2,20,2,0,2,0,0,20,1,19,1
4,0,2,1,18,16,2,0,0,2,4,1,2,1,1,0,0,2,4,1,1,0,1,0
0,4,3,1,11,1,10,2,4,3,0,1,10,1,9,2,4,3,0,1,9,0,9,2
2,4,2,1,7,3,4,1,4,2,2,1,4,1,3,0,4,2,2,1,3,1,2,0
0,4,4,0,7,0,7,0,4,4,0,0,7,0,7,0,4,4,0,0,7,0,7,0
1,3,3,0,14,4,10,0,3,3,1,0,10,3,7,0,3,3,1,0,7,2,5,0
2,1,4,3,27,13,14,9,1,4,2,3,14,7,7,4,1,4,2,3,7,3,4,2
1,3,4,3,19,5,14,9,3,4,1,3,14,4,10,7,3,4,1,3,10,2,8,5
0,2,1,2,13,1,12,6,2,1,0,2,12,1,11,5,2,1,0,2,11,1,10,4
1,2,2,4,14,4,10,9,2,2,1,4,10,2,8,7,2,2,1,4,8,2,6,5
2,3,2,4,8,3,5,4,3,2,2,4,5,2,3,2,3,2,2,4,3,1,2,1
1,2,3,1,13,3,10,3,2,3,1,1,10,2,8,2,2,3,1,1,8,2,6,1
0,3,4,1,19,1,18,5,3,4,0,1,18,1,17,5,3,4,0,1,17,1,16,4
4,2,1,2,11,9,2,0,2,1,4,2,2,1,1,0,2,1,4,2,1,0,1,0
4,1,4,2,23,20,3,1,1,4,4,2,3,2,1,0,1,4,4,2,1,0,1,0
2,1,2,1,19,9,10,3,1,2,2,1,10,5,5,1,1,2,2,1,5,2,3,0
3,2,0,1,5,3,2,0,2,0,3,1,2,1,1,0,2,0,3,1,1,0,1,0
3,0,4,2,29,20,9,4,0,4,3,2,9,6,3,1,0,4,3,2,3,2,1,0
4,4,3,4,11,9,2,1,4,3,4,4,2,1,1,0,4,3,4,4,1,0,1,0
0,3,2,4,12,1,11,9,3,2,0,4,11,1,10,8,3,2,0,4,10,1,9,8
2,3,0,1,2,1,1,0,3,0,2,1,1,0,1,0,3,0,2,1,1,0,1,0
4,2,1,1,15,13,2,0,2,1,4,1,2,1,1,0,2,1,4,1,1,0,1,0
0,2,3,0,27,2,25,2,2,3,0,0,25,2,23,2,2,3,0,0,23,2,21,2
1,1,4,0,22,6,16,1,1,4,1,0,16,4,12,1,1,4,1,0,12,3,9,0
2,3,0,1,3,1,2,0,3,0,2,1,2,0,2,0,3,0,2,1,2,1,1,0
3,3,3,4,10,7,3,2,3,3,3,4,3,2,1,0,3,3,3,4,1,0,1,0
0,4,2,1,2,0,2,0,4,2,0,1,2,0,2,0,4,2,0,1,2,0,2,0
1,3,3,0,8,2,6,0,3,3,1,0,6,1,5,0,3,3,1,0,5,1,4,0
4,3,1,4,1,0,1,0,3,1,4,4,1,0,1,0,3,1,4,4,1,0,1,0
2,1,0,4,6,3,3,2,1,0,2,4,3,1,2,1,1,0,2,4,2,1,1,0
3,2,4,2,22,15,7,3,2,4,3,2,7,4,3,1,2,4,3,2,3,2,1,0
4,4,4,4,3,2,1,0,4,4,4,4,1,0,1,0,4,4,4,4,1,0,1,0
0,4,4,3,5,0,5,3,4,4,0,3,5,0,5,3,4,4,0,3,5,0,5,3
4,1,3,4,21,18,3,2,1,3,4,4,3,2,1,0,1,3,4,4,1,0,1,0
2,0,4,4,26,13,13,11,0,4,2,4,13,6,7,6,0,4,2,4,7,3,4,3
4,4,4,3,5,4,1,0,4,4,4,3,1,0,1,0,4,4,4,3,1,0,1,0
2,1,0,3,9,4,5,3,1,0,2,3,5,2,3,2,1,0,2,3,3,1,2,1
4,3,0,3,5,4,1,0,3,0,4,3,1,0,1,0,3,0,4,3,1,0,1,0
0,0,4,3,28,2,26,18,0,4,0,3,26,2,24,16,0,4,0,3,24,2,22,15
1,1,4,3,27,8,19,13,1,4,1,3,19,5,14,9,1,4,1,3,14,4,10,6
1,4,0,0,3,0,3,0,4,0,1,0,3,0,3,0,4,0,1,0,3,0,3,0
3,2,4,4,24,16,8,7,2,4,3,4,8,5,3,2,2,4,3,4,3,2,1,0
0,1,1,2,18,1,17,8,1,1,0,2,17,1,16,7,1,1,0,2,16,1,15,7
1,0,0,3,19,5,14,9,0,0,1,3,14,4,10,6,0,0,1,3,10,3,7,4
4,0,0,3,8,7,1,0,0,0,4,3,1,0,1,0,0,0,4,3,1,0,1,0
0,0,1,3,13,1,12,8,0,1,0,3,12,1,11,7,0,1,0,3,11,1,10,6
1,4,3,2,3,0,3,1,4,3,1,2,3,0,3,1,4,3,1,2,3,0,3,1
0,4,0,3,1,0,1,0,4,0,0,3,1,0,1,0,4,0,0,3,1,0,1,0
1,0,0,3,11,3,8,5,0,0,1,3,8,2,6,4,0,0,1,3,6,1,5,3
3,0,4,2,26,18,8,4,0,4,3,2,8,5,3,1,0,4,3,2,3,2,1,0
1,0,4,4,27,8,19,17,0,4,1,4,19,5,14,12,0,4,1,4,14,4,10,8
0,2,2,1,18,1,17,5,2,2,0,1,17,1,16,4,2,2,0,1,16,1,15,4
4,1,3,1,18,16,2,0,1,3,4,1,2,1,1,0,1,3,4,1,1,0,1,0
2,0,4,0,26,12,14,1,0,4,2,0,14,7,7,0,0,4,2,0,7,3,4,0
3,2,4,1,22,15,7,2,2,4,3,1,7,4,3,0,2,4,3,1,3,2,1,0
2,4,0,2,0,0,0,0,4,0,2,2,0,0,0,0,4,0,2,2,0,0,0,0
4,2,4,0,17,15,2,0,2,4,4,0,2,1,1,0,2,4,4,0,1,0,1,0
0,4,1,3,6,0,6,4,4,1,0,3,6,0,6,4,4,1,0,3,6,0,6,4
1,3,2,0,17,5,12,1,3,2,1,0,12,3,9,0,3,2,1,0,9,2,7,0
2,0,2,3,13,6,7,4,0,2,2,3,7,3,4,2,0,2,2,3,4,1,3,2
2,4,1,0,5,2,3,0,4,1,2,0,3,1,2,0,4,1,2,0,2,1,1,0
3,2,4,4,23,16,7,6,2,4,3,4,7,4,3,2,2,4,3,4,3,2,1,0
2,2,1,2,10,5,5,2,2,1,2,2,5,2,3,1,2,1,2,2,3,1,2,0
0,1,4,4,29,2,27,24,1,4,0,4,27,2,25,22,1,4,0,4,25,2,23,20
4,0,2,3,17,15,2,1,0,2,4,3,2,1,1,0,0,2,4,3,1,0,1,0
0,0,2,4,23,2,21,18,0,2,0,4,21,2,19,17,0,2,0,4,19,1,18,16
2,1,0,1,4,1,3,0,1,0,2,1,3,1,2,0,1,0,2,1,2,0,2,0
4,2,1,4,13,11,2,1,2,1,4,4,2,1,1,0,2,1,4,4,1,0,1,0
4,3,0,0,1,0,1,0,3,0,4,0,1,0,1,0,3,0,4,0,1,0,1,0
0,2,3,0,18,1,17,1,2,3,0,0,17,1,16,1,2,3,0,0,16,1,15,1
2,0,2,2,18,8,10,5,0,2,2,2,10,5,5,2,0,2,2,2,5,2,3,1
2,0,4,4,28,13,15,13,0,4,2,4,15,7,8,7,0,4,2,4,8,4,4,3
4,2,1,4,8,7,1,0,2,1,4,4,1,0,1,0,2,1,4,4,1,0,1,0
1,0,2,3,19,5,14,9,0,2,1,3,14,4,10,6,0,2,1,3,10,3,7,4
1,4,0,4,5,1,4,3,4,0,1,4,4,1,3,2,4,0,1,4,3,0,3,2
4,2,0,4,3,2,1,0,2,0,4,4,1,0,1,0,2,0,4,4,1,0,1,0
2,3,3,0,6,2,4,0,3,3,2,0,4,1,3,0,3,3,2,0,3,1,2,0
0,3,0,3,3,0,3,2,3,0,0,3,3,0,3,2,3,0,0,3,3,0,3,2
2,2,1,3,8,3,5,3,2,1,2,3,5,2,3,2,2,1,2,3,3,1,2,1
0,0,0,0,13,1,12,1,0,0,0,0,12,1,11,1,0,0,0,0,11,1,10,1
1,1,3,3,18,5,13,9,1,3,1,3,13,3,10,6,1,3,1,3,10,2,8,5
2,3,2,2,4,2,2,0,3,2,2,2,2,0,2,0,3,2,2,2,2,1,1,0
1,3,2,2,6,1,5,2,3,2,1,2,5,1,4,1,3,2,1,2,4,1,3,1
1,2,4,4,16,4,12,10,2,4,1,4,12,3,9,8,2,4,1,4,9,2,7,6
4,0,1,4,17,15,2,1,0,1,4,4,2,1,1,0,0,1,4,4,1,0,1,0
2,2,0,2,4,1,3,1,2,0,2,2,3,1,2,0,2,0,2,2,2,1,1,0
0,2,4,1,21,2,19,5,2,4,0,1,19,1,18,5,2,4,0,1,18,1,17,5
2,2,3,0,22,10,12,1,2,3,2,0,12,5,7,0,2,3,2,0,7,3,4,0
4,2,2,4,8,7,1,0,2,2,4,4,1,0,1,0,2,2,4,4,1,0,1,0
0,2,0,1,12,1,11,3,2,0,0,1,11,1,10,3,2,0,0,1,10,1,9,2
4,1,3,2,22,19,3,1,1,3,4,2,3,2,1,0,1,3,4,2,1,0,1,0
4,2,2,1,19,17,2,0,2,2,4,1,2,1,1,0,2,2,4,1,1,0,1,0
4,3,0,1,2,1,1,0,3,0,4,1,1,0,1,0,3,0,4,1,1,0,1,0
3,0,4,3,28,19,9,6,0,4,3,3,9,6,3,2,0,4,3,3,3,2,1,0
2,4,2,1,1,0,1,0,4,2,2,1,1,0,1,0,4,2,2,1,1,0,1,0
4,4,4,4,3,2,1,0,4,4,4,4,1,0,1,0,4,4,4,4,1,0,1,0
3,3,0,3,6,4,2,1,3,0,3,3,2,1,1,0,3,0,3,3,1,0,1,0
1,0,1,4,14,4,10,9,0,1,1,4,10,3,7,6,0,1,1,4,7,2,5,4
1,1,1,3,15,4,11,7,1,1,1,3,11,3,8,5,1,1,1,3,8,2,6,4
0,3,0,0,4,0,4,0,3,0,0,0,4,0,4,0,3,0,0,0,4,0,4,0
0,1,1,3,20,1,19,13,1,1,0,3,19,1,18,12,1,1,0,3,18,1,17,11
0,2,3,1,20,1,19,5,2,3,0,1,19,1,18,5,2,3,0,1,18,1,17,5
4,3,0,0,0,0,0,0,3,0,4,0,0,0,0,0,3,0,4,0,0,0,0,0
1,2,1,1,13,3,10,2,2,1,1,1,10,3,7,2,2,1,1,1,7,2,5,1
3,0,3,2,29,20,9,4,0,3,3,2,9,6,3,1,0,3,3,2,3,2,1,0
0,0,0,0,3,0,3,0,0,0,0,0,3,0,3,0,0,0,0,0,3,0,3,0
4,3,4,4,0,0,0,0,3,4,4,4,0,0,0,0,3,4,4,4,0,0,0,0
1,4,4,1,10,3,7,2,4,4,1,1,7,2,5,1,4,4,1,1,5,1,4,1
2,1,3,4,22,11,11,9,1,3,2,4,11,5,6,5,1,3,2,4,6,3,3,2
0,3,4,0,6,0,6,0,3,4,0,0,6,0,6,0,3,4,0,0,6,0,6,0
1,0,0,0,20,5,15,1,0,0,1,0,15,4,11,1,0,0,1,0,11,3,8,0
4,3,0,3,2,1,1,0,3,0,4,3,1,0,1,0,3,0,4,3,1,0,1,0
4,1,0,1,11,9,2,0,1,0,4,1,2,1,1,0,1,0,4,1,1,0,1,0
0,1,0,3,8,0,8,5,1,0,0,3,8,0,8,5,1,0,0,3,8,0,8,5
0,0,2,3,21,2,19,13,0,2,0,3,19,1,18,12,0,2,0,3,18,1,17,11
3,0,4,2,29,20,9,4,0,4,3,2,9,6,3,1,0,4,3,2,3,2,1,0
4,4,1,0,1,0,1,0,4,1,4,0,1,0,1,0,4,1,4,0,1,0,1,0
0,4,0,0,1,0,1,0,4,0,0,0,1,0,1,0,4,0,0,0,1,0,1,0
0,1,1,1,18,1,17,5,1,1,0,1,17,1,16,4,1,1,0,1,16,1,15,4
4,2,3,3,19,17,2,1,2,3,4,3,2,1,1,0,2,3,4,3,1,0,1,0
0,0,3,1,27,2,25,7,0,3,0,1,25,2,23,6,0,3,0,1,23,2,21,6
4,1,0,2,0,0,0,0,1,0,4,2,0,0,0,0,1,0,4,2,0,0,0,0
4,1,3,0,16,14,2,0,1,3,4,0,2,1,1,0,1,3,4,0,1,0,1,0
2,2,1,2,3,1,2,0,2,1,2,2,2,0,2,1,2,1,2,2,2,0,2,0
2,1,0,1,8,4,4,1,1,0,2,1,4,1,3,0,1,0,2,1,3,1,2,0
1,0,0,2,6,1,5,2,0,0,1,2,5,1,4,2,0,0,1,2,4,1,3,1
3,0,0,3,9,6,3,2,0,0,3,3,3,2,1,0,0,0,3,3,1,0,1,0
4,0,0,4,9,8,1,0,0,0,4,4,1,0,1,0,0,0,4,4,1,0,1,0
0,3,3,2,7,0,7,3,3,3,0,2,7,0,7,3,3,3,0,2,7,0,7,3
0,3,0,4,3,0,3,2,3,0,0,4,3,0,3,2,3,0,0,4,3,0,3,2
3,4,3,1,5,3,2,0,4,3,3,1,2,1,1,0,4,3,3,1,1,0,1,0
4,0,3,0,24,21,3,0,0,3,4,0,3,2,1,0,0,3,4,0,1,0,1,0
2,1,4,4,22,11,11,9,1,4,2,4,11,5,6,5,1,4,2,4,6,2,4,3
0,4,4,1,9,0,9,2,4,4,0,1,9,0,9,2,4,4,0,1,9,0,9,2
0,1,1,1,9,0,9,2,1,1,0,1,9,0,9,2,1,1,0,1,9,0,9,2
2,1,3,4,28,14,14,12,1,3,2,4,14,7,7,6,1,3,2,4,7,3,4,3
1,3,3,2,4,1,3,1,3,3,1,2,3,0,3,1,3,3,1,2,3,0,3,1
1,4,4,3,8,2,6,4,4,4,1,3,6,1,5,3,4,4,1,3,5,1,4,2
4,1,2,3,14,12,2,1,1,2,4,3,2,1,1,0,1,2,4,3,1,0,1,0
2,3,1,2,10,5,5,2,3,1,2,2,5,2,3,1,3,1,2,2,3,1,2,1
4,4,4,2,4,3,1,0,4,4,4,2,1,0,1,0,4,4,4,2,1,0,1,0
2,0,1,3,18,9,9,6,0,1,2,3,9,4,5,3,0,1,2,3,5,2,3,2
0,2,4,0,19,1,18,1,2,4,0,0,18,1,17,1,2,4,0,0,17,1,16,1
2,2,4,2,23,11,12,5,2,4,2,2,12,5,7,3,2,4,2,2,7,3,4,1
3,0,1,1,11,7,4,1,0,1,3,1,4,2,2,0,0,1,3,1,2,1,1,0
3,1,4,1,23,16,7,2,1,4,3,1,7,4,3,0,1,4,3,1,3,2,1,0
3,3,3,3,15,10,5,3,3,3,3,3,5,3,2,1,3,3,3,3,2,1,1,0
2,4,4,4,10,5,5,4,4,4,2,4,5,2,3,2,4,4,2,4,3,1,2,1
2,0,4,4,27,13,14,12,0,4,2,4,14,7,7,6,0,4,2,4,7,3,4,3
0,3,3,1,12,1,11,3,3,3,0,1,11,1,10,3,3,3,0,1,10,0,10,2
4,4,2,3,0,0,0,0,4,2,4,3,0,0,0,0,4,2,4,3,0,0,0,0
3,1,1,1,17,11,6,1,1,1,3,1,6,4,2,0,1,1,3,1,2,1,1,0
2,3,3,3,13,6,7,4,3,3,2,3,7,3,4,2,3,3,2,3,4,1,3,2
1,3,2,0,23,6,17,1,3,2,1,0,17,5,12,1,3,2,1,0,12,3,9,0
2,2,4,2,23,11,12,6,2,4,2,2,12,6,6,3,2,4,2,2,6,3,3,1
1,0,2,1,23,6,17,5,0,2,1,1,17,5,12,3,0,2,1,1,12,3,9,2
4,1,1,3,8,7,1,0,1,1,4,3,1,0,1,0,1,1,4,3,1,0,1,0
0,2,0,1,10,0,10,2,2,0,0,1,10,0,10,2,2,0,0,1,10,1,9,2
3,2,4,4,28,19,9,8,2,4,3,4,9,6,3,2,2,4,3,4,3,2,1,0
4,2,0,2,12,10,2,1,2,0,4,2,2,1,1,0,2,0,4,2,1,0,1,0
3,0,2,0,15,10,5,0,0,2,3,0,5,3,2,0,0,2,3,0,2,1,1,0
4,4,4,3,8,7,1,0,4,4,4,3,1,0,1,0,4,4,4,3,1,0,1,0
3,4,4,4,1,0,1,0,4,4,3,4,1,0,1,0,4,4,3,4,1,0,1,0
0,2,4,4,20,2,18,16,2,4,0,4,18,1,17,15,2,4,0,4,17,1,16,14
2,1,3,4,22,10,12,10,1,3,2,4,12,5,7,6,1,3,2,4,7,3,4,3
4,3,0,1,12,10,2,0,3,0,4,1,2,1,1,0,3,0,4,1,1,0,1,0
4,4,1,2,9,8,1,0,4,1,4,2,1,0,1,0,4,1,4,2,1,0,1,0
3,0,4,0,26,18,8,0,0,4,3,0,8,5,3,0,0,4,3,0,3,2,1,0
3,3,3,2,12,8,4,2,3,3,3,2,4,2,2,0,3,3,3,2,2,1,1,0
2,3,2,4,13,6,7,6,3,2,2,4,7,3,4,3,3,2,2,4,4,2,2,1
0,2,3,0,16,1,15,1,2,3,0,0,15,1,14,1,2,3,0,0,14,1,13,1
1,0,2,3,18,5,13,9,0,2,1,3,13,3,10,6,0,2,1,3,10,2,8,5
1,4,0,2,5,1,4,1,4,0,1,2,4,1,3,1,4,0,1,2,3,0,3,1
0,2,1,2,13,1,12,6,2,1,0,2,12,1,11,5,2,1,0,2,11,1,10,4
3,4,0,2,7,4,3,1,4,0,3,2,3,2,1,0,4,0,3,2,1,0,1,0
0,1,3,3,23,2,21,14,1,3,0,3,21,2,19,13,1,3,0,3,19,1,18,12
2,3,2,1,20,9,11,3,3,2,2,1,11,5,6,1,3,2,2,1,6,2,4,1
1,2,2,3,7,2,5,3,2,2,1,3,5,1,4,2,2,2,1,3,4,1,3,2
0,2,2,0,14,1,13,1,2,2,0,0,13,1,12,1,2,2,0,0,12,1,11,1
2,1,0,0,4,1,3,0,1,0,2,0,3,1,2,0,1,0,2,0,2,0,2,0
2,4,1,2,2,0,2,0,4,1,2,2,2,1,1,0,4,1,2,2,1,0,1,0
2,4,2,1,1,0,1,0,4,2,2,1,1,0,1,0,4,2,2,1,1,0,1,0
1,4,0,3,7,2,5,3,4,0,1,3,5,1,4,2,4,0,1,3,4,1,3,2
0,1,0,1,5,0,5,1,1,0,0,1,5,0,5,1,1,0,0,1,5,0,5,1
1,1,4,4,27,8,19,17,1,4,1,4,19,5,14,12,1,4,1,4,14,4,10,9
4,4,4,0,14,12,2,0,4,4,4,0,2,1,1,0,4,4,4,0,1,0,1,0
4,2,3,3,24,21,3,2,2,3,4,3,3,2,1,0,2,3,4,3,1,0,1,0
1,0,2,0,14,4,10,0,0,2,1,0,10,3,7,0,0,2,1,0,7,2,5,0
2,3,3,4,5,2,3,2,3,3,2,4,3,1,2,1,3,3,2,4,2,0,2,1
1,1,0,1,7,2,5,1,1,0,1,1,5,1,4,1,1,0,1,1,4,1,3,0
3,2,3,4,27,18,9,8,2,3,3,4,9,6,3,2,2,3,3,4,3,2,1,0
1,4,0,0,9,2,7,0,4,0,1,0,7,2,5,0,4,0,1,0,5,1,4,0
3,4,2,1,0,0,0,0,4,2,3,1,0,0,0,0,4,2,3,1,0,0,0,0
3,1,0,2,3,2,1,0,1,0,3,2,1,0,1,0,1,0,3,2,1,0,1,0
3,2,2,4,12,8,4,3,2,2,3,4,4,2,2,1,2,2,3,4,2,1,1,0
0,3,3,0,19,1,18,1,3,3,0,0,18,1,17,1,3,3,0,0,17,1,16,1
1,3,4,3,17,5,12,8,3,4,1,3,12,3,9,6,3,4,1,3,9,2,7,4
4,4,0,3,3,2,1,0,4,0,4,3,1,0,1,0,4,0,4,3,1,0,1,0
4,2,2,2,9,8,1,0,2,2,4,2,1,0,1,0,2,2,4,2,1,0,1,0
3,0,0,0,1,0,1,0,0,0,3,0,1,0,1,0,0,0,3,0,1,0,1,0
1,0,1,4,16,4,12,10,0,1,1,4,12,3,9,8,0,1,1,4,9,2,7,6
3,0,2,3,22,15,7,4,0,2,3,3,7,4,3,2,0,2,3,3,3,2,1,0
1,1,1,1,11,3,8,2,1,1,1,1,8,2,6,1,1,1,1,1,6,1,5,1
3,2,3,4,25,17,8,7,2,3,3,4,8,5,3,2,2,3,3,4,3,2,1,0
4,4,4,2,4,3,1,0,4,4,4,2,1,0,1,0,4,4,4,2,1,0,1,0
1,4,0,0,1,0,1,0,4,0,1,0,1,0,1,0,4,0,1,0,1,0,1,0
4,0,4,1,28,25,3,0,0,4,4,1,3,2,1,0,0,4,4,1,1,0,1,0
4,0,4,1,29,26,3,0,0,4,4,1,3,2,1,0,0,4,4,1,1,0,1,0
2,2,1,0,10,4,6,0,2,1,2,0,6,2,4,0,2,1,2,0,4,1,3,0
3,1,3,2,29,20,9,4,1,3,3,2,9,6,3,1,1,3,3,2,3,2,1,0
2,0,1,0,18,9,9,0,0,1,2,0,9,4,5,0,0,1,2,0,5,2,3,0
2,4,2,3,3,1,2,1,4,2,2,3,2,1,1,0,4,2,2,3,1,0,1,0
2,4,0,3,2,0,2,1,4,0,2,3,2,1,1,0,4,0,2,3,1,0,1,0
0,0,0,1,10,0,10,3,0,0,0,1,10,1,9,2,0,0,0,1,9,0,9,2
4,1,4,0,29,26,3,0,1,4,4,0,3,2,1,0,1,4,4,0,1,0,1,0
2,0,4,2,29,14,15,7,0,4,2,2,15,7,8,3,0,4,2,2,8,3,5,2
2,1,0,3,10,4,6,4,1,0,2,3,6,3,3,2,1,0,2,3,3,1,2,1
4,3,0,4,4,3,1,0,3,0,4,4,1,0,1,0,3,0,4,4,1,0,1,0
4,4,4,0,6,5,1,0,4,4,4,0,1,0,1,0,4,4,4,0,1,0,1,0
3,2,0,2,2,1,1,0,2,0,3,2,1,0,1,0,2,0,3,2,1,0,1,0
3,3,2,0,3,2,1,0,3,2,3,0,1,0,1,0,3,2,3,0,1,0,1,0
1,0,1,4,11,3,8,7,0,1,1,4,8,2,6,5,0,1,1,4,6,1,5,4
0,4,0,4,4,0,4,3,4,0,0,4,4,0,4,3,4,0,0,4,4,0,4,3
4,0,3,2,25,22,3,1,0,3,4,2,3,2,1,0,0,3,4,2,1,0,1,0
1,3,1,2,10,3,7,3,3,1,1,2,7,2,5,2,3,1,1,2,5,1,4,1
1,0,3,2,25,7,18,9,0,3,1,2,18,5,13,6,0,3,1,2,13,3,10,4
2,2,3,1,22,10,12,3,2,3,2,1,12,5,7,2,2,3,2,1,7,3,4,1
3,0,2,3,14,9,5,3,0,2,3,3,5,3,2,1,0,2,3,3,2,1,1,0
4,1,0,3,13,11,2,1,1,0,4,3,2,1,1,0,1,0,4,3,1,0,1,0
2,2,3,2,23,11,12,5,2,3,2,2,12,5,7,3,2,3,2,2,7,3,4,1
0,2,3,1,16,1,15,4,2,3,0,1,15,1,14,4,2,3,0,1,14,1,13,3
2,1,2,1,16,8,8,2,1,2,2,1,8,3,5,1,1,2,2,1,5,2,3,0
3,4,4,3,12,8,4,2,4,4,3,3,4,2,2,1,4,4,3,3,2,1,1,0
4,3,4,0,15,13,2,0,3,4,4,0,2,1,1,0,3,4,4,0,1,0,1,0
4,4,0,4,4,3,1,0,4,0,4,4,1,0,1,0,4,0,4,4,1,0,1,0
0,4,0,4,4,0,4,3,4,0,0,4,4,0,4,3,4,0,0,4,4,0,4,3
1,4,4,1,8,2,6,1,4,4,1,1,6,1,5,1,4,4,1,1,5,1,4,1
0,4,4,2,5,0,5,2,4,4,0,2,5,0,5,2,4,4,0,2,5,0,5,2
0,1,1,3,14,1,13,9,1,1,0,3,13,1,12,8,1,1,0,3,12,1,11,7
3,2,4,2,17,11,6,3,2,4,3,2,6,4,2,1,2,4,3,2,2,1,1,0
4,3,0,3,1,0,1,0,3,0,4,3,1,0,1,0,3,0,4,3,1,0,1,0
3,4,2,1,6,4,2,0,4,2,3,1,2,1,1,0,4,2,3,1,1,0,1,0
2,2,1,3,16,8,8,5,2,1,2,3,8,4,4,2,2,1,2,3,4,2,2,1
1,2,4,3,24,7,17,11,2,4,1,3,17,5,12,8,2,4,1,3,12,3,9,6
4,1,0,0,3,2,1,0,1,0,4,0,1,0,1,0,1,0,4,0,1,0,1,0
1,4,4,2,9,2,7,3,4,4,1,2,7,2,5,2,4,4,1,2,5,1,4,2
2,2,4,3,25,12,13,9,2,4,2,3,13,6,7,4,2,4,2,3,7,3,4,2
3,0,3,4,25,17,8,7,0,3,3,4,8,5,3,2,0,3,3,4,3,2,1,0
4,3,2,1,2,1,1,0,3,2,4,1,1,0,1,0,3,2,4,1,1,0,1,0
3,2,3,3,16,11,5,3,2,3,3,3,5,3,2,1,2,3,3,3,2,1,1,0
1,4,3,1,10,2,8,2,4,3,1,1,8,2,6,1,4,3,1,1,6,1,5,1
0,2,4,4,21,2,19,17,2,4,0,4,19,1,18,16,2,4,0,4,18,1,17,15
1,4,0,1,9,2,7,2,4,0,1,1,7,2,5,1,4,0,1,1,5,1,4,1
1,0,2,3,24,7,17,11,0,2,1,3,17,5,12,8,0,2,1,3,12,3,9,6
1,2,4,1,27,8,19,5,2,4,1,1,19,5,14,4,2,4,1,1,14,4,10,2
3,4,2,1,8,5,3,0,4,2,3,1,3,2,1,0,4,2,3,1,1,0,1,0
0,0,4,0,28,2,26,2,0,4,0,0,26,2,24,2,0,4,0,0,24,2,22,2
2,0,1,4,14,7,7,6,0,1,2,4,7,3,4,3,0,1,2,4,4,2,2,1
2,3,0,1,7,3,4,1,3,0,2,1,4,1,3,0,3,0,2,1,3,1,2,0
2,4,0,4,11,5,6,5,4,0,2,4,6,3,3,2,4,0,2,4,3,1,2,1
3,4,1,4,8,5,3,2,4,1,3,4,3,2,1,0,4,1,3,4,1,0,1,0
2,3,4,2,18,9,9,4,3,4,2,2,9,4,5,2,3,4,2,2,5,2,3,1
0,3,1,0,6,0,6,0,3,1,0,0,6,0,6,0,3,1,0,0,6,0,6,0
1,1,2,3,19,5,14,9,1,2,1,3,14,4,10,6,1,2,1,3,10,2,8,5
2,3,2,4,3,1,2,1,3,2,2,4,2,0,2,1,3,2,2,4,2,0,2,1
3,3,2,4,9,6,3,2,3,2,3,4,3,2,1,0,3,2,3,4,1,0,1,0
4,4,4,0,17,15,2,0,4,4,4,0,2,1,1,0,4,4,4,0,1,0,1,0
0,2,0,2,8,0,8,4,2,0,0,2,8,0,8,3,2,0,0,2,8,0,8,4
1,2,2,0,12,3,9,0,2,2,1,0,9,2,7,0,2,2,1,0,7,2,5,0
0,0,1,0,19,1,18,1,0,1,0,0,18,1,17,1,0,1,0,0,17,1,16,1
2,0,2,4,18,8,10,9,0,2,2,4,10,5,5,4,0,2,2,4,5,2,3,2
4,2,4,2,21,18,3,1,2,4,4,2,3,2,1,0,2,4,4,2,1,0,1,0
2,2,0,3,5,2,3,2,2,0,2,3,3,1,2,1,2,0,2,3,2,0,2,1
3,2,3,4,11,7,4,3,2,3,3,4,4,2,2,1,2,3,3,4,2,1,1,0
0,2,4,4,26,2,24,21,2,4,0,4,24,2,22,19,2,4,0,4,22,2,20,18
3,3,3,0,16,11,5,0,3,3,3,0,5,3,2,0,3,3,3,0,2,1,1,0
2,2,2,4,4,1,3,2,2,2,2,4,3,1,2,1,2,2,2,4,2,0,2,1
0,1,4,0,27,2,25,2,1,4,0,0,25,2,23,2,1,4,0,0,23,2,21,2
2,0,0,3,9,4,5,3,0,0,2,3,5,2,3,2,0,0,2,3,3,1,2,1
4,3,0,0,2,1,1,0,3,0,4,0,1,0,1,0,3,0,4,0,1,0,1,0
2,1,4,2,25,12,13,6,1,4,2,2,13,6,7,3,1,4,2,2,7,3,4,2
2,1,1,3,9,4,5,3,1,1,2,3,5,2,3,2,1,1,2,3,3,1,2,1
4,4,3,2,2,1,1,0,4,3,4,2,1,0,1,0,4,3,4,2,1,0,1,0
0,0,0,3,2,0,2,1,0,0,0,3,2,0,2,1,0,0,0,3,2,0,2,1
1,0,3,0,26,7,19,1,0,3,1,0,19,5,14,1,0,3,1,0,14,4,10,0
1,3,4,1,10,2,8,2,3,4,1,1,8,2,6,1,3,4,1,1,6,1,5,1
2,2,4,1,27,13,14,4,2,4,2,1,14,7,7,2,2,4,2,1,7,3,4,1
3,0,2,0,26,18,8,0,0,2,3,0,8,5,3,0,0,2,3,0,3,2,1,0
2,0,1,1,24,12,12,3,0,1,2,1,12,6,6,1,0,1,2,1,6,2,4,1
0,1,2,1,18,1,17,5,1,2,0,1,17,1,16,4,1,2,0,1,16,1,15,4
0,1,2,1,11,1,10,2,1,2,0,1,10,0,10,2,1,2,0,1,10,1,9,2
4,4,2,3,1,0,1,0,4,2,4,3,1,0,1,0,4,2,4,3,1,0,1,0
2,3,1,3,9,4,5,3,3,1,2,3,5,2,3,2,3,1,2,3,3,1,2,1
3,4,2,4,5,3,2,1,4,2,3,4,2,1,1,0,4,2,3,4,1,0,1,0
2,1,1,2,9,4,5,2,1,1,2,2,5,2,3,1,1,1,2,2,3,1,2,1
3,1,3,4,14,9,5,4,1,3,3,4,5,3,2,1,1,3,3,4,2,1,1,0
4,0,0,2,4,3,1,0,0,0,4,2,1,0,1,0,0,0,4,2,1,0,1,0
1,4,0,2,2,0,2,0,4,0,1,2,2,0,2,0,4,0,1,2,2,0,2,1
3,0,0,2,13,9,4,1,0,0,3,2,4,2,2,1,0,0,3,2,2,1,1,0
4,4,3,0,6,5,1,0,4,3,4,0,1,0,1,0,4,3,4,0,1,0,1,0
4,4,1,3,5,4,1,0,4,1,4,3,1,0,1,0,4,1,4,3,1,0,1,0
3,3,2,4,12,8,4,3,3,2,3,4,4,2,2,1,3,2,3,4,2,1,1,0
2,2,2,3,16,8,8,5,2,2,2,3,8,3,5,3,2,2,2,3,5,2,3,2
3,1,1,4,10,7,3,2,1,1,3,4,3,2,1,0,1,1,3,4,1,0,1,0
4,1,3,1,19,17,2,0,1,3,4,1,2,1,1,0,1,3,4,1,1,0,1,0
0,3,4,2,10,1,9,4,3,4,0,2,9,0,9,4,3,4,0,2,9,0,9,4
0,0,3,3,25,2,23,16,0,3,0,3,23,2,21,14,0,3,0,3,21,2,19,13
0,3,1,2,8,0,8,3,3,1,0,2,8,0,8,4,3,1,0,2,8,0,8,4
3,4,2,3,8,5,3,2,4,2,3,3,3,2,1,0,4,2,3,3,1,0,1,0
4,1,3,4,25,22,3,2,1,3,4,4,3,2,1,0,1,3,4,4,1,0,1,0
1,0,0,2,3,0,3,1,0,0,1,2,3,0,3,1,0,0,1,2,3,0,3,1
0,1,1,3,16,1,15,10,1,1,0,3,15,1,14,9,1,1,0,3,14,1,13,9
3,0,2,3,22,15,7,4,0,2,3,3,7,4,3,2,0,2,3,3,3,2,1,0
3,0,3,0,26,18,8,0,0,3,3,0,8,5,3,0,0,3,3,0,3,2,1,0
0,4,4,2,7,0,7,3,4,4,0,2,7,0,7,3,4,4,0,2,7,0,7,3
0,1,3,0,19,1,18,1,1,3,0,0,18,1,17,1,1,3,0,0,17,1,16,1
3,2,3,0,17,11,6,0,2,3,3,0,6,4,2,0,2,3,3,0,2,1,1,0
0,3,1,2,8,0,8,3,3,1,0,2,8,0,8,3,3,1,0,2,8,0,8,3
0,3,4,2,15,1,14,6,3,4,0,2,14,1,13,6,3,4,0,2,13,1,12,6
4,1,2,2,13,11,2,0,1,2,4,2,2,1,1,0,1,2,4,2,1,0,1,0
4,2,0,4,4,3,1,0,2,0,4,4,1,0,1,0,2,0,4,4,1,0,1,0
1,1,1,1,7,2,5,1,1,1,1,1,5,1,4,1,1,1,1,1,4,1,3,0
2,3,4,3,10,5,5,3,3,4,2,3,5,2,3,2,3,4,2,3,3,1,2,1
2,2,2,0,9,4,5,0,2,2,2,0,5,2,3,0,2,2,2,0,3,1,2,0
4,2,0,1,4,3,1,0,2,0,4,1,1,0,1,0,2,0,4,1,1,0,1,0
0,1,1,0,12,1,11,1,1,1,0,0,11,1,10,1,1,1,0,0,10,1,9,0
2,1,4,2,28,14,14,6,1,4,2,2,14,7,7,3,1,4,2,2,7,3,4,1
3,0,1,4,15,10,5,4,0,1,3,4,5,3,2,1,0,1,3,4,2,1,1,0
2,0,1,3,13,6,7,4,0,1,2,3,7,3,4,2,0,1,2,3,4,2,2,1
4,3,1,2,8,7,1,0,3,1,4,2,1,0,1,0,3,1,4,2,1,0,1,0
3,3,2,1,7,4,3,0,3,2,3,1,3,2,1,0,3,2,3,1,1,0,1,0
0,1,1,2,4,0,4,1,1,1,0,2,4,0,4,1,1,1,0,2,4,0,4,1
1,4,0,2,8,2,6,3,4,0,1,2,6,1,5,2,4,0,1,2,5,1,4,2
0,3,3,3,13,1,12,8,3,3,0,3,12,1,11,7,3,3,0,3,11,1,10,6
1,0,0,1,11,3,8,2,0,0,1,1,8,2,6,1,0,0,1,1,6,1,5,1
0,4,3,3,11,1,10,6,4,3,0,3,10,0,10,7,4,3,0,3,10,0,10,6
0,4,2,2,1,0,1,0,4,2,0,2,1,0,1,0,4,2,0,2,1,0,1,0
0,2,2,2,6,0,6,3,2,2,0,2,6,0,6,2,2,2,0,2,6,0,6,2
0,4,2,2,0,0,0,0,4,2,0,2,0,0,0,0,4,2,0,2,0,0,0,0
1,2,2,2,7,2,5,2,2,2,1,2,5,1,4,2,2,2,1,2,4,1,3,1
1,2,0,2,8,2,6,2,2,0,1,2,6,1,5,2,2,0,1,2,5,1,4,2
0,1,1,4,14,1,13,11,1,1,0,4,13,1,12,10,1,1,0,4,12,1,11,9
1,0,1,3,11,3,8,5,0,1,1,3,8,2,6,4,0,1,1,3,6,1,5,3
1,0,0,2,18,5,13,6,0,0,1,2,13,3,10,4,0,0,1,2,10,3,7,3
4,1,4,2,24,21,3,1,1,4,4,2,3,2,1,0,1,4,4,2,1,0,1,0
0,2,3,2,26,2,24,11,2,3,0,2,24,2,22,11,2,3,0,2,22,2,20,9
0,0,0,0,10,0,10,1,0,0,0,0,10,0,10,0,0,0,0,0,10,1,9,0
2,4,3,3,1,0,1,0,4,3,2,3,1,0,1,0,4,3,2,3,1,0,1,0
4,0,4,2,27,24,3,1,0,4,4,2,3,2,1,0,0,4,4,2,1,0,1,0
3,0,0,3,5,3,2,1,0,0,3,3,2,1,1,0,0,0,3,3,1,0,1,0
0,1,4,3,25,2,23,16,1,4,0,3,23,2,21,14,1,4,0,3,21,2,19,13
1,1,1,3,18,5,13,9,1,1,1,3,13,3,10,6,1,1,1,3,10,2,8,5
0,2,1,3,6,0,6,4,2,1,0,3,6,0,6,4,2,1,0,3,6,0,6,4
3,0,1,0,16,11,5,0,0,1,3,0,5,3,2,0,0,1,3,0,2,1,1,0
3,3,0,2,5,3,2,1,3,0,3,2,2,1,1,0,3,0,3,2,1,0,1,0
2,3,3,4,0,0,0,0,3,3,2,4,0,0,0,0,3,3,2,4,0,0,0,0
3,4,4,3,9,6,3,2,4,4,3,3,3,2,1,0,4,4,3,3,1,0,1,0
3,3,3,4,12,8,4,3,3,3,3,4,4,2,2,1,3,3,3,4,2,1,1,0
2,4,2,3,8,3,5,3,4,2,2,3,5,2,3,2,4,2,2,3,3,1,2,1
2,1,1,2,16,8,8,3,1,1,2,2,8,3,5,2,1,1,2,2,5,2,3,1
4,2,2,0,9,8,1,0,2,2,4,0,1,0,1,0,2,2,4,0,1,0,1,0
1,3,4,0,15,4,11,1,3,4,1,0,11,3,8,0,3,4,1,0,8,2,6,0
0,0,0,2,13,1,12,6,0,0,0,2,12,1,11,5,0,0,0,2,11,1,10,4
2,3,0,1,8,3,5,1,3,0,2,1,5,2,3,0,3,0,2,1,3,1,2,0
3,3,3,1,16,11,5,1,3,3,3,1,5,3,2,0,3,3,3,1,2,1,1,0
2,1,4,4,25,12,13,11,1,4,2,4,13,6,7,6,1,4,2,4,7,3,4,3
1,1,3,1,26,7,19,5,1,3,1,1,19,5,14,4,1,3,1,1,14,4,10,2
3,3,4,3,17,11,6,4,3,4,3,3,6,4,2,1,3,4,3,3,2,1,1,0
2,0,1,4,10,5,5,4,0,1,2,4,5,2,3,2,0,1,2,4,3,1,2,1
3,0,3,2,29,20,9,4,0,3,3,2,9,6,3,1,0,3,3,2,3,2,1,0
3,4,4,2,6,4,2,0,4,4,3,2,2,1,1,0,4,4,3,2,1,0,1,0
1,4,0,3,0,0,0,0,4,0,1,3,0,0,0,0,4,0,1,3,0,0,0,0
3,4,3,4,8,5,3,2,4,3,3,4,3,2,1,0,4,3,3,4,1,0,1,0
4,3,1,0,3,2,1,0,3,1,4,0,1,0,1,0,3,1,4,0,1,0,1,0
3,4,1,4,5,3,2,1,4,1,3,4,2,1,1,0,4,1,3,4,1,0,1,0
4,2,3,2,11,9,2,0,2,3,4,2,2,1,1,0,2,3,4,2,1,0,1,0
1,2,0,1,3,0,3,0,2,0,1,1,3,0,3,0,2,0,1,1,3,0,3,0
0,4,1,1,10,1,9,2,4,1,0,1,9,0,9,2,4,1,0,1,9,0,9,2
4,1,3,3,27,24,3,2,1,3,4,3,3,2,1,0,1,3,4,3,1,0,1,0
4,4,1,2,4,3,1,0,4,1,4,2,1,0,1,0,4,1,4,2,1,0,1,0
4,1,3,1,24,21,3,0,1,3,4,1,3,2,1,0,1,3,4,1,1,0,1,0
2,4,1,4,0,0,0,0,4,1,2,4,0,0,0,0,4,1,2,4,0,0,0,0
0,0,3,2,25,2,23,11,0,3,0,2,23,2,21,10,0,3,0,2,21,2,19,9
2,0,0,4,6,3,3,2,0,0,2,4,3,1,2,1,0,0,2,4,2,1,1,0
0,1,1,1,13,1,12,3,1,1,0,1,12,1,11,3,1,1,0,1,11,1,10,2
0,0,1,4,8,0,8,7,0,1,0,4,8,0,8,7,0,1,0,4,8,0,8,7
1,2,0,4,3,0,3,2,2,0,1,4,3,0,3,2,2,0,1,4,3,0,3,2
2,4,2,4,4,2,2,1,4,2,2,4,2,0,2,1,4,2,2,4,2,0,2,1
3,4,3,0,8,5,3,0,4,3,3,0,3,2,1,0,4,3,3,0,1,0,1,0
3,2,2,2,17,11,6,3,2,2,3,2,6,4,2,1,2,2,3,2,2,1,1,0
3,1,3,0,26,18,8,0,1,3,3,0,8,5,3,0,1,3,3,0,3,2,1,0
4,3,4,0,23,20,3,0,3,4,4,0,3,2,1,0,3,4,4,0,1,0,1,0
0,1,2,4,18,1,17,15,1,2,0,4,17,1,16,14,1,2,0,4,16,1,15,13
3,2,2,0,12,8,4,0,2,2,3,0,4,2,2,0,2,2,3,0,2,1,1,0
4,4,2,4,8,7,1,0,4,2,4,4,1,0,1,0,4,2,4,4,1,0,1,0
3,0,0,3,7,4,3,2,0,0,3,3,3,2,1,0,0,0,3,3,1,0,1,0
3,2,3,1,24,16,8,2,2,3,3,1,8,5,3,0,2,3,3,1,3,2,1,0
0,3,3,2,15,1,14,7,3,3,0,2,14,1,13,6,3,3,0,2,13,1,12,5
4,3,2,0,10,8,2,0,3,2,4,0,2,1,1,0,3,2,4,0,1,0,1,0
4,4,3,1,9,8,1,0,4,3,4,1,1,0,1,0,4,3,4,1,1,0,1,0
0,0,2,3,20,2,18,12,0,2,0,3,18,1,17,11,0,2,0,3,17,1,16,11
4,0,2,4,15,13,2,1,0,2,4,4,2,1,1,0,0,2,4,4,1,0,1,0
4,2,4,3,10,8,2,1,2,4,4,3,2,1,1,0,2,4,4,3,1,0,1,0
3,4,3,0,4,2,2,0,4,3,3,0,2,1,1,0,4,3,3,0,1,0,1,0
2,1,2,0,11,5,6,0,1,2,2,0,6,3,3,0,1,2,2,0,3,1,2,0
1,1,3,3,22,6,16,11,1,3,1,3,16,4,12,8,1,3,1,3,12,3,9,6
1,0,0,4,12,3,9,8,0,0,1,4,9,2,7,6,0,0,1,4,7,2,5,4
2,4,0,0,9,4,5,0,4,0,2,0,5,2,3,0,4,0,2,0,3,1,2,0
0,3,3,2,13,1,12,5,3,3,0,2,12,1,11,5,3,3,0,2,11,1,10,5
2,3,4,3,24,11,13,9,3,4,2,3,13,6,7,4,3,4,2,3,7,3,4,2
1,0,0,3,7,2,5,3,0,0,1,3,5,1,4,2,0,0,1,3,4,1,3,2
4,1,1,3,17,15,2,1,1,1,4,3,2,1,1,0,1,1,4,3,1,0,1,0
1,4,4,1,11,3,8,2,4,4,1,1,8,2,6,1,4,4,1,1,6,1,5,1
2,4,3,3,4,2,2,1,4,3,2,3,2,1,1,0,4,3,2,3,1,0,1,0
0,3,1,2,8,0,8,4,3,1,0,2,8,0,8,4,3,1,0,2,8,0,8,4
3,1,2,3,11,7,4,2,1,2,3,3,4,2,2,1,1,2,3,3,2,1,1,0
3,3,4,4,8,5,3,2,3,4,3,4,3,2,1,0,3,4,3,4,1,0,1,0
4,4,1,0,2,1,1,0,4,1,4,0,1,0,1,0,4,1,4,0,1,0,1,0
4,4,1,3,6,5,1,0,4,1,4,3,1,0,1,0,4,1,4,3,1,0,1,0
1,2,0,0,1,0,1,0,2,0,1,0,1,0,1,0,2,0,1,0,1,0,1,0
0,1,0,3,5,0,5,3,1,0,0,3,5,0,5,3,1,0,0,3,5,0,5,3
3,4,2,3,5,3,2,1,4,2,3,3,2,1,1,0,4,2,3,3,1,0,1,0
0,4,3,3,0,0,0,0,4,3,0,3,0,0,0,0,4,3,0,3,0,0,0,0
2,0,3,3,27,13,14,9,0,3,2,3,14,7,7,4,0,3,2,3,7,3,4,2
4,1,2,0,23,20,3,0,1,2,4,0,3,2,1,0,1,2,4,0,1,0,1,0
2,1,1,2,13,6,7,3,1,1,2,2,7,3,4,1,1,1,2,2,4,2,2,0
1,1,3,3,20,5,15,10,1,3,1,3,15,4,11,7,1,3,1,3,11,3,8,5
2,3,2,0,4,2,2,0,3,2,2,0,2,1,1,0,3,2,2,0,1,0,1,0
3,4,2,2,6,4,2,1,4,2,3,2,2,1,1,0,4,2,3,2,1,0,1,0
2,1,4,1,29,14,15,4,1,4,2,1,15,7,8,2,1,4,2,1,8,3,5,1
2,1,2,2,12,6,6,2,1,2,2,2,6,2,4,1,1,2,2,2,4,2,2,1
0,2,0,0,10,0,10,1,2,0,0,0,10,0,10,0,2,0,0,0,10,1,9,0
3,3,0,3,3,2,1,0,3,0,3,3,1,0,1,0,3,0,3,3,1,0,1,0
3,4,2,4,7,4,3,2,4,2,3,4,3,2,1,0,4,2,3,4,1,0,1,0
3,0,1,2,15,10,5,2,0,1,3,2,5,3,2,0,0,1,3,2,2,1,1,0
2,4,0,1,3,1,2,0,4,0,2,1,2,0,2,0,4,0,2,1,2,1,1,0
4,3,2,4,13,11,2,1,3,2,4,4,2,1,1,0,3,2,4,4,1,0,1,0
2,2,2,4,16,8,8,7,2,2,2,4,8,4,4,3,2,2,2,4,4,2,2,1
3,3,2,3,14,9,5,3,3,2,3,3,5,3,2,1,3,2,3,3,2,1,1,0
3,3,4,3,13,9,4,2,3,4,3,3,4,2,2,1,3,4,3,3,2,1,1,0
4,4,0,3,4,3,1,0,4,0,4,3,1,0,1,0,4,0,4,3,1,0,1,0
4,3,4,1,22,19,3,0,3,4,4,1,3,2,1,0,3,4,4,1,1,0,1,0
2,4,0,1,1,0,1,0,4,0,2,1,1,0,1,0,4,0,2,1,1,0,1,0
3,0,1,3,10,6,4,2,0,1,3,3,4,2,2,1,0,1,3,3,2,1,1,0
4,0,1,0,14,12,2,0,0,1,4,0,2,1,1,0,0,1,4,0,1,0,1,0
0,1,2,2,17,1,16,8,1,2,0,2,16,1,15,7,1,2,0,2,15,1,14,7
2,2,4,1,18,9,9,2,2,4,2,1,9,4,5,1,2,4,2,1,5,2,3,0
2,1,1,0,13,6,7,0,1,1,2,0,7,3,4,0,1,1,2,0,4,2,2,0
3,1,3,1,21,14,7,2,1,3,3,1,7,4,3,0,1,3,3,1,3,2,1,0
2,0,2,0,19,9,10,0,0,2,2,0,10,4,6,0,0,2,2,0,6,3,3,0
4,3,1,1,5,4,1,0,3,1,4,1,1,0,1,0,3,1,4,1,1,0,1,0
1,0,3,4,29,8,21,18,0,3,1,4,21,6,15,13,0,3,1,4,15,4,11,9
2,0,2,3,26,13,13,9,0,2,2,3,13,6,7,4,0,2,2,3,7,3,4,2
4,1,4,3,14,12,2,1,1,4,4,3,2,1,1,0,1,4,4,3,1,0,1,0
4,0,2,3,19,17,2,1,0,2,4,3,2,1,1,0,0,2,4,3,1,0,1,0
1,0,3,0,27,8,19,1,0,3,1,0,19,5,14,1,0,3,1,0,14,4,10,1
1,4,0,2,8,2,6,2,4,0,1,2,6,1,5,2,4,0,1,2,5,1,4,1
0,4,2,0,6,0,6,0,4,2,0,0,6,0,6,0,4,2,0,0,6,0,6,0
0,1,4,2,23,2,21,10,1,4,0,2,21,2,19,9,1,4,0,2,19,1,18,9
2,1,0,4,2,0,2,1,1,0,2,4,2,1,1,0,1,0,2,4,1,0,1,0
3,3,3,0,15,10,5,0,3,3,3,0,5,3,2,0,3,3,3,0,2,1,1,0
1,0,3,4,23,6,17,15,0,3,1,4,17,5,12,10,0,3,1,4,12,3,9,8
1,1,4,0,28,8,20,1,1,4,1,0,20,5,15,1,1,4,1,0,15,4,11,1
1,0,1,1,18,5,13,3,0,1,1,1,13,3,10,2,0,1,1,1,10,2,8,2
1,4,3,1,12,3,9,2,4,3,1,1,9,2,7,2,4,3,1,1,7,2,5,1
1,2,3,4,20,5,15,13,2,3,1,4,15,4,11,9,2,3,1,4,11,3,8,7
1,2,2,3,7,2,5,3,2,2,1,3,5,1,4,2,2,2,1,3,4,1,3,2
3,4,1,4,6,4,2,1,4,1,3,4,2,1,1,0,4,1,3,4,1,0,1,0
4,2,0,0,8,7,1,0,2,0,4,0,1,0,1,0,2,0,4,0,1,0,1,0
2,2,2,3,14,6,8,5,2,2,2,3,8,4,4,2,2,2,2,3,4,2,2,1
3,4,0,2,12,8,4,2,4,0,3,2,4,2,2,0,4,0,3,2,2,1,1,0
1,3,4,1,9,2,7,2,3,4,1,1,7,2,5,1,3,4,1,1,5,1,4,1
1,2,2,3,8,2,6,4,2,2,1,3,6,1,5,3,2,2,1,3,5,1,4,2
1,4,4,4,1,0,1,0,4,4,1,4,1,0,1,0,4,4,1,4,1,0,1,0
3,1,4,4,18,12,6,5,1,4,3,4,6,4,2,1,1,4,3,4,2,1,1,0
0,0,1,3,16,1,15,10,0,1,0,3,15,1,14,9,0,1,0,3,14,1,13,9
4,4,0,2,5,4,1,0,4,0,4,2,1,0,1,0,4,0,4,2,1,0,1,0
4,4,1,3,3,2,1,0,4,1,4,3,1,0,1,0,4,1,4,3,1,0,1,0
0,0,3,0,28,2,26,2,0,3,0,0,26,2,24,2,0,3,0,0,24,2,22,2
0,1,3,3,26,2,24,16,1,3,0,3,24,2,22,15,1,3,0,3,22,2,20,13
4,0,1,0,11,9,2,0,0,1,4,0,2,1,1,0,0,1,4,0,1,0,1,0
0,3,4,1,24,2,22,6,3,4,0,1,22,2,20,5,3,4,0,1,20,2,18,5
2,2,1,3,6,2,4,2,2,1,2,3,4,1,3,2,2,1,2,3,3,1,2,1
2,2,3,3,13,6,7,4,2,3,2,3,7,3,4,2,2,3,2,3,4,2,2,1
2,0,0,4,5,2,3,2,0,0,2,4,3,1,2,1,0,0,2,4,2,1,1,0
0,1,1,1,5,0,5,1,1,1,0,1,5,0,5,1,1,1,0,1,5,0,5,1
1,4,4,3,13,3,10,6,4,4,1,3,10,2,8,5,4,4,1,3,8,2,6,4
3,4,3,1,9,6,3,0,4,3,3,1,3,2,1,0,4,3,3,1,1,0,1,0
1,4,1,1,3,0,3,0,4,1,1,1,3,0,3,0,4,1,1,1,3,0,3,0
1,1,0,0,4,1,3,0,1,0,1,0,3,0,3,0,1,0,1,0,3,0,3,0
4,2,3,1,18,16,2,0,2,3,4,1,2,1,1,0,2,3,4,1,1,0,1,0
4,2,2,0,12,10,2,0,2,2,4,0,2,1,1,0,2,2,4,0,1,0,1,0
4,2,0,3,11,9,2,1,2,0,4,3,2,1,1,0,2,0,4,3,1,0,1,0
4,2,2,2,10,8,2,0,2,2,4,2,2,1,1,0,2,2,4,2,1,0,1,0
4,3,3,0,9,8,1,0,3,3,4,0,1,0,1,0,3,3,4,0,1,0,1,0
0,0,2,0,20,2,18,1,0,2,0,0,18,1,17,1,0,2,0,0,17,1,16,1
0,2,1,4,10,0,10,8,2,1,0,4,10,1,9,8,2,1,0,4,9,0,9,8
4,4,3,3,9,8,1,0,4,3,4,3,1,0,1,0,4,3,4,3,1,0,1,0
1,0,0,4,1,0,1,0,0,0,1,4,1,0,1,0,0,0,1,4,1,0,1,0
4,1,2,3,15,13,2,1,1,2,4,3,2,1,1,0,1,2,4,3,1,0,1,0
3,4,1,2,9,6,3,1,4,1,3,2,3,2,1,0,4,1,3,2,1,0,1,0
0,0,1,2,17,1,16,7,0,1,0,2,16,1,15,7,0,1,0,2,15,1,14,7
2,1,1,3,9,4,5,3,1,1,2,3,5,2,3,2,1,1,2,3,3,1,2,1
2,3,2,2,5,2,3,1,3,2,2,2,3,1,2,1,3,2,2,2,2,1,1,0
0,1,3,4,26,2,24,21,1,3,0,4,24,2,22,19,1,3,0,4,22,2,20,18
1,4,3,1,2,0,2,0,4,3,1,1,2,0,2,0,4,3,1,1,2,0,2,0
0,3,0,1,5,0,5,1,3,0,0,1,5,0,5,1,3,0,0,1,5,0,5,1
2,2,0,0,5,2,3,0,2,0,2,0,3,1,2,0,2,0,2,0,2,1,1,0
3,1,0,0,6,4,2,0,1,0,3,0,2,1,1,0,1,0,3,0,1,0,1,0
1,3,3,0,6,1,5,0,3,3,1,0,5,1,4,0,3,3,1,0,4,1,3,0
4,4,3,2,1,0,1,0,4,3,4,2,1,0,1,0,4,3,4,2,1,0,1,0
4,3,1,1,17,15,2,0,3,1,4,1,2,1,1,0,3,1,4,1,1,0,1,0
4,1,4,4,29,26,3,2,1,4,4,4,3,2,1,0,1,4,4,4,1,0,1,0
4,4,1,4,0,0,0,0,4,1,4,4,0,0,0,0,4,1,4,4,0,0,0,0
4,2,1,2,7,6,1,0,2,1,4,2,1,0,1,0,2,1,4,2,1,0,1,0
2,3,3,1,18,9,9,2,3,3,2,1,9,4,5,1,3,3,2,1,5,2,3,0
3,4,1,1,8,5,3,0,4,1,3,1,3,2,1,0,4,1,3,1,1,0,1,0
3,3,3,1,9,6,3,0,3,3,3,1,3,2,1,0,3,3,3,1,1,0,1,0
4,1,3,0,28,25,3,0,1,3,4,0,3,2,1,0,1,3,4,0,1,0,1,0
3,3,1,1,6,4,2,0,3,1,3,1,2,1,1,0,3,1,3,1,1,0,1,0
2,1,0,0,6,3,3,0,1,0,2,0,3,1,2,0,1,0,2,0,2,1,1,0
2,1,3,0,27,13,14,1,1,3,2,0,14,7,7,0,1,3,2,0,7,3,4,0
2,4,0,3,3,1,2,1,4,0,2,3,2,0,2,1,4,0,2,3,2,0,2,1
1,0,0,1,17,5,12,3,0,0,1,1,12,3,9,2,0,0,1,1,9,2,7,2
4,1,2,0,9,8,1,0,1,2,4,0,1,0,1,0,1,2,4,0,1,0,1,0
1,0,0,4,7,2,5,4,0,0,1,4,5,1,4,3,0,0,1,4,4,1,3,2
3,4,2,0,10,6,4,0,4,2,3,0,4,2,2,0,4,2,3,0,2,1,1,0
1,0,1,2,15,4,11,5,0,1,1,2,11,3,8,4,0,1,1,2,8,2,6,3
0,3,1,2,13,1,12,6,3,1,0,2,12,1,11,5,3,1,0,2,11,1,10,4
2,0,1,0,16,8,8,0,0,1,2,0,8,3,5,0,0,1,2,0,5,2,3,0
2,2,3,1,18,8,10,3,2,3,2,1,10,5,5,1,2,3,2,1,5,2,3,0
0,0,4,1,28,2,26,7,0,4,0,1,26,2,24,7,0,4,0,1,24,2,22,6
1,0,1,4,27,8,19,17,0,1,1,4,19,5,14,12,0,1,1,4,14,4,10,9
3,3,3,4,13,9,4,3,3,3,3,4,4,2,2,1,3,3,3,4,2,1,1,0
0,2,3,3,17,1,16,11,2,3,0,3,16,1,15,10,2,3,0,3,15,1,14,9
1,4,1,3,2,0,2,1,4,1,1,3,2,0,2,1,4,1,1,3,2,0,2,1
0,0,2,3,23,2,21,14,0,2,0,3,21,2,19,13,0,2,0,3,19,1,18,12
2,0,2,0,23,11,12,1,0,2,2,0,12,6,6,0,0,2,2,0,6,3,3,0
1,4,0,3,7,2,5,3,4,0,1,3,5,1,4,2,4,0,1,3,4,1,3,2
0,3,0,4,2,0,2,1,3,0,0,4,2,0,2,1,3,0,0,4,2,0,2,1
3,3,1,4,4,2,2,1,3,1,3,4,2,1,1,0,3,1,3,4,1,0,1,0
1,0,3,2,22,6,16,8,0,3,1,2,16,4,12,6,0,3,1,2,12,3,9,4
3,3,3,1,14,9,5,1,3,3,3,1,5,3,2,0,3,3,3,1,2,1,1,0
3,0,0,2,12,8,4,2,0,0,3,2,4,2,2,0,0,0,3,2,2,1,1,0
2,3,0,0,13,6,7,0,3,0,2,0,7,3,4,0,3,0,2,0,4,1,3,0
4,0,0,3,7,6,1,0,0,0,4,3,1,0,1,0,0,0,4,3,1,0,1,0
1,4,1,0,3,0,3,0,4,1,1,0,3,0,3,0,4,1,1,0,3,0,3,0
3,0,1,4,18,12,6,5,0,1,3,4,6,4,2,1,0,1,3,4,2,1,1,0
3,3,3,3,4,2,2,1,3,3,3,3,2,1,1,0,3,3,3,3,1,0,1,0
4,4,4,1,9,8,1,0,4,4,4,1,1,0,1,0,4,4,4,1,1,0,1,0
1,2,0,3,8,2,6,4,2,0,1,3,6,1,5,3,2,0,1,3,5,1,4,2
3,2,3,1,22,15,7,2,2,3,3,1,7,4,3,0,2,3,3,1,3,2,1,0
2,1,2,0,13,6,7,0,1,2,2,0,7,3,4,0,1,2,2,0,4,2,2,0
1,4,4,4,17,5,12,10,4,4,1,4,12,3,9,8,4,4,1,4,9,2,7,6
1,3,3,0,7,2,5,0,3,3,1,0,5,1,4,0,3,3,1,0,4,1,3,0
4,0,4,0,29,26,3,0,0,4,4,0,3,2,1,0,0,4,4,0,1,0,1,0
4,0,3,4,24,21,3,2,0,3,4,4,3,2,1,0,0,3,4,4,1,0,1,0
3,0,2,4,14,9,5,4,0,2,3,4,5,3,2,1,0,2,3,4,2,1,1,0
3,4,4,4,9,6,3,2,4,4,3,4,3,2,1,0,4,4,3,4,1,0,1,0
3,1,2,1,9,6,3,0,1,2,3,1,3,2,1,0,1,2,3,1,1,0,1,0
2,0,0,0,12,5,7,0,0,0,2,0,7,3,4,0,0,0,2,0,4,2,2,0
0,2,0,2,6,0,6,3,2,0,0,2,6,0,6,2,2,0,0,2,6,0,6,3
2,1,1,3,12,6,6,4,1,1,2,3,6,3,3,2,1,1,2,3,3,1,2,1
0,4,1,0,1,0,1,0,4,1,0,0,1,0,1,0,4,1,0,0,1,0,1,0
3,2,3,1,17,11,6,1,2,3,3,1,6,4,2,0,2,3,3,1,2,1,1,0
4,4,4,1,3,2,1,0,4,4,4,1,1,0,1,0,4,4,4,1,1,0,1,0
4,2,1,2,13,11,2,0,2,1,4,2,2,1,1,0,2,1,4,2,1,0,1,0
2,0,4,1,29,14,15,4,0,4,2,1,15,7,8,2,0,4,2,1,8,4,4,1
1,3,0,3,0,0,0,0,3,0,1,3,0,0,0,0,3,0,1,3,0,0,0,0
2,0,4,3,29,14,15,10,0,4,2,3,15,7,8,5,0,4,2,3,8,4,4,2
3,4,2,1,5,3,2,0,4,2,3,1,2,1,1,0,4,2,3,1,1,0,1,0
1,0,0,4,8,2,6,5,0,0,1,4,6,1,5,4,0,0,1,4,5,1,4,3
2,1,2,4,15,7,8,7,1,2,2,4,8,3,5,4,1,2,2,4,5,2,3,2
3,3,4,2,18,12,6,2,3,4,3,2,6,4,2,1,3,4,3,2,2,1,1,0
0,4,4,2,0,0,0,0,4,4,0,2,0,0,0,0,4,4,0,2,0,0,0,0
4,4,1,4,8,7,1,0,4,1,4,4,1,0,1,0,4,1,4,4,1,0,1,0
4,1,3,0,29,26,3,0,1,3,4,0,3,2,1,0,1,3,4,0,1,0,1,0
2,4,1,1,4,1,3,0,4,1,2,1,3,1,2,0,4,1,2,1,2,0,2,0
4,2,4,0,20,18,2,0,2,4,4,0,2,1,1,0,2,4,4,0,1,0,1,0
3,2,0,2,16,11,5,2,2,0,3,2,5,3,2,0,2,0,3,2,2,1,1,0
1,0,3,0,28,8,20,2,0,3,1,0,20,5,15,1,0,3,1,0,15,4,11,1
2,3,0,0,1,0,1,0,3,0,2,0,1,0,1,0,3,0,2,0,1,0,1,0
4,2,2,3,13,11,2,1,2,2,4,3,2,1,1,0,2,2,4,3,1,0,1,0
3,1,0,0,1,0,1,0,1,0,3,0,1,0,1,0,1,0,3,0,1,0,1,0
0,1,2,1,17,1,16,4,1,2,0,1,16,1,15,4,1,2,0,1,15,1,14,4
2,4,2,2,4,1,3,1,4,2,2,2,3,1,2,0,4,2,2,2,2,1,1,0
0,3,3,4,23,2,21,18,3,3,0,4,21,2,19,17,3,3,0,4,19,1,18,16
0,4,4,1,9,0,9,2,4,4,0,1,9,0,9,2,4,4,0,1,9,0,9,2
2,4,4,0,13,6,7,0,4,4,2,0,7,3,4,0,4,4,2,0,4,2,2,0
3,2,0,0,0,0,0,0,2,0,3,0,0,0,0,0,2,0,3,0,0,0,0,0
4,1,4,2,24,21,3,1,1,4,4,2,3,2,1,0,1,4,4,2,1,0,1,0
3,0,0,4,12,8,4,3,0,0,3,4,4,2,2,1,0,0,3,4,2,1,1,0
0,0,3,1,26,2,24,7,0,3,0,1,24,2,22,6,0,3,0,1,22,2,20,6
3,2,0,4,1,0,1,0,2,0,3,4,1,0,1,0,2,0,3,4,1,0,1,0
2,0,0,1,8,3,5,1,0,0,2,1,5,2,3,0,0,0,2,1,3,1,2,0
1,2,2,4,14,4,10,8,2,2,1,4,10,3,7,6,2,2,1,4,7,2,5,4
1,4,0,4,8,2,6,5,4,0,1,4,6,1,5,4,4,0,1,4,5,1,4,3
4,4,3,3,6,5,1,0,4,3,4,3,1,0,1,0,4,3,4,3,1,0,1,0
3,0,2,4,25,17,8,7,0,2,3,4,8,5,3,2,0,2,3,4,3,2,1,0
4,1,0,3,6,5,1,0,1,0,4,3,1,0,1,0,1,0,4,3,1,0,1,0
1,4,4,1,4,1,3,0,4,4,1,1,3,0,3,0,4,4,1,1,3,0,3,0
1,0,3,1,28,8,20,5,0,3,1,1,20,5,15,4,0,3,1,1,15,4,11,3
0,3,1,3,7,0,7,4,3,1,0,3,7,0,7,4,3,1,0,3,7,0,7,4
4,4,1,2,9,8,1,0,4,1,4,2,1,0,1,0,4,1,4,2,1,0,1,0
1,3,1,3,3,0,3,2,3,1,1,3,3,0,3,2,3,1,1,3,3,0,3,2
0,0,1,4,17,1,16,14,0,1,0,4,16,1,15,13,0,1,0,4,15,1,14,12
0,3,4,4,13,1,12,10,3,4,0,4,12,1,11,9,3,4,0,4,11,1,10,9
1,0,4,4,29,8,21,18,0,4,1,4,21,6,15,13,0,4,1,4,15,4,11,9
1,1,1,2,12,3,9,4,1,1,1,2,9,2,7,3,1,1,1,2,7,2,5,2
4,3,0,0,8,7,1,0,3,0,4,0,1,0,1,0,3,0,4,0,1,0,1,0
0,4,1,2,4,0,4,1,4,1,0,2,4,0,4,2,4,1,0,2,4,0,4,1
2,2,0,4,9,4,5,4,2,0,2,4,5,2,3,2,2,0,2,4,3,1,2,1
1,2,2,3,17,5,12,8,2,2,1,3,12,3,9,6,2,2,1,3,9,2,7,4
3,1,4,3,20,13,7,4,1,4,3,3,7,4,3,2,1,4,3,3,3,2,1,0
2,4,2,4,1,0,1,0,4,2,2,4,1,0,1,0,4,2,2,4,1,0,1,0
3,0,3,2,20,13,7,3,0,3,3,2,7,4,3,1,0,3,3,2,3,2,1,0
4,3,2,1,10,8,2,0,3,2,4,1,2,1,1,0,3,2,4,1,1,0,1,0
3,4,4,1,12,8,4,1,4,4,3,1,4,2,2,0,4,4,3,1,2,1,1,0
3,1,4,1,28,19,9,2,1,4,3,1,9,6,3,0,1,4,3,1,3,2,1,0
1,1,0,3,11,3,8,5,1,0,1,3,8,2,6,4,1,0,1,3,6,1,5,3
4,1,1,4,5,4,1,0,1,1,4,4,1,0,1,0,1,1,4,4,1,0,1,0
1,0,1,0,16,4,12,1,0,1,1,0,12,3,9,0,0,1,1,0,9,2,7,0
0,0,3,3,24,2,22,15,0,3,0,3,22,2,20,13,0,3,0,3,20,2,18,12
4,0,4,0,25,22,3,0,0,4,4,0,3,2,1,0,0,4,4,0,1,0,1,0
3,4,1,4,6,4,2,1,4,1,3,4,2,1,1,0,4,1,3,4,1,0,1,0
3,3,1,2,8,5,3,1,3,1,3,2,3,2,1,0,3,1,3,2,1,0,1,0
3,0,1,3,13,9,4,2,0,1,3,3,4,2,2,1,0,1,3,3,2,1,1,0
2,1,1,4,14,6,8,7,1,1,2,4,8,3,5,4,1,1,2,4,5,2,3,2
4,2,0,3,6,5,1,0,2,0,4,3,1,0,1,0,2,0,4,3,1,0,1,0
2,4,1,4,0,0,0,0,4,1,2,4,0,0,0,0,4,1,2,4,0,0,0,0
0,3,2,0,8,0,8,0,3,2,0,0,8,0,8,0,3,2,0,0,8,0,8,0
2,2,4,1,18,8,10,3,2,4,2,1,10,4,6,1,2,4,2,1,6,3,3,0
1,4,1,3,7,2,5,3,4,1,1,3,5,1,4,2,4,1,1,3,4,1,3,2
0,1,1,0,18,1,17,1,1,1,0,0,17,1,16,1,1,1,0,0,16,1,15,1
2,0,3,2,23,11,12,6,0,3,2,2,12,6,6,2,0,3,2,2,6,3,3,1
3,1,3,3,29,20,9,6,1,3,3,3,9,6,3,2,1,3,3,3,3,2,1,0
4,4,3,1,4,3,1,0,4,3,4,1,1,0,1,0,4,3,4,1,1,0,1,0
1,4,0,1,3,0,3,0,4,0,1,1,3,0,3,0,4,0,1,1,3,0,3,0
3,3,0,1,6,4,2,0,3,0,3,1,2,1,1,0,3,0,3,1,1,0,1,0
1,2,0,3,4,1,3,2,2,0,1,3,3,0,3,2,2,0,1,3,3,0,3,2
0,1,4,0,29,2,27,2,1,4,0,0,27,2,25,2,1,4,0,0,25,2,23,2
0,2,1,1,14,1,13,3,2,1,0,1,13,1,12,3,2,1,0,1,12,1,11,3
3,1,2,3,16,11,5,3,1,2,3,3,5,3,2,1,1,2,3,3,2,1,1,0
3,4,4,1,3,2,1,0,4,4,3,1,1,0,1,0,4,4,3,1,1,0,1,0
1,2,2,2,19,5,14,6,2,2,1,2,14,4,10,4,2,2,1,2,10,2,8,4
1,2,3,4,14,4,10,8,2,3,1,4,10,3,7,6,2,3,1,4,7,2,5,4
4,2,0,3,0,0,0,0,2,0,4,3,0,0,0,0,2,0,4,3,0,0,0,0
2,0,4,0,29,14,15,1,0,4,2,0,15,7,8,0,0,4,2,0,8,3,5,0
0,4,4,0,13,1,12,1,4,4,0,0,12,1,11,1,4,4,0,0,11,1,10,0
0,2,4,2,22,2,20,9,2,4,0,2,20,2,18,8,2,4,0,2,18,1,17,8
2,1,4,3,24,11,13,9,1,4,2,3,13,6,7,4,1,4,2,3,7,3,4,2
2,1,3,3,25,12,13,9,1,3,2,3,13,6,7,4,1,3,2,3,7,3,4,2
2,0,4,4,28,14,14,12,0,4,2,4,14,6,8,7,0,4,2,4,8,4,4,3
2,0,1,3,8,4,4,2,0,1,2,3,4,2,2,1,0,1,2,3,2,1,1,0
0,0,3,3,29,2,27,18,0,3,0,3,27,2,25,17,0,3,0,3,25,2,23,16
2,2,0,1,1,0,1,0,2,0,2,1,1,0,1,0,2,0,2,1,1,0,1,0
2,1,4,2,26,12,14,6,1,4,2,2,14,6,8,4,1,4,2,2,8,3,5,2
3,2,0,4,1,0,1,0,2,0,3,4,1,0,1,0,2,0,3,4,1,0,1,0
3,4,3,1,8,5,3,0,4,3,3,1,3,2,1,0,4,3,3,1,1,0,1,0
2,0,3,2,29,14,15,7,0,3,2,2,15,7,8,3,0,3,2,2,8,3,5,2
0,4,1,2,7,0,7,3,4,1,0,2,7,0,7,3,4,1,0,2,7,0,7,3
1,4,3,1,7,2,5,1,4,3,1,1,5,1,4,1,4,3,1,1,4,1,3,0
3,3,1,0,5,3,2,0,3,1,3,0,2,1,1,0,3,1,3,0,1,0,1,0
0,0,4,2,29,2,27,13,0,4,0,2,27,2,25,12,0,4,0,2,25,2,23,11
0,2,4,1,21,2,19,5,2,4,0,1,19,1,18,5,2,4,0,1,18,1,17,5
0,1,3,3,28,2,26,18,1,3,0,3,26,2,24,16,1,3,0,3,24,2,22,15
2,3,3,1,14,6,8,2,3,3,2,1,8,3,5,1,3,3,2,1,5,2,3,0
2,0,0,0,8,4,4,0,0,0,2,0,4,2,2,0,0,0,2,0,2,0,2,0
1,1,1,0,15,4,11,1,1,1,1,0,11,3,8,0,1,1,1,0,8,2,6,0
3,2,3,2,18,12,6,3,2,3,3,2,6,4,2,1,2,3,3,2,2,1,1,0
4,0,3,0,27,24,3,0,0,3,4,0,3,2,1,0,0,3,4,0,1,0,1,0
1,0,0,3,13,3,10,6,0,0,1,3,10,2,8,5,0,0,1,3,8,2,6,4
0,2,4,0,11,1,10,0,2,4,0,0,10,0,10,1,2,4,0,0,10,0,10,1
1,3,2,4,8,2,6,5,3,2,1,4,6,1,5,4,3,2,1,4,5,1,4,3
0,3,3,4,11,1,10,9,3,3,0,4,10,0,10,9,3,3,0,4,10,0,10,9
4,4,0,0,4,3,1,0,4,0,4,0,1,0,1,0,4,0,4,0,1,0,1,0
2,2,0,0,3,1,2,0,2,0,2,0,2,0,2,0,2,0,2,0,2,0,2,0
4,2,1,0,21,18,3,0,2,1,4,0,3,2,1,0,2,1,4,0,1,0,1,0
0,2,4,3,27,2,25,17,2,4,0,3,25,2,23,16,2,4,0,3,23,2,21,14
2,4,2,2,5,2,3,1,4,2,2,2,3,1,2,1,4,2,2,2,2,1,1,0
3,2,0,4,9,6,3,2,2,0,3,4,3,2,1,0,2,0,3,4,1,0,1,0
1,3,2,2,14,4,10,4,3,2,1,2,10,3,7,3,3,2,1,2,7,2,5,2
0,0,3,2,25,2,23,11,0,3,0,2,23,2,21,10,0,3,0,2,21,2,19,9
4,3,2,4,16,14,2,1,3,2,4,4,2,1,1,0,3,2,4,4,1,0,1,0
2,0,0,1,4,2,2,0,0,0,2,1,2,0,2,0,0,0,2,1,2,1,1,0
4,2,0,3,15,13,2,1,2,0,4,3,2,1,1,0,2,0,4,3,1,0,1,0
2,3,0,1,8,3,5,1,3,0,2,1,5,2,3,0,3,0,2,1,3,1,2,0
1,2,3,0,22,6,16,1,2,3,1,0,16,4,12,1,2,3,1,0,12,3,9,0
4,2,4,1,17,15,2,0,2,4,4,1,2,1,1,0,2,4,4,1,1,0,1,0
4,2,3,1,21,18,3,0,2,3,4,1,3,2,1,0,2,3,4,1,1,0,1,0
3,4,2,3,9,6,3,2,4,2,3,3,3,2,1,0,4,2,3,3,1,0,1,0
2,2,0,3,9,4,5,3,2,0,2,3,5,2,3,2,2,0,2,3,3,1,2,1
4,2,1,0,9,8,1,0,2,1,4,0,1,0,1,0,2,1,4,0,1,0,1,0
1,4,0,0,2,0,2,0,4,0,1,0,2,0,2,0,4,0,1,0,2,0,2,0
2,3,0,4,0,0,0,0,3,0,2,4,0,0,0,0,3,0,2,4,0,0,0,0
4,1,4,3,24,21,3,2,1,4,4,3,3,2,1,0,1,4,4,3,1,0,1,0
4,4,4,4,5,4,1,0,4,4,4,4,1,0,1,0,4,4,4,4,1,0,1,0
0,0,4,1,28,2,26,7,0,4,0,1,26,2,24,7,0,4,0,1,24,2,22,6
4,2,4,4,22,19,3,2,2,4,4,4,3,2,1,0,2,4,4,4,1,0,1,0
1,1,2,4,18,5,13,11,1,2,1,4,13,3,10,9,1,2,1,4,10,2,8,7
3,2,3,3,29,20,9,6,2,3,3,3,9,6,3,2,2,3,3,3,3,2,1,0
3,0,4,0,28,19,9,0,0,4,3,0,9,6,3,0,0,4,3,0,3,2,1,0
1,3,1,3,13,3,10,7,3,1,1,3,10,3,7,4,3,1,1,3,7,2,5,3
2,3,4,4,15,7,8,7,3,4,2,4,8,3,5,4,3,4,2,4,5,2,3,2
1,3,2,4,4,1,3,2,3,2,1,4,3,0,3,2,3,2,1,4,3,0,3,2
3,4,1,1,9,6,3,0,4,1,3,1,3,2,1,0,4,1,3,1,1,0,1,0
4,0,0,1,10,9,1,0,0,0,4,1,1,0,1,0,0,0,4,1,1,0,1,0
2,1,3,0,27,13,14,1,1,3,2,0,14,6,8,0,1,3,2,0,8,4,4,0
3,0,4,3,28,19,9,6,0,4,3,3,9,6,3,2,0,4,3,3,3,2,1,0
0,0,0,4,2,0,2,1,0,0,0,4,2,0,2,1,0,0,0,4,2,0,2,1
4,1,1,4,7,6,1,0,1,1,4,4,1,0,1,0,1,1,4,4,1,0,1,0
3,0,3,4,27,18,9,8,0,3,3,4,9,6,3,2,0,3,3,4,3,2,1,0
4,3,4,2,9,8,1,0,3,4,4,2,1,0,1,0,3,4,4,2,1,0,1,0
4,3,2,0,13,11,2,0,3,2,4,0,2,1,1,0,3,2,4,0,1,0,1,0
4,4,3,1,2,1,1,0,4,3,4,1,1,0,1,0,4,3,4,1,1,0,1,0
1,0,0,3,5,1,4,2,0,0,1,3,4,1,3,2,0,0,1,3,3,0,3,2
4,2,4,3,28,25,3,2,2,4,4,3,3,2,1,0,2,4,4,3,1,0,1,0
3,1,0,1,1,0,1,0,1,0,3,1,1,0,1,0,1,0,3,1,1,0,1,0
3,3,1,2,4,2,2,0,3,1,3,2,2,1,1,0,3,1,3,2,1,0,1,0
0,4,2,0,0,0,0,0,4,2,0,0,0,0,0,0,4,2,0,0,0,0,0,0
3,1,4,1,28,19,9,2,1,4,3,1,9,6,3,0,1,4,3,1,3,2,1,0
1,3,3,2,14,4,10,5,3,3,1,2,10,3,7,3,3,3,1,2,7,2,5,2
2,2,2,2,18,8,10,5,2,2,2,2,10,5,5,2,2,2,2,2,5,2,3,1
4,3,1,4,9,8,1,0,3,1,4,4,1,0,1,0,3,1,4,4,1,0,1,0
4,2,4,1,13,11,2,0,2,4,4,1,2,1,1,0,2,4,4,1,1,0,1,0
3,1,2,0,19,13,6,0,1,2,3,0,6,4,2,0,1,2,3,0,2,1,1,0
0,2,0,1,1,0,1,0,2,0,0,1,1,0,1,0,2,0,0,1,1,0,1,0
1,2,3,2,4,1,3,1,2,3,1,2,3,0,3,1,2,3,1,2,3,0,3,1
2,0,4,3,28,13,15,10,0,4,2,3,15,7,8,5,0,4,2,3,8,4,4,2
1,4,3,0,9,2,7,0,4,3,1,0,7,2,5,0,4,3,1,0,5,1,4,0
0,3,3,2,19,1,18,9,3,3,0,2,18,1,17,8,3,3,0,2,17,1,16,7
0,3,0,1,5,0,5,1,3,0,0,1,5,0,5,1,3,0,0,1,5,0,5,1
3,0,3,4,29,20,9,8,0,3,3,4,9,6,3,2,0,3,3,4,3,2,1,0
4,2,1,0,4,3,1,0,2,1,4,0,1,0,1,0,2,1,4,0,1,0,1,0
4,1,4,3,24,21,3,2,1,4,4,3,3,2,1,0,1,4,4,3,1,0,1,0
1,0,2,1,20,5,15,4,0,2,1,1,15,4,11,3,0,2,1,1,11,3,8,2
1,1,0,0,3,0,3,0,1,0,1,0,3,0,3,0,1,0,1,0,3,0,3,0
0,3,0,3,8,0,8,5,3,0,0,3,8,0,8,5,3,0,0,3,8,0,8,5
3,1,4,2,25,17,8,4,1,4,3,2,8,5,3,1,1,4,3,2,3,2,1,0
4,0,3,2,26,23,3,1,0,3,4,2,3,2,1,0,0,3,4,2,1,0,1,0
0,0,2,3,26,2,24,16,0,2,0,3,24,2,22,15,0,2,0,3,22,2,20,13
1,3,4,3,15,4,11,7,3,4,1,3,11,3,8,5,3,4,1,3,8,2,6,4
2,2,1,1,12,5,7,2,2,1,2,1,7,3,4,1,2,1,2,1,4,2,2,0
0,3,2,1,3,0,3,0,3,2,0,1,3,0,3,0,3,2,0,1,3,0,3,0
2,2,0,0,8,4,4,0,2,0,2,0,4,2,2,0,2,0,2,0,2,1,1,0
4,4,1,3,9,8,1,0,4,1,4,3,1,0,1,0,4,1,4,3,1,0,1,0
3,2,0,0,5,3,2,0,2,0,3,0,2,1,1,0,2,0,3,0,1,0,1,0
4,4,0,0,8,7,1,0,4,0,4,0,1,0,1,0,4,0,4,0,1,0,1,0
1,2,0,0,8,2,6,0,2,0,1,0,6,1,5,0,2,0,1,0,5,1,4,0
1,1,2,0,11,3,8,0,1,2,1,0,8,2,6,0,1,2,1,0,6,1,5,0
4,0,3,3,29,26,3,2,0,3,4,3,3,2,1,0,0,3,4,3,1,0,1,0
1,2,4,3,10,3,7,4,2,4,1,3,7,2,5,3,2,4,1,3,5,1,4,2
1,4,1,4,0,0,0,0,4,1,1,4,0,0,0,0,4,1,1,4,0,0,0,0
0,2,4,3,27,2,25,17,2,4,0,3,25,2,23,16,2,4,0,3,23,2,21,14
1,1,3,3,21,6,15,10,1,3,1,3,15,4,11,7,1,3,1,3,11,3,8,5
0,4,1,3,4,0,4,2,4,1,0,3,4,0,4,2,4,1,0,3,4,0,4,2
4,2,0,4,8,7,1,0,2,0,4,4,1,0,1,0,2,0,4,4,1,0,1,0
4,0,0,4,4,3,1,0,0,0,4,4,1,0,1,0,0,0,4,4,1,0,1,0
0,0,1,0,12,1,11,1,0,1,0,0,11,1,10,0,0,1,0,0,10,0,10,1
4,1,1,3,1,0,1,0,1,1,4,3,1,0,1,0,1,1,4,3,1,0,1,0
1,2,4,3,19,5,14,9,2,4,1,3,14,4,10,6,2,4,1,3,10,2,8,5
2,1,1,4,10,5,5,4,1,1,2,4,5,2,3,2,1,1,2,4,3,1,2,1
3,4,3,2,14,9,5,2,4,3,3,2,5,3,2,0,4,3,3,2,2,1,1,0
2,4,4,4,1,0,1,0,4,4,2,4,1,0,1,0,4,4,2,4,1,0,1,0
4,0,4,3,27,24,3,2,0,4,4,3,3,2,1,0,0,4,4,3,1,0,1,0
0,0,3,1,29,2,27,8,0,3,0,1,27,2,25,7,0,3,0,1,25,2,23,6
4,4,2,4,4,3,1,0,4,2,4,4,1,0,1,0,4,2,4,4,1,0,1,0
3,2,2,3,15,10,5,3,2,2,3,3,5,3,2,1,2,2,3,3,2,1,1,0
2,2,1,4,12,5,7,6,2,1,2,4,7,3,4,3,2,1,2,4,4,2,2,1
2,3,0,1,9,4,5,1,3,0,2,1,5,2,3,0,3,0,2,1,3,1,2,0
2,2,1,2,10,5,5,2,2,1,2,2,5,2,3,1,2,1,2,2,3,1,2,0
2,3,0,2,10,5,5,2,3,0,2,2,5,2,3,1,3,0,2,2,3,1,2,0
4,4,4,0,8,7,1,0,4,4,4,0,1,0,1,0,4,4,4,0,1,0,1,0
1,0,0,2,8,2,6,3,0,0,1,2,6,1,5,2,0,0,1,2,5,1,4,1
1,3,4,2,9,2,7,3,3,4,1,2,7,2,5,2,3,4,1,2,5,1,4,1
4,1,0,0,8,7,1,0,1,0,4,0,1,0,1,0,1,0,4,0,1,0,1,0
1,0,0,1,1,0,1,0,0,0,1,1,1,0,1,0,0,0,1,1,1,0,1,0
1,3,4,4,24,7,17,15,3,4,1,4,17,5,12,10,3,4,1,4,12,3,9,8
1,1,1,1,16,4,12,3,1,1,1,1,12,3,9,2,1,1,1,1,9,2,7,2
4,1,1,1,8,7,1,0,1,1,4,1,1,0,1,0,1,1,4,1,1,0,1,0
0,4,1,1,5,0,5,1,4,1,0,1,5,0,5,1,4,1,0,1,5,0,5,1
2,1,4,1,29,14,15,4,1,4,2,1,15,7,8,2,1,4,2,1,8,4,4,1
2,1,1,0,11,5,6,0,1,1,2,0,6,3,3,0,1,1,2,0,3,1,2,0
0,3,0,1,2,0,2,0,3,0,0,1,2,0,2,0,3,0,0,1,2,0,2,0
1,4,2,0,4,1,3,0,4,2,1,0,3,0,3,0,4,2,1,0,3,0,3,0
2,1,2,1,19,9,10,3,1,2,2,1,10,4,6,1,1,2,2,1,6,2,4,1
1,3,3,1,25,7,18,5,3,3,1,1,18,5,13,3,3,3,1,1,13,3,10,3
2,3,3,3,9,4,5,3,3,3,2,3,5,2,3,2,3,3,2,3,3,1,2,1
0,2,2,2,11,1,10,5,2,2,0,2,10,0,10,5,2,2,0,2,10,0,10,4
3,2,1,4,13,9,4,3,2,1,3,4,4,2,2,1,2,1,3,4,2,1,1,0
1,3,4,2,13,3,10,5,3,4,1,2,10,2,8,4,3,4,1,2,8,2,6,2
3,3,2,3,9,6,3,2,3,2,3,3,3,2,1,0,3,2,3,3,1,0,1,0
0,2,4,3,26,2,24,16,2,4,0,3,24,2,22,15,2,4,0,3,22,2,20,13
4,0,3,0,27,24,3,0,0,3,4,0,3,2,1,0,0,3,4,0,1,0,1,0
2,2,0,1,2,1,1,0,2,0,2,1,1,0,1,0,2,0,2,1,1,0,1,0
3,3,0,3,0,0,0,0,3,0,3,3,0,0,0,0,3,0,3,3,0,0,0,0
1,2,1,4,10,2,8,7,2,1,1,4,8,2,6,5,2,1,1,4,6,1,5,4
0,4,4,2,5,0,5,2,4,4,0,2,5,0,5,2,4,4,0,2,5,0,5,2
1,4,4,4,11,3,8,7,4,4,1,4,8,2,6,5,4,4,1,4,6,1,5,4
4,0,1,2,14,12,2,1,0,1,4,2,2,1,1,0,0,1,4,2,1,0,1,0
0,3,3,3,14,1,13,9,3,3,0,3,13,1,12,8,3,3,0,3,12,1,11,7
2,2,2,0,19,9,10,0,2,2,2,0,10,4,6,0,2,2,2,0,6,3,3,0
2,1,0,1,9,4,5,1,1,0,2,1,5,2,3,0,1,0,2,1,3,1,2,0
4,2,1,0,5,4,1,0,2,1,4,0,1,0,1,0,2,1,4,0,1,0,1,0
4,4,0,2,4,3,1,0,4,0,4,2,1,0,1,0,4,0,4,2,1,0,1,0
0,1,2,2,8,0,8,3,1,2,0,2,8,0,8,4,1,2,0,2,8,0,8,3
0,1,4,1,26,2,24,7,1,4,0,1,24,2,22,6,1,4,0,1,22,2,20,5
3,2,1,4,1,0,1,0,2,1,3,4,1,0,1,0,2,1,3,4,1,0,1,0
0,2,4,4,25,2,23,20,2,4,0,4,23,2,21,18,2,4,0,4,21,2,19,17
1,4,4,3,12,3,9,6,4,4,1,3,9,2,7,4,4,4,1,3,7,2,5,3
3,4,0,1,3,2,1,0,4,0,3,1,1,0,1,0,4,0,3,1,1,0,1,0
2,3,4,2,14,7,7,3,3,4,2,2,7,3,4,1,3,4,2,2,4,2,2,0
4,1,2,3,11,9,2,1,1,2,4,3,2,1,1,0,1,2,4,3,1,0,1,0
1,0,4,3,25,7,18,12,0,4,1,3,18,5,13,9,0,4,1,3,13,3,10,7
1,0,3,3,23,6,17,11,0,3,1,3,17,5,12,8,0,3,1,3,12,3,9,6
2,0,2,2,20,9,11,5,0,2,2,2,11,5,6,3,0,2,2,2,6,3,3,1
3,4,1,3,4,2,2,1,4,1,3,3,2,1,1,0,4,1,3,3,1,0,1,0
3,2,1,2,8,5,3,1,2,1,3,2,3,2,1,0,2,1,3,2,1,0,1,0
3,0,3,1,26,18,8,2,0,3,3,1,8,5,3,0,0,3,3,1,3,2,1,0
3,3,0,2,6,4,2,1,3,0,3,2,2,1,1,0,3,0,3,2,1,0,1,0
3,0,2,3,20,14,6,4,0,2,3,3,6,4,2,1,0,2,3,3,2,1,1,0
2,1,0,1,6,2,4,1,1,0,2,1,4,1,3,0,1,0,2,1,3,1,2,0
2,1,4,3,23,11,12,8,1,4,2,3,12,6,6,4,1,4,2,3,6,2,4,2
4,0,3,2,23,20,3,1,0,3,4,2,3,2,1,0,0,3,4,2,1,0,1,0
0,1,3,0,23,2,21,2,1,3,0,0,21,2,19,1,1,3,0,0,19,1,18,1
3,4,3,4,6,4,2,1,4,3,3,4,2,1,1,0,4,3,3,4,1,0,1,0
3,0,3,1,23,16,7,2,0,3,3,1,7,4,3,0,0,3,3,1,3,2,1,0
2,4,4,2,5,2,3,1,4,4,2,2,3,1,2,1,4,4,2,2,2,0,2,0
2,3,2,4,15,7,8,7,3,2,2,4,8,3,5,4,3,2,2,4,5,2,3,2
3,2,4,3,17,11,6,4,2,4,3,3,6,4,2,1,2,4,3,3,2,1,1,0
0,4,3,3,11,1,10,6,4,3,0,3,10,0,10,7,4,3,0,3,10,0,10,7
2,2,4,1,21,10,11,3,2,4,2,1,11,5,6,1,2,4,2,1,6,2,4,1
3,3,0,3,7,4,3,2,3,0,3,3,3,2,1,0,3,0,3,3,1,0,1,0
3,1,2,3,21,14,7,4,1,2,3,3,7,4,3,2,1,2,3,3,3,2,1,0
0,3,3,4,7,0,7,6,3,3,0,4,7,0,7,6,3,3,0,4,7,0,7,6
2,3,2,1,7,3,4,1,3,2,2,1,4,1,3,0,3,2,2,1,3,1,2,0
3,4,3,0,6,4,2,0,4,3,3,0,2,1,1,0,4,3,3,0,1,0,1,0
3,4,1,4,0,0,0,0,4,1,3,4,0,0,0,0,4,1,3,4,0,0,0,0
2,4,2,4,5,2,3,2,4,2,2,4,3,1,2,1,4,2,2,4,2,0,2,1
4,0,1,4,16,14,2,1,0,1,4,4,2,1,1,0,0,1,4,4,1,0,1,0
1,2,4,2,17,5,12,5,2,4,1,2,12,3,9,4,2,4,1,2,9,2,7,3
2,0,0,2,15,7,8,4,0,0,2,2,8,3,5,2,0,0,2,2,5,2,3,1
1,0,0,1,4,1,3,0,0,0,1,1,3,0,3,0,0,0,1,1,3,0,3,0
4,0,1,4,19,17,2,1,0,1,4,4,2,1,1,0,0,1,4,4,1,0,1,0
0,1,0,0,2,0,2,0,1,0,0,0,2,0,2,0,1,0,0,0,2,0,2,0
4,1,0,2,2,1,1,0,1,0,4,2,1,0,1,0,1,0,4,2,1,0,1,0
2,2,4,0,18,8,10,1,2,4,2,0,10,4,6,0,2,4,2,0,6,3,3,0
2,3,4,3,17,8,9,6,3,4,2,3,9,4,5,3,3,4,2,3,5,2,3,2
4,3,2,3,13,11,2,1,3,2,4,3,2,1,1,0,3,2,4,3,1,0,1,0
2,2,1,0,1,0,1,0,2,1,2,0,1,0,1,0,2,1,2,0,1,0,1,0
3,2,0,1,11,7,4,1,2,0,3,1,4,2,2,0,2,0,3,1,2,1,1,0
2,2,1,4,8,3,5,4,2,1,2,4,5,2,3,2,2,1,2,4,3,1,2,1
4,3,4,2,16,14,2,0,3,4,4,2,2,1,1,0,3,4,4,2,1,0,1,0
3,3,4,1,12,8,4,1,3,4,3,1,4,2,2,0,3,4,3,1,2,1,1,0
2,4,3,1,1,0,1,0,4,3,2,1,1,0,1,0,4,3,2,1,1,0,1,0
4,4,1,1,4,3,1,0,4,1,4,1,1,0,1,0,4,1,4,1,1,0,1,0
0,2,2,4,17,1,16,14,2,2,0,4,16,1,15,13,2,2,0,4,15,1,14,12
1,3,2,4,7,2,5,4,3,2,1,4,5,1,4,3,3,2,1,4,4,1,3,2
3,2,0,3,2,1,1,0,2,0,3,3,1,0,1,0,2,0,3,3,1,0,1,0
3,1,2,1,10,7,3,0,1,2,3,1,3,2,1,0,1,2,3,1,1,0,1,0
2,1,1,0,7,3,4,0,1,1,2,0,4,1,3,0,1,1,2,0,3,1,2,0
3,2,0,2,2,1,1,0,2,0,3,2,1,0,1,0,2,0,3,2,1,0,1,0
2,4,3,3,2,0,2,1,4,3,2,3,2,0,2,1,4,3,2,3,2,1,1,0
4,2,4,2,16,14,2,1,2,4,4,2,2,1,1,0,2,4,4,2,1,0,1,0
4,0,2,2,20,18,2,0,0,2,4,2,2,1,1,0,0,2,4,2,1,0,1,0
0,2,4,0,18,1,17,1,2,4,0,0,17,1,16,1,2,4,0,0,16,1,15,1
4,4,0,4,11,9,2,1,4,0,4,4,2,1,1,0,4,0,4,4,1,0,1,0
1,1,3,0,24,7,17,1,1,3,1,0,17,5,12,1,1,3,1,0,12,3,9,0
1,4,4,2,13,3,10,5,4,4,1,2,10,2,8,4,4,4,1,2,8,2,6,3
4,0,2,3,27,24,3,2,0,2,4,3,3,2,1,0,0,2,4,3,1,0,1,0
3,1,4,4,27,18,9,8,1,4,3,4,9,6,3,2,1,4,3,4,3,2,1,0
4,3,3,4,15,13,2,1,3,3,4,4,2,1,1,0,3,3,4,4,1,0,1,0
0,4,2,2,5,0,5,2,4,2,0,2,5,0,5,2,4,2,0,2,5,0,5,2
2,0,4,2,25,12,13,6,0,4,2,2,13,6,7,3,0,4,2,2,7,3,4,1
4,0,1,1,19,17,2,0,0,1,4,1,2,1,1,0,0,1,4,1,1,0,1,0
2,3,1,3,12,6,6,4,3,1,2,3,6,2,4,2,3,1,2,3,4,1,3,2
1,0,2,4,29,8,21,18,0,2,1,4,21,6,15,13,0,2,1,4,15,4,11,9
4,0,3,4,26,23,3,2,0,3,4,4,3,2,1,0,0,3,4,4,1,0,1,0
1,1,4,1,24,7,17,5,1,4,1,1,17,5,12,3,1,4,1,1,12,3,9,2
1,1,1,3,17,5,12,8,1,1,1,3,12,3,9,6,1,1,1,3,9,2,7,4
1,2,3,1,23,6,17,5,2,3,1,1,17,5,12,3,2,3,1,1,12,3,9,2
2,4,0,4,2,0,2,1,4,0,2,4,2,0,2,1,4,0,2,4,2,1,1,0
1,3,4,2,9,2,7,3,3,4,1,2,7,2,5,2,3,4,1,2,5,1,4,2
4,0,2,1,29,26,3,0,0,2,4,1,3,2,1,0,0,2,4,1,1,0,1,0
2,4,1,3,3,1,2,1,4,1,2,3,2,1,1,0,4,1,2,3,1,0,1,0
0,3,4,0,19,1,18,1,3,4,0,0,18,1,17,1,3,4,0,0,17,1,16,1
0,4,4,2,1,0,1,0,4,4,0,2,1,0,1,0,4,4,0,2,1,0,1,0
0,0,0,3,7,0,7,4,0,0,0,3,7,0,7,4,0,0,0,3,7,0,7,4
4,3,4,0,22,19,3,0,3,4,4,0,3,2,1,0,3,4,4,0,1,0,1,0
0,2,0,3,3,0,3,2,2,0,0,3,3,0,3,2,2,0,0,3,3,0,3,2
4,4,2,3,8,7,1,0,4,2,4,3,1,0,1,0,4,2,4,3,1,0,1,0
2,1,3,4,25,12,13,11,1,3,2,4,13,6,7,6,1,3,2,4,7,3,4,3
2,4,3,4,11,5,6,5,4,3,2,4,6,2,4,3,4,3,2,4,4,1,3,2
1,4,4,4,8,2,6,5,4,4,1,4,6,1,5,4,4,4,1,4,5,1,4,3
0,3,3,2,16,1,15,7,3,3,0,2,15,1,14,6,3,3,0,2,14,1,13,6
1,3,2,2,10,3,7,3,3,2,1,2,7,2,5,2,3,2,1,2,5,1,4,1
0,0,2,3,19,1,18,12,0,2,0,3,18,1,17,11,0,2,0,3,17,1,16,11
3,4,2,4,0,0,0,0,4,2,3,4,0,0,0,0,4,2,3,4,0,0,0,0
2,0,1,2,16,7,9,4,0,1,2,2,9,4,5,2,0,1,2,2,5,2,3,1
4,3,3,1,13,11,2,0,3,3,4,1,2,1,1,0,3,3,4,1,1,0,1,0
3,1,0,0,1,0,1,0,1,0,3,0,1,0,1,0,1,0,3,0,1,0,1,0
2,4,2,1,9,4,5,1,4,2,2,1,5,2,3,0,4,2,2,1,3,1,2,0
3,0,4,2,27,18,9,4,0,4,3,2,9,6,3,1,0,4,3,2,3,2,1,0
3,3,4,1,11,7,4,1,3,4,3,1,4,2,2,0,3,4,3,1,2,1,1,0
0,4,4,3,16,1,15,10,4,4,0,3,15,1,14,9,4,4,0,3,14,1,13,9
0,3,1,2,3,0,3,1,3,1,0,2,3,0,3,1,3,1,0,2,3,0,3,1
2,4,4,0,10,4,6,0,4,4,2,0,6,3,3,0,4,4,2,0,3,1,2,0
1,1,2,3,27,8,19,13,1,2,1,3,19,5,14,9,1,2,1,3,14,4,10,7
4,4,2,4,4,3,1,0,4,2,4,4,1,0,1,0,4,2,4,4,1,0,1,0
2,3,2,0,13,6,7,0,3,2,2,0,7,3,4,0,3,2,2,0,4,1,3,0
3,3,3,3,12,8,4,2,3,3,3,3,4,2,2,1,3,3,3,3,2,1,1,0
3,3,0,1,1,0,1,0,3,0,3,1,1,0,1,0,3,0,3,1,1,0,1,0
4,3,2,2,20,18,2,1,3,2,4,2,2,1,1,0,3,2,4,2,1,0,1,0
1,4,1,1,6,1,5,1,4,1,1,1,5,1,4,1,4,1,1,1,4,1,3,0
4,0,3,2,29,26,3,1,0,3,4,2,3,2,1,0,0,3,4,2,1,0,1,0
4,1,2,2,22,19,3,1,1,2,4,2,3,2,1,0,1,2,4,2,1,0,1,0
1,1,0,2,0,0,0,0,1,0,1,2,0,0,0,0,1,0,1,2,0,0,0,0
2,1,4,0,17,8,9,0,1,4,2,0,9,4,5,0,1,4,2,0,5,2,3,0
2,1,0,2,7,3,4,2,1,0,2,2,4,1,3,1,1,0,2,2,3,1,2,1
1,0,1,0,16,4,12,1,0,1,1,0,12,3,9,0,0,1,1,0,9,2,7,0
1,4,2,1,10,3,7,2,4,2,1,1,7,2,5,1,4,2,1,1,5,1,4,1
2,2,4,4,26,12,14,12,2,4,2,4,14,7,7,6,2,4,2,4,7,3,4,3
3,1,0,2,5,3,2,1,1,0,3,2,2,1,1,0,1,0,3,2,1,0,1,0
3,2,2,2,13,9,4,2,2,2,3,2,4,2,2,1,2,2,3,2,2,1,1,0
4,0,3,0,26,23,3,0,0,3,4,0,3,2,1,0,0,3,4,0,1,0,1,0
3,1,1,3,6,4,2,1,1,1,3,3,2,1,1,0,1,1,3,3,1,0,1,0
4,0,4,1,29,26,3,0,0,4,4,1,3,2,1,0,0,4,4,1,1,0,1,0
0,3,2,2,8,0,8,3,3,2,0,2,8,0,8,3,3,2,0,2,8,0,8,4
4,0,4,1,28,25,3,0,0,4,4,1,3,2,1,0,0,4,4,1,1,0,1,0
1,2,1,4,10,2,8,7,2,1,1,4,8,2,6,5,2,1,1,4,6,1,5,4
0,1,2,0,12,1,11,1,1,2,0,0,11,1,10,0,1,2,0,0,10,1,9,0
3,2,2,3,16,11,5,3,2,2,3,3,5,3,2,1,2,2,3,3,2,1,1,0
2,4,0,3,5,2,3,2,4,0,2,3,3,1,2,1,4,0,2,3,2,0,2,1
4,1,0,3,5,4,1,0,1,0,4,3,1,0,1,0,1,0,4,3,1,0,1,0
1,1,2,1,20,6,14,4,1,2,1,1,14,4,10,3,1,2,1,1,10,3,7,2
4,3,4,2,19,17,2,0,3,4,4,2,2,1,1,0,3,4,4,2,1,0,1,0
2,3,3,2,6,3,3,1,3,3,2,2,3,1,2,0,3,3,2,2,2,1,1,0
0,2,0,2,11,1,10,5,2,0,0,2,10,1,9,4,2,0,0,2,9,0,9,4
3,1,2,4,21,14,7,6,1,2,3,4,7,4,3,2,1,2,3,4,3,2,1,0
0,4,4,0,7,0,7,0,4,4,0,0,7,0,7,0,4,4,0,0,7,0,7,0
1,4,0,0,5,1,4,0,4,0,1,0,4,1,3,0,4,0,1,0,3,0,3,0
0,0,1,1,18,1,17,5,0,1,0,1,17,1,16,4,0,1,0,1,16,1,15,4
1,3,3,4,5,1,4,3,3,3,1,4,4,1,3,2,3,3,1,4,3,0,3,2
3,2,0,3,6,4,2,1,2,0,3,3,2,1,1,0,2,0,3,3,1,0,1,0
1,2,0,0,10,3,7,0,2,0,1,0,7,2,5,0,2,0,1,0,5,1,4,0
1,4,0,3,1,0,1,0,4,0,1,3,1,0,1,0,4,0,1,3,1,0,1,0
1,1,2,4,14,4,10,9,1,2,1,4,10,2,8,7,1,2,1,4,8,2,6,5
3,0,0,2,7,4,3,1,0,0,3,2,3,2,1,0,0,0,3,2,1,0,1,0
4,0,0,0,7,6,1,0,0,0,4,0,1,0,1,0,0,0,4,0,1,0,1,0
1,4,0,1,3,0,3,0,4,0,1,1,3,0,3,0,4,0,1,1,3,0,3,0
4,1,1,4,22,19,3,2,1,1,4,4,3,2,1,0,1,1,4,4,1,0,1,0
2,4,1,4,2,0,2,1,4,1,2,4,2,1,1,0,4,1,2,4,1,0,1,0
0,0,3,4,22,2,20,18,0,3,0,4,20,1,19,17,0,3,0,4,19,1,18,16
1,2,3,0,24,7,17,1,2,3,1,0,17,5,12,1,2,3,1,0,12,3,9,0
4,2,0,4,8,7,1,0,2,0,4,4,1,0,1,0,2,0,4,4,1,0,1,0
4,3,4,2,12,10,2,1,3,4,4,2,2,1,1,0,3,4,4,2,1,0,1,0
0,4,2,4,4,0,4,3,4,2,0,4,4,0,4,3,4,2,0,4,4,0,4,3
1,4,4,4,9,2,7,6,4,4,1,4,7,2,5,4,4,4,1,4,5,1,4,3
4,0,3,4,28,25,3,2,0,3,4,4,3,2,1,0,0,3,4,4,1,0,1,0
2,2,2,4,17,8,9,8,2,2,2,4,9,4,5,4,2,2,2,4,5,2,3,2
1,4,2,0,7,2,5,0,4,2,1,0,5,1,4,0,4,2,1,0,4,1,3,0
3,1,0,2,2,1,1,0,1,0,3,2,1,0,1,0,1,0,3,2,1,0,1,0
4,1,1,2,5,4,1,0,1,1,4,2,1,0,1,0,1,1,4,2,1,0,1,0
3,3,2,0,8,5,3,0,3,2,3,0,3,2,1,0,3,2,3,0,1,0,1,0
3,1,4,0,25,17,8,0,1,4,3,0,8,5,3,0,1,4,3,0,3,2,1,0
0,2,4,1,19,1,18,5,2,4,0,1,18,1,17,5,2,4,0,1,17,1,16,4
2,4,2,4,3,1,2,1,4,2,2,4,2,0,2,1,4,2,2,4,2,0,2,1
2,0,2,2,21,10,11,5,0,2,2,2,11,5,6,2,0,2,2,2,6,2,4,2
2,0,3,3,28,14,14,9,0,3,2,3,14,7,7,4,0,3,2,3,7,3,4,2
4,4,1,3,2,1,1,0,4,1,4,3,1,0,1,0,4,1,4,3,1,0,1,0
3,1,1,3,13,9,4,2,1,1,3,3,4,2,2,1,1,1,3,3,2,1,1,0
1,4,0,3,7,2,5,3,4,0,1,3,5,1,4,2,4,0,1,3,4,1,3,2
4,2,4,3,27,24,3,2,2,4,4,3,3,2,1,0,2,4,4,3,1,0,1,0
0,0,2,1,21,2,19,5,0,2,0,1,19,1,18,5,0,2,0,1,18,1,17,5
1,0,1,0,18,5,13,1,0,1,1,0,13,3,10,1,0,1,1,0,10,3,7,0
4,2,3,0,12,10,2,0,2,3,4,0,2,1,1,0,2,3,4,0,1,0,1,0
2,2,1,0,7,3,4,0,2,1,2,0,4,1,3,0,2,1,2,0,3,1,2,0
3,2,1,0,15,10,5,0,2,1,3,0,5,3,2,0,2,1,3,0,2,1,1,0
2,2,4,1,25,12,13,3,2,4,2,1,13,6,7,2,2,4,2,1,7,3,4,1
4,4,3,1,13,11,2,0,4,3,4,1,2,1,1,0,4,3,4,1,1,0,1,0
1,1,4,1,20,6,14,4,1,4,1,1,14,4,10,2,1,4,1,1,10,2,8,2
4,0,4,2,28,25,3,1,0,4,4,2,3,2,1,0,0,4,4,2,1,0,1,0
3,2,1,0,7,4,3,0,2,1,3,0,3,2,1,0,2,1,3,0,1,0,1,0
0,2,0,4,2,0,2,1,2,0,0,4,2,0,2,1,2,0,0,4,2,0,2,1
4,0,1,3,22,19,3,2,0,1,4,3,3,2,1,0,0,1,4,3,1,0,1,0
0,0,4,0,29,2,27,2,0,4,0,0,27,2,25,2,0,4,0,0,25,2,23,2
0,4,2,0,17,1,16,1,4,2,0,0,16,1,15,1,4,2,0,0,15,1,14,1
1,3,2,4,16,4,12,10,3,2,1,4,12,3,9,8,3,2,1,4,9,2,7,6
3,1,1,4,14,9,5,4,1,1,3,4,5,3,2,1,1,1,3,4,2,1,1,0
1,0,2,1,18,5,13,3,0,2,1,1,13,3,10,2,0,2,1,1,10,3,7,2
4,4,1,1,5,4,1,0,4,1,4,1,1,0,1,0,4,1,4,1,1,0,1,0
0,1,3,4,21,2,19,17,1,3,0,4,19,1,18,16,1,3,0,4,18,1,17,15
1,2,4,1,16,4,12,3,2,4,1,1,12,3,9,2,2,4,1,1,9,2,7,2
0,3,3,4,18,1,17,15,3,3,0,4,17,1,16,14,3,3,0,4,16,1,15,13
4,2,2,3,11,9,2,1,2,2,4,3,2,1,1,0,2,2,4,3,1,0,1,0
3,2,2,0,6,4,2,0,2,2,3,0,2,1,1,0,2,2,3,0,1,0,1,0
1,1,2,1,14,4,10,3,1,2,1,1,10,3,7,2,1,2,1,1,7,2,5,1
2,0,1,4,19,9,10,8,0,1,2,4,10,5,5,4,0,1,2,4,5,2,3,2
2,0,0,3,13,6,7,4,0,0,2,3,7,3,4,2,0,0,2,3,4,2,2,1
2,3,0,4,3,1,2,1,3,0,2,4,2,1,1,0,3,0,2,4,1,0,1,0
3,0,3,4,28,19,9,8,0,3,3,4,9,6,3,2,0,3,3,4,3,2,1,0
2,2,3,3,15,7,8,5,2,3,2,3,8,4,4,2,2,3,2,3,4,2,2,1
1,0,0,4,20,6,14,12,0,0,1,4,14,4,10,8,0,0,1,4,10,3,7,6
4,0,2,3,23,20,3,2,0,2,4,3,3,2,1,0,0,2,4,3,1,0,1,0
3,2,2,4,5,3,2,1,2,2,3,4,2,1,1,0,2,2,3,4,1,0,1,0
2,3,1,1,10,5,5,1,3,1,2,1,5,2,3,0,3,1,2,1,3,1,2,0
3,1,4,2,28,19,9,4,1,4,3,2,9,6,3,1,1,4,3,2,3,2,1,0
4,4,0,2,1,0,1,0,4,0,4,2,1,0,1,0,4,0,4,2,1,0,1,0
2,1,0,4,9,4,5,4,1,0,2,4,5,2,3,2,1,0,2,4,3,1,2,1
3,0,3,4,27,18,9,8,0,3,3,4,9,6,3,2,0,3,3,4,3,2,1,0
0,1,3,4,26,2,24,21,1,3,0,4,24,2,22,19,1,3,0,4,22,2,20,17
1,1,2,4,10,3,7,6,1,2,1,4,7,2,5,4,1,2,1,4,5,1,4,3
4,0,4,3,29,26,3,2,0,4,4,3,3,2,1,0,0,4,4,3,1,0,1,0
2,3,1,1,5,2,3,0,3,1,2,1,3,1,2,0,3,1,2,1,2,1,1,0
4,3,1,0,8,7,1,0,3,1,4,0,1,0,1,0,3,1,4,0,1,0,1,0
4,1,2,0,25,22,3,0,1,2,4,0,3,2,1,0,1,2,4,0,1,0,1,0
0,4,3,1,10,0,10,2,4,3,0,1,10,1,9,2,4,3,0,1,9,0,9,2
3,3,1,3,2,1,1,0,3,1,3,3,1,0,1,0,3,1,3,3,1,0,1,0
3,1,1,4,13,9,4,3,1,1,3,4,4,2,2,1,1,1,3,4,2,1,1,0
2,1,3,4,26,13,13,11,1,3,2,4,13,6,7,6,1,3,2,4,7,3,4,3
2,2,2,1,12,5,7,2,2,2,2,1,7,3,4,1,2,2,2,1,4,1,3,0
1,4,1,4,3,0,3,2,4,1,1,4,3,0,3,2,4,1,1,4,3,0,3,2
2,2,4,1,22,11,11,3,2,4,2,1,11,5,6,1,2,4,2,1,6,3,3,0
2,4,4,2,0,0,0,0,4,4,2,2,0,0,0,0,4,4,2,2,0,0,0,0
0,2,3,0,10,0,10,1,2,3,0,0,10,1,9,0,2,3,0,0,9,0,9,0
1,1,1,1,21,6,15,4,1,1,1,1,15,4,11,3,1,1,1,1,11,3,8,2
3,0,0,3,6,4,2,1,0,0,3,3,2,1,1,0,0,0,3,3,1,0,1,0
0,2,0,4,8,0,8,7,2,0,0,4,8,0,8,7,2,0,0,4,8,0,8,7
0,2,3,1,26,2,24,7,2,3,0,1,24,2,22,6,2,3,0,1,22,2,20,5
3,1,0,3,14,9,5,3,1,0,3,3,5,3,2,1,1,0,3,3,2,1,1,0
1,4,4,0,9,2,7,0,4,4,1,0,7,2,5,0,4,4,1,0,5,1,4,0
0,4,4,0,3,0,3,0,4,4,0,0,3,0,3,0,4,4,0,0,3,0,3,0
1,1,0,2,11,3,8,4,1,0,1,2,8,2,6,3,1,0,1,2,6,1,5,2
4,1,0,2,10,8,2,1,1,0,4,2,2,1,1,0,1,0,4,2,1,0,1,0
4,3,3,2,12,10,2,0,3,3,4,2,2,1,1,0,3,3,4,2,1,0,1,0
1,4,3,1,2,0,2,0,4,3,1,1,2,0,2,0,4,3,1,1,2,0,2,0
2,1,2,4,24,11,13,11,1,2,2,4,13,6,7,6,1,2,2,4,7,3,4,3
2,2,0,4,4,1,3,2,2,0,2,4,3,1,2,1,2,0,2,4,2,0,2,1
4,0,2,2,16,14,2,1,0,2,4,2,2,1,1,0,0,2,4,2,1,0,1,0
2,1,1,3,12,6,6,4,1,1,2,3,6,3,3,2,1,1,2,3,3,1,2,1
1,1,4,1,29,8,21,6,1,4,1,1,21,6,15,4,1,4,1,1,15,4,11,3
2,1,4,0,21,10,11,1,1,4,2,0,11,5,6,0,1,4,2,0,6,3,3,0
2,1,1,1,7,3,4,1,1,1,2,1,4,2,2,0,1,1,2,1,2,1,1,0
4,4,3,3,6,5,1,0,4,3,4,3,1,0,1,0,4,3,4,3,1,0,1,0
0,1,0,1,0,0,0,0,1,0,0,1,0,0,0,0,1,0,0,1,0,0,0,0
1,1,2,0,19,5,14,1,1,2,1,0,14,4,10,1,1,2,1,0,10,3,7,0
2,0,2,4,19,9,10,8,0,2,2,4,10,5,5,4,0,2,2,4,5,2,3,2
0,0,1,4,15,1,14,12,0,1,0,4,14,1,13,11,0,1,0,4,13,1,12,10
0,3,4,2,8,0,8,3,3,4,0,2,8,0,8,4,3,4,0,2,8,0,8,3
0,0,0,4,11,1,10,8,0,0,0,4,10,1,9,8,0,0,0,4,9,0,9,8
2,3,1,3,13,6,7,4,3,1,2,3,7,3,4,2,3,1,2,3,4,2,2,1
2,0,4,4,28,13,15,13,0,4,2,4,15,7,8,7,0,4,2,4,8,3,5,4
2,4,1,1,20,9,11,3,4,1,2,1,11,5,6,1,4,1,2,1,6,3,3,0
2,1,4,1,23,11,12,3,1,4,2,1,12,5,7,2,1,4,2,1,7,3,4,1
4,1,2,2,22,19,3,1,1,2,4,2,3,2,1,0,1,2,4,2,1,0,1,0
1,3,3,2,15,4,11,5,3,3,1,2,11,3,8,4,3,3,1,2,8,2,6,2
4,0,2,0,20,18,2,0,0,2,4,0,2,1,1,0,0,2,4,0,1,0,1,0
4,2,0,3,6,5,1,0,2,0,4,3,1,0,1,0,2,0,4,3,1,0,1,0
1,3,3,2,5,1,4,1,3,3,1,2,4,1,3,1,3,3,1,2,3,0,3,1
0,2,0,3,1,0,1,0,2,0,0,3,1,0,1,0,2,0,0,3,1,0,1,0
1,1,0,0,8,2,6,0,1,0,1,0,6,1,5,0,1,0,1,0,5,1,4,0
4,4,4,0,6,5,1,0,4,4,4,0,1,0,1,0,4,4,4,0,1,0,1,0
0,0,0,4,12,1,11,9,0,0,0,4,11,1,10,9,0,0,0,4,10,0,10,9
0,4,4,2,14,1,13,6,4,4,0,2,13,1,12,5,4,4,0,2,12,1,11,5
4,4,1,2,1,0,1,0,4,1,4,2,1,0,1,0,4,1,4,2,1,0,1,0
2,2,4,4,22,11,11,9,2,4,2,4,11,5,6,5,2,4,2,4,6,2,4,3
2,3,3,1,18,8,10,2,3,3,2,1,10,4,6,1,3,3,2,1,6,3,3,0
1,1,3,2,28,8,20,9,1,3,1,2,20,5,15,7,1,3,1,2,15,4,11,5
2,4,1,3,7,3,4,2,4,1,2,3,4,1,3,2,4,1,2,3,3,1,2,1
4,1,3,4,23,20,3,2,1,3,4,4,3,2,1,0,1,3,4,4,1,0,1,0
3,3,3,4,16,11,5,4,3,3,3,4,5,3,2,1,3,3,3,4,2,1,1,0
1,1,2,0,14,4,10,1,1,2,1,0,10,3,7,0,1,2,1,0,7,2,5,0
4,1,2,2,16,14,2,1,1,2,4,2,2,1,1,0,1,2,4,2,1,0,1,0
2,0,2,0,16,7,9,0,0,2,2,0,9,4,5,0,0,2,2,0,5,2,3,0
3,0,1,4,13,9,4,3,0,1,3,4,4,2,2,1,0,1,3,4,2,1,1,0
1,4,2,1,0,0,0,0,4,2,1,1,0,0,0,0,4,2,1,1,0,0,0,0
0,3,1,0,10,0,10,1,3,1,0,0,10,1,9,0,3,1,0,0,9,0,9,0
2,1,0,1,5,2,3,0,1,0,2,1,3,1,2,0,1,0,2,1,2,0,2,0
3,3,1,4,0,0,0,0,3,1,3,4,0,0,0,0,3,1,3,4,0,0,0,0
0,2,1,0,7,0,7,0,2,1,0,0,7,0,7,0,2,1,0,0,7,0,7,0
4,4,2,2,7,6,1,0,4,2,4,2,1,0,1,0,4,2,4,2,1,0,1,0
1,1,0,0,7,2,5,0,1,0,1,0,5,1,4,0,1,0,1,0,4,1,3,0
3,3,3,0,19,13,6,0,3,3,3,0,6,4,2,0,3,3,3,0,2,1,1,0
4,2,1,0,10,9,1,0,2,1,4,0,1,0,1,0,2,1,4,0,1,0,1,0
2,4,3,3,3,1,2,1,4,3,2,3,2,1,1,0,4,3,2,3,1,0,1,0
0,0,2,2,17,1,16,7,0,2,0,2,16,1,15,7,0,2,0,2,15,1,14,7
0,1,4,4,27,2,25,22,1,4,0,4,25,2,23,20,1,4,0,4,23,2,21,18
4,0,1,3,17,15,2,1,0,1,4,3,2,1,1,0,0,1,4,3,1,0,1,0
2,4,1,4,3,1,2,1,4,1,2,4,2,1,1,0,4,1,2,4,1,0,1,0
2,0,4,2,29,14,15,7,0,4,2,2,15,7,8,3,0,4,2,2,8,3,5,2
0,0,1,2,2,0,2,1,0,1,0,2,2,0,2,0,0,1,0,2,2,0,2,0
1,2,4,2,17,5,12,6,2,4,1,2,12,3,9,4,2,4,1,2,9,2,7,3
4,4,2,1,2,1,1,0,4,2,4,1,1,0,1,0,4,2,4,1,1,0,1,0
4,4,3,0,8,7,1,0,4,3,4,0,1,0,1,0,4,3,4,0,1,0,1,0
2,3,2,4,2,1,1,0,3,2,2,4,1,0,1,0,3,2,2,4,1,0,1,0
0,4,1,2,5,0,5,2,4,1,0,2,5,0,5,2,4,1,0,2,5,0,5,2
4,0,2,3,26,23,3,2,0,2,4,3,3,2,1,0,0,2,4,3,1,0,1,0
2,4,2,3,5,2,3,2,4,2,2,3,3,1,2,1,4,2,2,3,2,1,1,0
3,4,3,1,6,4,2,0,4,3,3,1,2,1,1,0,4,3,3,1,1,0,1,0
3,0,2,0,26,18,8,0,0,2,3,0,8,5,3,0,0,2,3,0,3,2,1,0
3,3,4,2,16,11,5,2,3,4,3,2,5,3,2,0,3,4,3,2,2,1,1,0
1,3,2,4,12,3,9,8,3,2,1,4,9,2,7,6,3,2,1,4,7,2,5,4
2,4,4,4,20,9,11,9,4,4,2,4,11,5,6,5,4,4,2,4,6,3,3,2
0,3,4,3,16,1,15,10,3,4,0,3,15,1,14,9,3,4,0,3,14,1,13,9
1,3,4,3,10,3,7,4,3,4,1,3,7,2,5,3,3,4,1,3,5,1,4,2
4,0,1,1,16,14,2,0,0,1,4,1,2,1,1,0,0,1,4,1,1,0,1,0
4,4,2,0,3,2,1,0,4,2,4,0,1,0,1,0,4,2,4,0,1,0,1,0
4,2,1,2,7,6,1,0,2,1,4,2,1,0,1,0,2,1,4,2,1,0,1,0
4,0,0,3,2,1,1,0,0,0,4,3,1,0,1,0,0,0,4,3,1,0,1,0
3,1,4,1,27,18,9,2,1,4,3,1,9,6,3,0,1,4,3,1,3,2,1,0
3,3,2,2,20,14,6,2,3,2,3,2,6,4,2,1,3,2,3,2,2,1,1,0
4,2,4,2,21,18,3,1,2,4,4,2,3,2,1,0,2,4,4,2,1,0,1,0
0,4,2,0,1,0,1,0,4,2,0,0,1,0,1,0,4,2,0,0,1,0,1,0
2,0,1,3,26,12,14,9,0,1,2,3,14,7,7,4,0,1,2,3,7,3,4,2
4,3,0,1,2,1,1,0,3,0,4,1,1,0,1,0,3,0,4,1,1,0,1,0
3,3,3,3,10,6,4,2,3,3,3,3,4,2,2,1,3,3,3,3,2,1,1,0
2,2,3,4,22,10,12,10,2,3,2,4,12,6,6,5,2,3,2,4,6,3,3,2
3,2,0,1,4,2,2,0,2,0,3,1,2,1,1,0,2,0,3,1,1,0,1,0
1,2,0,4,2,0,2,1,2,0,1,4,2,0,2,1,2,0,1,4,2,0,2,1
0,2,2,1,15,1,14,4,2,2,0,1,14,1,13,3,2,2,0,1,13,1,12,3
1,1,0,3,0,0,0,0,1,0,1,3,0,0,0,0,1,0,1,3,0,0,0,0
1,2,2,2,11,3,8,3,2,2,1,2,8,2,6,2,2,2,1,2,6,1,5,2
4,3,0,3,5,4,1,0,3,0,4,3,1,0,1,0,3,0,4,3,1,0,1,0
3,3,0,4,2,1,1,0,3,0,3,4,1,0,1,0,3,0,3,4,1,0,1,0
1,3,0,0,9,2,7,0,3,0,1,0,7,2,5,0,3,0,1,0,5,1,4,0
2,0,2,0,15,7,8,0,0,2,2,0,8,3,5,0,0,2,2,0,5,2,3,0
1,0,3,2,25,7,18,9,0,3,1,2,18,5,13,6,0,3,1,2,13,3,10,5
3,4,3,2,9,6,3,1,4,3,3,2,3,2,1,0,4,3,3,2,1,0,1,0
4,2,0,1,13,11,2,0,2,0,4,1,2,1,1,0,2,0,4,1,1,0,1,0
0,4,2,3,5,0,5,3,4,2,0,3,5,0,5,3,4,2,0,3,5,0,5,3
1,4,0,1,7,2,5,1,4,0,1,1,5,1,4,1,4,0,1,1,4,1,3,0
1,4,4,3,1,0,1,0,4,4,1,3,1,0,1,0,4,4,1,3,1,0,1,0
0,3,4,4,8,0,8,7,3,4,0,4,8,0,8,7,3,4,0,4,8,0,8,7
4,1,3,3,17,15,2,1,1,3,4,3,2,1,1,0,1,3,4,3,1,0,1,0
0,2,3,4,23,2,21,18,2,3,0,4,21,2,19,17,2,3,0,4,19,1,18,16
1,1,3,0,22,6,16,1,1,3,1,0,16,4,12,1,1,3,1,0,12,3,9,0
2,1,1,1,7,3,4,1,1,1,2,1,4,1,3,0,1,1,2,1,3,1,2,0
1,0,3,3,28,8,20,13,0,3,1,3,20,5,15,10,0,3,1,3,15,4,11,7
3,1,3,1,19,13,6,1,1,3,3,1,6,4,2,0,1,3,3,1,2,1,1,0
4,0,4,2,23,20,3,1,0,4,4,2,3,2,1,0,0,4,4,2,1,0,1,0
0,2,3,4,18,1,17,15,2,3,0,4,17,1,16,14,2,3,0,4,16,1,15,13
1,2,2,2,17,5,12,5,2,2,1,2,12,3,9,4,2,2,1,2,9,2,7,3
2,4,0,3,3,1,2,1,4,0,2,3,2,1,1,0,4,0,2,3,1,0,1,0
0,2,4,3,24,2,22,15,2,4,0,3,22,2,20,14,2,4,0,3,20,2,18,12
3,2,1,1,2,1,1,0,2,1,3,1,1,0,1,0,2,1,3,1,1,0,1,0
1,2,2,1,19,5,14,4,2,2,1,1,14,4,10,3,2,2,1,1,10,2,8,2
4,1,4,0,23,20,3,0,1,4,4,0,3,2,1,0,1,4,4,0,1,0,1,0
0,4,0,0,10,1,9,0,4,0,0,0,9,0,9,0,4,0,0,0,9,0,9,0
0,4,0,0,2,0,2,0,4,0,0,0,2,0,2,0,4,0,0,0,2,0,2,0
4,0,2,3,27,24,3,2,0,2,4,3,3,2,1,0,0,2,4,3,1,0,1,0
0,2,3,0,19,1,18,1,2,3,0,0,18,1,17,1,2,3,0,0,17,1,16,1
0,0,0,3,12,1,11,7,0,0,0,3,11,1,10,7,0,0,0,3,10,1,9,6
2,4,1,4,0,0,0,0,4,1,2,4,0,0,0,0,4,1,2,4,0,0,0,0
0,4,0,2,2,0,2,0,4,0,0,2,2,0,2,0,4,0,0,2,2,0,2,1
0,2,0,3,0,0,0,0,2,0,0,3,0,0,0,0,2,0,0,3,0,0,0,0
1,0,0,0,5,1,4,0,0,0,1,0,4,1,3,0,0,0,1,0,3,0,3,0
0,4,0,4,1,0,1,0,4,0,0,4,1,0,1,0,4,0,0,4,1,0,1,0
1,4,2,2,7,2,5,2,4,2,1,2,5,1,4,2,4,2,1,2,4,1,3,1
3,3,4,4,16,11,5,4,3,4,3,4,5,3,2,1,3,4,3,4,2,1,1,0
1,3,0,1,8,2,6,1,3,0,1,1,6,1,5,1,3,0,1,1,5,1,4,1
1,3,2,4,8,2,6,5,3,2,1,4,6,1,5,4,3,2,1,4,5,1,4,3
4,3,1,3,7,6,1,0,3,1,4,3,1,0,1,0,3,1,4,3,1,0,1,0
4,2,1,4,9,8,1,0,2,1,4,4,1,0,1,0,2,1,4,4,1,0,1,0
1,1,2,0,27,8,19,1,1,2,1,0,19,5,14,1,1,2,1,0,14,4,10,1
3,2,0,0,3,2,1,0,2,0,3,0,1,0,1,0,2,0,3,0,1,0,1,0
2,4,4,0,0,0,0,0,4,4,2,0,0,0,0,0,4,4,2,0,0,0,0,0
0,2,0,4,4,0,4,3,2,0,0,4,4,0,4,3,2,0,0,4,4,0,4,3
2,4,3,1,5,2,3,0,4,3,2,1,3,1,2,0,4,3,2,1,2,0,2,0
4,4,2,4,12,10,2,1,4,2,4,4,2,1,1,0,4,2,4,4,1,0,1,0
4,3,1,2,2,1,1,0,3,1,4,2,1,0,1,0,3,1,4,2,1,0,1,0
0,0,1,3,18,1,17,11,0,1,0,3,17,1,16,11,0,1,0,3,16,1,15,10
3,1,2,4,15,10,5,4,1,2,3,4,5,3,2,1,1,2,3,4,2,1,1,0
0,0,3,4,28,2,26,23,0,3,0,4,26,2,24,21,0,3,0,4,24,2,22,19
2,3,1,2,6,2,4,1,3,1,2,2,4,2,2,1,3,1,2,2,2,1,1,0
0,4,2,4,5,0,5,4,4,2,0,4,5,0,5,4,4,2,0,4,5,0,5,4
2,0,2,3,29,14,15,10,0,2,2,3,15,7,8,5,0,2,2,3,8,4,4,2
1,4,2,0,9,2,7,0,4,2,1,0,7,2,5,0,4,2,1,0,5,1,4,0
1,1,3,4,27,8,19,17,1,3,1,4,19,5,14,12,1,3,1,4,14,4,10,9
2,4,4,2,10,5,5,2,4,4,2,2,5,2,3,1,4,4,2,2,3,1,2,1
1,4,1,3,8,2,6,4,4,1,1,3,6,1,5,3,4,1,1,3,5,1,4,2
2,2,0,1,11,5,6,1,2,0,2,1,6,3,3,0,2,0,2,1,3,1,2,0
3,2,2,4,15,10,5,4,2,2,3,4,5,3,2,1,2,2,3,4,2,1,1,0
1,3,0,3,5,1,4,2,3,0,1,3,4,1,3,2,3,0,1,3,3,0,3,2
0,4,2,3,7,0,7,4,4,2,0,3,7,0,7,4,4,2,0,3,7,0,7,4
2,4,0,4,6,3,3,2,4,0,2,4,3,1,2,1,4,0,2,4,2,0,2,1
3,0,3,0,25,17,8,0,0,3,3,0,8,5,3,0,0,3,3,0,3,2,1,0
0,0,1,1,2,0,2,0,0,1,0,1,2,0,2,0,0,1,0,1,2,0,2,0
1,4,3,0,10,3,7,0,4,3,1,0,7,2,5,0,4,3,1,0,5,1,4,0
3,1,4,0,26,18,8,0,1,4,3,0,8,5,3,0,1,4,3,0,3,2,1,0
0,4,3,4,5,0,5,4,4,3,0,4,5,0,5,4,4,3,0,4,5,0,5,4
2,2,0,4,5,2,3,2,2,0,2,4,3,1,2,1,2,0,2,4,2,0,2,1
4,1,3,0,19,17,2,0,1,3,4,0,2,1,1,0,1,3,4,0,1,0,1,0
3,3,0,3,5,3,2,1,3,0,3,3,2,1,1,0,3,0,3,3,1,0,1,0
2,4,1,1,0,0,0,0,4,1,2,1,0,0,0,0,4,1,2,1,0,0,0,0
2,3,4,3,22,10,12,8,3,4,2,3,12,6,6,4,3,4,2,3,6,3,3,2
0,1,4,1,25,2,23,6,1,4,0,1,23,2,21,6,1,4,0,1,21,2,19,5
2,4,1,1,10,4,6,1,4,1,2,1,6,3,3,0,4,1,2,1,3,1,2,0
3,4,2,2,3,2,1,0,4,2,3,2,1,0,1,0,4,2,3,2,1,0,1,0
0,4,0,2,7,0,7,3,4,0,0,2,7,0,7,3,4,0,0,2,7,0,7,3
1,1,2,0,15,4,11,1,1,2,1,0,11,3,8,0,1,2,1,0,8,2,6,0
2,0,0,1,19,9,10,2,0,0,2,1,10,4,6,1,0,0,2,1,6,3,3,0
0,3,2,4,5,0,5,4,3,2,0,4,5,0,5,4,3,2,0,4,5,0,5,4
1,3,2,4,10,2,8,7,3,2,1,4,8,2,6,5,3,2,1,4,6,1,5,4
3,1,4,4,24,16,8,7,1,4,3,4,8,5,3,2,1,4,3,4,3,2,1,0
1,1,4,3,26,7,19,13,1,4,1,3,19,5,14,9,1,4,1,3,14,4,10,6
4,0,0,3,10,9,1,0,0,0,4,3,1,0,1,0,0,0,4,3,1,0,1,0
0,1,3,4,17,1,16,14,1,3,0,4,16,1,15,13,1,3,0,4,15,1,14,12
2,1,4,0,21,10,11,1,1,4,2,0,11,5,6,0,1,4,2,0,6,2,4,0
2,2,1,1,12,6,6,1,2,1,2,1,6,3,3,0,2,1,2,1,3,1,2,0
4,3,1,3,7,6,1,0,3,1,4,3,1,0,1,0,3,1,4,3,1,0,1,0
3,2,2,1,15,10,5,1,2,2,3,1,5,3,2,0,2,2,3,1,2,1,1,0
4,2,4,4,26,23,3,2,2,4,4,4,3,2,1,0,2,4,4,4,1,0,1,0
3,1,0,2,7,4,3,1,1,0,3,2,3,2,1,0,1,0,3,2,1,0,1,0
3,1,1,2,12,8,4,2,1,1,3,2,4,2,2,1,1,1,3,2,2,1,1,0
1,0,2,2,24,7,17,8,0,2,1,2,17,5,12,5,0,2,1,2,12,3,9,4
4,0,2,2,19,17,2,1,0,2,4,2,2,1,1,0,0,2,4,2,1,0,1,0
4,1,0,4,2,1,1,0,1,0,4,4,1,0,1,0,1,0,4,4,1,0,1,0
4,2,2,1,12,10,2,0,2,2,4,1,2,1,1,0,2,2,4,1,1,0,1,0
2,2,2,4,10,5,5,4,2,2,2,4,5,2,3,2,2,2,2,4,3,1,2,1
4,3,0,4,5,4,1,0,3,0,4,4,1,0,1,0,3,0,4,4,1,0,1,0
3,2,1,4,13,9,4,3,2,1,3,4,4,2,2,1,2,1,3,4,2,1,1,0
3,4,1,1,5,3,2,0,4,1,3,1,2,1,1,0,4,1,3,1,1,0,1,0
4,3,3,0,8,7,1,0,3,3,4,0,1,0,1,0,3,3,4,0,1,0,1,0
1,2,4,1,25,7,18,5,2,4,1,1,18,5,13,3,2,4,1,1,13,3,10,2
4,3,2,4,5,4,1,0,3,2,4,4,1,0,1,0,3,2,4,4,1,0,1,0
2,3,4,1,27,13,14,4,3,4,2,1,14,6,8,2,3,4,2,1,8,4,4,1
2,3,1,4,3,1,2,1,3,1,2,4,2,0,2,1,3,1,2,4,2,0,2,1
0,2,0,3,3,0,3,2,2,0,0,3,3,0,3,2,2,0,0,3,3,0,3,2
4,3,4,0,16,14,2,0,3,4,4,0,2,1,1,0,3,4,4,0,1,0,1,0
0,3,2,4,5,0,5,4,3,2,0,4,5,0,5,4,3,2,0,4,5,0,5,4
0,0,3,1,26,2,24,7,0,3,0,1,24,2,22,6,0,3,0,1,22,2,20,5
0,1,3,1,23,2,21,6,1,3,0,1,21,2,19,5,1,3,0,1,19,1,18,5
3,3,1,2,4,2,2,1,3,1,3,2,2,1,1,0,3,1,3,2,1,0,1,0
3,4,4,1,11,7,4,1,4,4,3,1,4,2,2,0,4,4,3,1,2,1,1,0
4,1,4,3,25,22,3,2,1,4,4,3,3,2,1,0,1,4,4,3,1,0,1,0
1,1,2,2,15,4,11,5,1,2,1,2,11,3,8,3,1,2,1,2,8,2,6,3
1,0,2,2,28,8,20,9,0,2,1,2,20,5,15,7,0,2,1,2,15,4,11,5
0,1,2,2,13,1,12,5,1,2,0,2,12,1,11,5,1,2,0,2,11,1,10,5
3,0,0,0,4,2,2,0,0,0,3,0,2,1,1,0,0,0,3,0,1,0,1,0
4,0,3,0,27,24,3,0,0,3,4,0,3,2,1,0,0,3,4,0,1,0,1,0
1,3,1,2,13,3,10,5,3,1,1,2,10,2,8,3,3,1,1,2,8,2,6,3
2,3,1,1,14,6,8,2,3,1,2,1,8,4,4,1,3,1,2,1,4,2,2,0
0,3,2,3,9,0,9,6,3,2,0,3,9,0,9,6,3,2,0,3,9,0,9,6
4,2,4,2,17,15,2,0,2,4,4,2,2,1,1,0,2,4,4,2,1,0,1,0
3,4,4,2,6,4,2,0,4,4,3,2,2,1,1,0,4,4,3,2,1,0,1,0
3,2,2,4,20,13,7,6,2,2,3,4,7,4,3,2,2,2,3,4,3,2,1,0
4,4,4,0,5,4,1,0,4,4,4,0,1,0,1,0,4,4,4,0,1,0,1,0
4,4,2,4,3,2,1,0,4,2,4,4,1,0,1,0,4,2,4,4,1,0,1,0
4,2,3,2,20,18,2,0,2,3,4,2,2,1,1,0,2,3,4,2,1,0,1,0
1,1,0,3,4,1,3,2,1,0,1,3,3,0,3,2,1,0,1,3,3,0,3,2
4,4,3,2,6,5,1,0,4,3,4,2,1,0,1,0,4,3,4,2,1,0,1,0
3,4,4,4,2,1,1,0,4,4,3,4,1,0,1,0,4,4,3,4,1,0,1,0
4,0,0,1,10,8,2,0,0,0,4,1,2,1,1,0,0,0,4,1,1,0,1,0
0,2,1,4,8,0,8,7,2,1,0,4,8,0,8,7,2,1,0,4,8,0,8,7
4,4,3,3,0,0,0,0,4,3,4,3,0,0,0,0,4,3,4,3,0,0,0,0
3,2,3,1,19,13,6,1,2,3,3,1,6,4,2,0,2,3,3,1,2,1,1,0
1,0,4,1,27,8,19,5,0,4,1,1,19,5,14,4,0,4,1,1,14,4,10,3
4,4,2,3,8,7,1,0,4,2,4,3,1,0,1,0,4,2,4,3,1,0,1,0
1,4,1,2,8,2,6,2,4,1,1,2,6,1,5,2,4,1,1,2,5,1,4,2
0,3,2,2,6,0,6,3,3,2,0,2,6,0,6,2,3,2,0,2,6,0,6,2
4,4,3,4,0,0,0,0,4,3,4,4,0,0,0,0,4,3,4,4,0,0,0,0
0,2,2,4,14,1,13,11,2,2,0,4,13,1,12,10,2,2,0,4,12,1,11,9
1,4,1,4,5,1,4,3,4,1,1,4,4,1,3,2,4,1,1,4,3,0,3,2
4,3,0,0,1,0,1,0,3,0,4,0,1,0,1,0,3,0,4,0,1,0,1,0
0,2,2,3,15,1,14,9,2,2,0,3,14,1,13,9,2,2,0,3,13,1,12,8
2,1,2,1,16,7,9,2,1,2,2,1,9,4,5,1,1,2,2,1,5,2,3,0
2,0,3,1,27,13,14,4,0,3,2,1,14,7,7,2,0,3,2,1,7,3,4,1
2,3,1,0,4,2,2,0,3,1,2,0,2,1,1,0,3,1,2,0,1,0,1,0
4,0,3,3,27,24,3,2,0,3,4,3,3,2,1,0,0,3,4,3,1,0,1,0
2,0,2,4,17,8,9,8,0,2,2,4,9,4,5,4,0,2,2,4,5,2,3,2
4,4,3,0,2,1,1,0,4,3,4,0,1,0,1,0,4,3,4,0,1,0,1,0
2,0,4,0,28,13,15,1,0,4,2,0,15,7,8,0,0,4,2,0,8,3,5,0
3,2,2,0,10,7,3,0,2,2,3,0,3,2,1,0,2,2,3,0,1,0,1,0
0,4,0,2,12,1,11,5,4,0,0,2,11,1,10,5,4,0,0,2,10,0,10,4
4,1,4,3,25,22,3,2,1,4,4,3,3,2,1,0,1,4,4,3,1,0,1,0
1,3,2,1,10,3,7,2,3,2,1,1,7,2,5,1,3,2,1,1,5,1,4,1
2,0,0,4,12,6,6,5,0,0,2,4,6,2,4,3,0,0,2,4,4,1,3,2
1,1,2,3,23,6,17,11,1,2,1,3,17,5,12,8,1,2,1,3,12,3,9,6
4,2,0,4,1,0,1,0,2,0,4,4,1,0,1,0,2,0,4,4,1,0,1,0
3,3,4,1,11,7,4,1,3,4,3,1,4,2,2,0,3,4,3,1,2,1,1,0
4,3,4,3,11,9,2,1,3,4,4,3,2,1,1,0,3,4,4,3,1,0,1,0
4,1,4,0,28,25,3,0,1,4,4,0,3,2,1,0,1,4,4,0,1,0,1,0
3,0,4,4,28,19,9,8,0,4,3,4,9,6,3,2,0,4,3,4,3,2,1,0
1,3,2,1,7,2,5,1,3,2,1,1,5,1,4,1,3,2,1,1,4,1,3,0
0,4,0,4,3,0,3,2,4,0,0,4,3,0,3,2,4,0,0,4,3,0,3,2
1,0,1,1,12,3,9,2,0,1,1,1,9,2,7,2,0,1,1,1,7,2,5,1
0,4,2,4,8,0,8,7,4,2,0,4,8,0,8,7,4,2,0,4,8,0,8,7
2,4,1,4,2,1,1,0,4,1,2,4,1,0,1,0,4,1,2,4,1,0,1,0
2,1,3,4,23,11,12,10,1,3,2,4,12,5,7,6,1,3,2,4,7,3,4,3
4,3,4,4,13,11,2,1,3,4,4,4,2,1,1,0,3,4,4,4,1,0,1,0
0,4,3,0,4,0,4,0,4,3,0,0,4,0,4,0,4,3,0,0,4,0,4,0
3,0,2,3,26,18,8,5,0,2,3,3,8,5,3,2,0,2,3,3,3,2,1,0
2,4,0,4,4,1,3,2,4,0,2,4,3,1,2,1,4,0,2,4,2,1,1,0
4,3,4,0,13,11,2,0,3,4,4,0,2,1,1,0,3,4,4,0,1,0,1,0
4,2,4,2,23,20,3,1,2,4,4,2,3,2,1,0,2,4,4,2,1,0,1,0
2,3,1,2,6,2,4,1,3,1,2,2,4,1,3,1,3,1,2,2,3,1,2,1
0,3,0,0,2,0,2,0,3,0,0,0,2,0,2,0,3,0,0,0,2,0,2,0
0,0,1,1,17,1,16,4,0,1,0,1,16,1,15,4,0,1,0,1,15,1,14,4
4,1,3,1,25,22,3,0,1,3,4,1,3,2,1,0,1,3,4,1,1,0,1,0
3,1,2,2,14,9,5,2,1,2,3,2,5,3,2,0,1,2,3,2,2,1,1,0
4,2,2,0,10,8,2,0,2,2,4,0,2,1,1,0,2,2,4,0,1,0,1,0
1,1,2,0,9,2,7,0,1,2,1,0,7,2,5,0,1,2,1,0,5,1,4,0
2,2,0,1,14,6,8,2,2,0,2,1,8,4,4,1,2,0,2,1,4,2,2,0
3,1,1,3,16,11,5,3,1,1,3,3,5,3,2,1,1,1,3,3,2,1,1,0
0,2,0,4,5,0,5,4,2,0,0,4,5,0,5,4,2,0,0,4,5,0,5,4
0,0,4,2,27,2,25,12,0,4,0,2,25,2,23,11,0,4,0,2,23,2,21,10
0,2,2,1,17,1,16,4,2,2,0,1,16,1,15,4,2,2,0,1,15,1,14,4
0,4,2,2,0,0,0,0,4,2,0,2,0,0,0,0,4,2,0,2,0,0,0,0
0,4,3,3,7,0,7,4,4,3,0,3,7,0,7,4,4,3,0,3,7,0,7,4
3,4,2,0,11,7,4,0,4,2,3,0,4,2,2,0,4,2,3,0,2,1,1,0
4,3,0,1,8,7,1,0,3,0,4,1,1,0,1,0,3,0,4,1,1,0,1,0
3,2,4,3,20,14,6,4,2,4,3,3,6,4,2,1,2,4,3,3,2,1,1,0
1,1,1,2,8,2,6,3,1,1,1,2,6,1,5,2,1,1,1,2,5,1,4,1
0,0,1,1,15,1,14,4,0,1,0,1,14,1,13,3,0,1,0,1,13,1,12,3
4,3,1,0,6,5,1,0,3,1,4,0,1,0,1,0,3,1,4,0,1,0,1,0
3,4,2,2,7,4,3,1,4,2,3,2,3,2,1,0,4,2,3,2,1,0,1,0
4,4,2,1,1,0,1,0,4,2,4,1,1,0,1,0,4,2,4,1,1,0,1,0
4,3,3,2,17,15,2,0,3,3,4,2,2,1,1,0,3,3,4,2,1,0,1,0
0,1,2,2,21,2,19,9,1,2,0,2,19,1,18,8,1,2,0,2,18,1,17,8
1,1,0,2,15,4,11,5,1,0,1,2,11,3,8,4,1,0,1,2,8,2,6,2
2,2,1,3,7,3,4,2,2,1,2,3,4,1,3,2,2,1,2,3,3,1,2,1
1,3,1,1,8,2,6,1,3,1,1,1,6,1,5,1,3,1,1,1,5,1,4,1
4,4,4,4,3,2,1,0,4,4,4,4,1,0,1,0,4,4,4,4,1,0,1,0
4,1,3,2,18,16,2,0,1,3,4,2,2,1,1,0,1,3,4,2,1,0,1,0
2,1,1,3,11,5,6,4,1,1,2,3,6,2,4,2,1,1,2,3,4,2,2,1
2,1,4,4,24,12,12,10,1,4,2,4,12,5,7,6,1,4,2,4,7,3,4,3
1,2,3,2,21,6,15,7,2,3,1,2,15,4,11,5,2,3,1,2,11,3,8,3
0,3,1,2,1,0,1,0,3,1,0,2,1,0,1,0,3,1,0,2,1,0,1,0
4,0,4,0,27,24,3,0,0,4,4,0,3,2,1,0,0,4,4,0,1,0,1,0
3,4,2,4,1,0,1,0,4,2,3,4,1,0,1,0,4,2,3,4,1,0,1,0
1,2,3,3,16,4,12,8,2,3,1,3,12,3,9,6,2,3,1,3,9,2,7,4
4,1,2,2,18,16,2,1,1,2,4,2,2,1,1,0,1,2,4,2,1,0,1,0
0,4,2,1,5,0,5,1,4,2,0,1,5,0,5,1,4,2,0,1,5,0,5,1
0,0,1,2,15,1,14,7,0,1,0,2,14,1,13,6,0,1,0,2,13,1,12,5
4,1,2,0,22,19,3,0,1,2,4,0,3,2,1,0,1,2,4,0,1,0,1,0
0,1,1,3,9,0,9,6,1,1,0,3,9,0,9,6,1,1,0,3,9,0,9,6
2,1,0,3,10,5,5,3,1,0,2,3,5,2,3,2,1,0,2,3,3,1,2,1
2,1,1,3,10,5,5,3,1,1,2,3,5,2,3,2,1,1,2,3,3,1,2,1
0,4,0,4,4,0,4,3,4,0,0,4,4,0,4,3,4,0,0,4,4,0,4,3
3,2,0,3,14,9,5,3,2,0,3,3,5,3,2,1,2,0,3,3,2,1,1,0
0,0,0,4,4,0,4,3,0,0,0,4,4,0,4,3,0,0,0,4,4,0,4,3
1,2,2,1,6,1,5,1,2,2,1,1,5,1,4,1,2,2,1,1,4,1,3,0
0,4,2,3,4,0,4,2,4,2,0,3,4,0,4,2,4,2,0,3,4,0,4,2
3,0,0,3,15,10,5,3,0,0,3,3,5,3,2,1,0,0,3,3,2,1,1,0
3,4,2,4,11,7,4,3,4,2,3,4,4,2,2,1,4,2,3,4,2,1,1,0
4,3,2,0,8,7,1,0,3,2,4,0,1,0,1,0,3,2,4,0,1,0,1,0
0,0,2,1,21,2,19,5,0,2,0,1,19,1,18,5,0,2,0,1,18,1,17,5
3,1,3,0,21,14,7,0,1,3,3,0,7,4,3,0,1,3,3,0,3,2,1,0
2,0,2,0,11,5,6,0,0,2,2,0,6,3,3,0,0,2,2,0,3,1,2,0
1,4,4,0,0,0,0,0,4,4,1,0,0,0,0,0,4,4,1,0,0,0,0,0
1,2,2,2,14,4,10,4,2,2,1,2,10,3,7,3,2,2,1,2,7,2,5,2
2,2,2,0,9,4,5,0,2,2,2,0,5,2,3,0,2,2,2,0,3,1,2,0
4,0,2,1,13,11,2,0,0,2,4,1,2,1,1,0,0,2,4,1,1,0,1,0
1,1,0,4,9,2,7,6,1,0,1,4,7,2,5,4,1,0,1,4,5,1,4,3
1,0,3,3,25,7,18,12,0,3,1,3,18,5,13,9,0,3,1,3,13,3,10,6
1,0,4,2,29,8,21,10,0,4,1,2,21,6,15,7,0,4,1,2,15,4,11,5
1,0,4,3,25,7,18,12,0,4,1,3,18,5,13,9,0,4,1,3,13,3,10,7
3,1,0,3,2,1,1,0,1,0,3,3,1,0,1,0,1,0,3,3,1,0,1,0
1,2,4,3,15,4,11,7,2,4,1,3,11,3,8,5,2,4,1,3,8,2,6,4
4,4,3,2,8,7,1,0,4,3,4,2,1,0,1,0,4,3,4,2,1,0,1,0
2,4,2,1,0,0,0,0,4,2,2,1,0,0,0,0,4,2,2,1,0,0,0,0
4,3,1,3,5,4,1,0,3,1,4,3,1,0,1,0,3,1,4,3,1,0,1,0
0,4,1,0,0,0,0,0,4,1,0,0,0,0,0,0,4,1,0,0,0,0,0,0
4,4,2,0,3,2,1,0,4,2,4,0,1,0,1,0,4,2,4,0,1,0,1,0
3,1,4,0,20,14,6,0,1,4,3,0,6,4,2,0,1,4,3,0,2,1,1,0
0,0,2,3,25,2,23,16,0,2,0,3,23,2,21,14,0,2,0,3,21,2,19,13
3,4,2,1,5,3,2,0,4,2,3,1,2,1,1,0,4,2,3,1,1,0,1,0
3,2,1,4,8,5,3,2,2,1,3,4,3,2,1,0,2,1,3,4,1,0,1,0
2,4,1,2,3,1,2,1,4,1,2,2,2,0,2,0,4,1,2,2,2,0,2,0
0,3,0,3,7,0,7,4,3,0,0,3,7,0,7,4,3,0,0,3,7,0,7,4
4,1,2,4,19,17,2,1,1,2,4,4,2,1,1,0,1,2,4,4,1,0,1,0
3,2,3,2,7,4,3,1,2,3,3,2,3,2,1,0,2,3,3,2,1,0,1,0
4,2,1,2,12,10,2,0,2,1,4,2,2,1,1,0,2,1,4,2,1,0,1,0
4,3,0,0,1,0,1,0,3,0,4,0,1,0,1,0,3,0,4,0,1,0,1,0
0,4,0,4,5,0,5,4,4,0,0,4,5,0,5,4,4,0,0,4,5,0,5,4
0,3,2,1,16,1,15,4,3,2,0,1,15,1,14,4,3,2,0,1,14,1,13,3
4,1,2,2,12,10,2,1,1,2,4,2,2,1,1,0,1,2,4,2,1,0,1,0
1,0,3,4,27,8,19,17,0,3,1,4,19,5,14,12,0,3,1,4,14,4,10,8
1,3,1,0,5,1,4,0,3,1,1,0,4,1,3,0,3,1,1,0,3,0,3,0
4,2,0,3,0,0,0,0,2,0,4,3,0,0,0,0,2,0,4,3,0,0,0,0
0,1,1,4,13,1,12,10,1,1,0,4,12,1,11,9,1,1,0,4,11,1,10,9
0,0,3,4,24,2,22,19,0,3,0,4,22,2,20,17,0,3,0,4,20,1,19,17
3,3,0,1,3,2,1,0,3,0,3,1,1,0,1,0,3,0,3,1,1,0,1,0
2,2,3,0,7,3,4,0,2,3,2,0,4,1,3,0,2,3,2,0,3,1,2,0
3,3,2,1,10,6,4,1,3,2,3,1,4,2,2,0,3,2,3,1,2,1,1,0
0,0,2,2,20,2,18,8,0,2,0,2,18,1,17,8,0,2,0,2,17,1,16,8
1,0,2,2,20,5,15,7,0,2,1,2,15,4,11,5,0,2,1,2,11,3,8,3
0,2,2,2,11,1,10,5,2,2,0,2,10,0,10,5,2,2,0,2,10,1,9,4
2,3,1,0,8,4,4,0,3,1,2,0,4,2,2,0,3,1,2,0,2,0,2,0
3,3,2,0,9,6,3,0,3,2,3,0,3,2,1,0,3,2,3,0,1,0,1,0
1,1,2,2,11,3,8,3,1,2,1,2,8,2,6,2,1,2,1,2,6,1,5,2
0,0,2,0,21,2,19,1,0,2,0,0,19,1,18,1,0,2,0,0,18,1,17,1
4,3,1,4,6,5,1,0,3,1,4,4,1,0,1,0,3,1,4,4,1,0,1,0
0,1,2,4,21,2,19,17,1,2,0,4,19,1,18,16,1,2,0,4,18,1,17,15
1,2,4,3,19,5,14,9,2,4,1,3,14,4,10,7,2,4,1,3,10,3,7,4
1,0,2,1,19,5,14,4,0,2,1,1,14,4,10,2,0,2,1,1,10,2,8,2
3,3,2,3,20,14,6,4,3,2,3,3,6,4,2,1,3,2,3,3,2,1,1,0
4,4,2,3,2,1,1,0,4,2,4,3,1,0,1,0,4,2,4,3,1,0,1,0
0,0,3,4,25,2,23,20,0,3,0,4,23,2,21,18,0,3,0,4,21,2,19,17
1,3,3,4,24,7,17,15,3,3,1,4,17,5,12,10,3,3,1,4,12,3,9,8
1,3,0,2,2,0,2,0,3,0,1,2,2,0,2,1,3,0,1,2,2,0,2,0
0,1,0,0,8,0,8,0,1,0,0,0,8,0,8,0,1,0,0,0,8,0,8,0
1,3,2,2,6,1,5,2,3,2,1,2,5,1,4,1,3,2,1,2,4,1,3,1
2,1,3,2,27,13,14,7,1,3,2,2,14,6,8,3,1,3,2,2,8,3,5,2
4,1,4,2,26,23,3,1,1,4,4,2,3,2,1,0,1,4,4,2,1,0,1,0
2,3,1,1,9,4,5,1,3,1,2,1,5,2,3,0,3,1,2,1,3,1,2,0
1,4,4,2,6,1,5,2,4,4,1,2,5,1,4,2,4,4,1,2,4,1,3,1
3,4,2,0,2,1,1,0,4,2,3,0,1,0,1,0,4,2,3,0,1,0,1,0
3,3,0,0,7,4,3,0,3,0,3,0,3,2,1,0,3,0,3,0,1,0,1,0
4,0,3,2,22,19,3,1,0,3,4,2,3,2,1,0,0,3,4,2,1,0,1,0
3,2,0,0,8,5,3,0,2,0,3,0,3,2,1,0,2,0,3,0,1,0,1,0
1,3,3,3,8,2,6,4,3,3,1,3,6,1,5,3,3,3,1,3,5,1,4,2
2,2,4,1,29,14,15,4,2,4,2,1,15,7,8,2,2,4,2,1,8,3,5,1
1,2,0,3,8,2,6,4,2,0,1,3,6,1,5,3,2,0,1,3,5,1,4,2
1,0,2,4,28,8,20,18,0,2,1,4,20,5,15,13,0,2,1,4,15,4,11,9
0,2,4,2,23,2,21,10,2,4,0,2,21,2,19,9,2,4,0,2,19,1,18,8
0,4,3,1,7,0,7,2,4,3,0,1,7,0,7,2,4,3,0,1,7,0,7,2
1,3,0,0,1,0,1,0,3,0,1,0,1,0,1,0,3,0,1,0,1,0,1,0
2,0,3,4,27,13,14,12,0,3,2,4,14,6,8,7,0,3,2,4,8,4,4,3
4,1,1,1,21,18,3,0,1,1,4,1,3,2,1,0,1,1,4,1,1,0,1,0
3,3,4,0,10,6,4,0,3,4,3,0,4,2,2,0,3,4,3,0,2,1,1,0
1,2,3,3,19,5,14,9,2,3,1,3,14,4,10,6,2,3,1,3,10,2,8,5
4,0,0,4,5,4,1,0,0,0,4,4,1,0,1,0,0,0,4,4,1,0,1,0
2,3,3,0,10,5,5,0,3,3,2,0,5,2,3,0,3,3,2,0,3,1,2,0
2,1,3,2,21,10,11,5,1,3,2,2,11,5,6,3,1,3,2,2,6,2,4,2
3,1,3,0,20,13,7,0,1,3,3,0,7,4,3,0,1,3,3,0,3,2,1,0
0,4,4,3,14,1,13,9,4,4,0,3,13,1,12,8,4,4,0,3,12,1,11,7
0,1,3,2,12,1,11,5,1,3,0,2,11,1,10,4,1,3,0,2,10,0,10,5
2,2,0,2,6,2,4,2,2,0,2,2,4,2,2,1,2,0,2,2,2,0,2,0
4,4,2,1,7,6,1,0,4,2,4,1,1,0,1,0,4,2,4,1,1,0,1,0
4,3,0,2,6,5,1,0,3,0,4,2,1,0,1,0,3,0,4,2,1,0,1,0
1,3,1,1,6,1,5,1,3,1,1,1,5,1,4,1,3,1,1,1,4,1,3,0
0,2,3,0,22,2,20,2,2,3,0,0,20,2,18,1,2,3,0,0,18,1,17,1
0,3,3,4,5,0,5,4,3,3,0,4,5,0,5,4,3,3,0,4,5,0,5,4
0,3,0,4,6,0,6,5,3,0,0,4,6,0,6,5,3,0,0,4,6,0,6,5
4,0,0,1,5,4,1,0,0,0,4,1,1,0,1,0,0,0,4,1,1,0,1,0
3,1,3,4,16,11,5,4,1,3,3,4,5,3,2,1,1,3,3,4,2,1,1,0
3,1,2,4,13,9,4,3,1,2,3,4,4,2,2,1,1,2,3,4,2,1,1,0
4,2,0,1,3,2,1,0,2,0,4,1,1,0,1,0,2,0,4,1,1,0,1,0
4,0,3,3,24,21,3,2,0,3,4,3,3,2,1,0,0,3,4,3,1,0,1,0
4,1,0,1,7,6,1,0,1,0,4,1,1,0,1,0,1,0,4,1,1,0,1,0
0,3,1,0,2,0,2,0,3,1,0,0,2,0,2,0,3,1,0,0,2,0,2,0
0,2,2,3,16,1,15,10,2,2,0,3,15,1,14,9,2,2,0,3,14,1,13,9
0,3,1,2,11,1,10,4,3,1,0,2,10,1,9,4,3,1,0,2,9,0,9,4
3,4,1,1,2,1,1,0,4,1,3,1,1,0,1,0,4,1,3,1,1,0,1,0
2,2,0,4,1,0,1,0,2,0,2,4,1,0,1,0,2,0,2,4,1,0,1,0
4,0,0,3,1,0,1,0,0,0,4,3,1,0,1,0,0,0,4,3,1,0,1,0
4,3,0,0,1,0,1,0,3,0,4,0,1,0,1,0,3,0,4,0,1,0,1,0
4,4,3,3,8,7,1,0,4,3,4,3,1,0,1,0,4,3,4,3,1,0,1,0
1,2,0,0,1,0,1,0,2,0,1,0,1,0,1,0,2,0,1,0,1,0,1,0
4,3,0,0,2,1,1,0,3,0,4,0,1,0,1,0,3,0,4,0,1,0,1,0
1,4,4,3,3,0,3,2,4,4,1,3,3,0,3,2,4,4,1,3,3,0,3,2
2,4,3,2,4,1,3,1,4,3,2,2,3,1,2,1,4,3,2,2,2,0,2,0
2,3,3,4,4,1,3,2,3,3,2,4,3,1,2,1,3,3,2,4,2,1,1,0
2,4,2,3,9,4,5,3,4,2,2,3,5,2,3,2,4,2,2,3,3,1,2,1
2,2,4,4,16,8,8,7,2,4,2,4,8,4,4,3,2,4,2,4,4,2,2,1
0,3,1,2,6,0,6,3,3,1,0,2,6,0,6,2,3,1,0,2,6,0,6,3
1,4,3,3,4,1,3,2,4,3,1,3,3,0,3,2,4,3,1,3,3,0,3,2
4,3,2,2,7,6,1,0,3,2,4,2,1,0,1,0,3,2,4,2,1,0,1,0
1,4,4,4,2,0,2,1,4,4,1,4,2,0,2,1,4,4,1,4,2,0,2,1
0,0,0,4,1,0,1,0,0,0,0,4,1,0,1,0,0,0,0,4,1,0,1,0
3,4,2,2,3,2,1,0,4,2,3,2,1,0,1,0,4,2,3,2,1,0,1,0
1,1,2,2,23,6,17,8,1,2,1,2,17,5,12,5,1,2,1,2,12,3,9,4
4,2,3,3,20,17,3,2,2,3,4,3,3,2,1,0,2,3,4,3,1,0,1,0
4,3,0,3,7,6,1,0,3,0,4,3,1,0,1,0,3,0,4,3,1,0,1,0
1,3,0,0,1,0,1,0,3,0,1,0,1,0,1,0,3,0,1,0,1,0,1,0
2,3,1,4,7,3,4,3,3,1,2,4,4,2,2,1,3,1,2,4,2,1,1,0
2,2,2,2,16,8,8,4,2,2,2,2,8,3,5,2,2,2,2,2,5,2,3,1
4,3,3,4,11,9,2,1,3,3,4,4,2,1,1,0,3,3,4,4,1,0,1,0
1,0,0,1,7,2,5,1,0,0,1,1,5,1,4,1,0,0,1,1,4,1,3,0
2,0,2,1,24,12,12,3,0,2,2,1,12,6,6,1,0,2,2,1,6,3,3,0
4,4,4,3,2,1,1,0,4,4,4,3,1,0,1,0,4,4,4,3,1,0,1,0
4,3,3,4,13,11,2,1,3,3,4,4,2,1,1,0,3,3,4,4,1,0,1,0
0,3,3,0,19,1,18,1,3,3,0,0,18,1,17,1,3,3,0,0,17,1,16,1
2,4,4,2,5,2,3,1,4,4,2,2,3,1,2,0,4,4,2,2,2,1,1,0
3,3,1,3,3,2,1,0,3,1,3,3,1,0,1,0,3,1,3,3,1,0,1,0
2,1,0,4,6,2,4,3,1,0,2,4,4,1,3,2,1,0,2,4,3,1,2,1
0,4,4,4,10,0,10,8,4,4,0,4,10,1,9,8,4,4,0,4,9,0,9,8
4,4,3,1,3,2,1,0,4,3,4,1,1,0,1,0,4,3,4,1,1,0,1,0
4,1,2,1,19,17,2,0,1,2,4,1,2,1,1,0,1,2,4,1,1,0,1,0
1,0,1,2,16,4,12,6,0,1,1,2,12,3,9,4,0,1,1,2,9,2,7,3
2,3,1,2,1,0,1,0,3,1,2,2,1,0,1,0,3,1,2,2,1,0,1,0
0,0,1,0,14,1,13,1,0,1,0,0,13,1,12,1,0,1,0,0,12,1,11,1
4,0,2,0,24,21,3,0,0,2,4,0,3,2,1,0,0,2,4,0,1,0,1,0
1,0,2,3,23,6,17,11,0,2,1,3,17,5,12,8,0,2,1,3,12,3,9,6
3,3,2,0,5,3,2,0,3,2,3,0,2,1,1,0,3,2,3,0,1,0,1,0
2,1,3,3,22,10,12,8,1,3,2,3,12,5,7,4,1,3,2,3,7,3,4,2
1,4,2,0,7,2,5,0,4,2,1,0,5,1,4,0,4,2,1,0,4,1,3,0
0,3,3,4,6,0,6,5,3,3,0,4,6,0,6,5,3,3,0,4,6,0,6,5
3,1,1,3,14,9,5,3,1,1,3,3,5,3,2,1,1,1,3,3,2,1,1,0
4,4,0,2,3,2,1,0,4,0,4,2,1,0,1,0,4,0,4,2,1,0,1,0
1,1,4,0,25,7,18,1,1,4,1,0,18,5,13,1,1,4,1,0,13,3,10,0
2,2,2,1,14,7,7,2,2,2,2,1,7,3,4,1,2,2,2,1,4,1,3,0
0,4,0,1,7,0,7,2,4,0,0,1,7,0,7,2,4,0,0,1,7,0,7,2
2,0,4,3,25,12,13,9,0,4,2,3,13,6,7,4,0,4,2,3,7,3,4,2
4,0,0,1,12,10,2,0,0,0,4,1,2,1,1,0,0,0,4,1,1,0,1,0
0,3,0,2,6,0,6,2,3,0,0,2,6,0,6,2,3,0,0,2,6,0,6,2
2,4,1,3,4,2,2,1,4,1,2,3,2,0,2,1,4,1,2,3,2,0,2,1
1,4,3,0,6,1,5,0,4,3,1,0,5,1,4,0,4,3,1,0,4,1,3,0
2,2,3,2,15,7,8,3,2,3,2,2,8,4,4,1,2,3,2,2,4,2,2,1
0,3,4,3,14,1,13,9,3,4,0,3,13,1,12,8,3,4,0,3,12,1,11,7
4,3,1,1,5,4,1,0,3,1,4,1,1,0,1,0,3,1,4,1,1,0,1,0
0,4,4,3,6,0,6,4,4,4,0,3,6,0,6,4,4,4,0,3,6,0,6,4
3,0,2,1,23,16,7,2,0,2,3,1,7,4,3,0,0,2,3,1,3,2,1,0
3,0,0,4,14,9,5,4,0,0,3,4,5,3,2,1,0,0,3,4,2,1,1,0
4,0,1,2,16,14,2,0,0,1,4,2,2,1,1,0,0,1,4,2,1,0,1,0
4,0,3,0,29,26,3,0,0,3,4,0,3,2,1,0,0,3,4,0,1,0,1,0
2,2,1,3,9,4,5,3,2,1,2,3,5,2,3,2,2,1,2,3,3,1,2,1
3,0,2,4,20,14,6,5,0,2,3,4,6,4,2,1,0,2,3,4,2,1,1,0
0,3,0,2,0,0,0,0,3,0,0,2,0,0,0,0,3,0,0,2,0,0,0,0
4,4,2,4,4,3,1,0,4,2,4,4,1,0,1,0,4,2,4,4,1,0,1,0
0,0,1,3,10,1,9,6,0,1,0,3,9,0,9,6,0,1,0,3,9,0,9,6
4,4,0,2,0,0,0,0,4,0,4,2,0,0,0,0,4,0,4,2,0,0,0,0
1,4,1,0,9,2,7,0,4,1,1,0,7,2,5,0,4,1,1,0,5,1,4,0
4,0,1,1,13,11,2,0,0,1,4,1,2,1,1,0,0,1,4,1,1,0,1,0
0,0,3,4,28,2,26,23,0,3,0,4,26,2,24,21,0,3,0,4,24,2,22,19
0,2,3,3,18,1,17,11,2,3,0,3,17,1,16,11,2,3,0,3,16,1,15,10
1,4,3,4,2,0,2,1,4,3,1,4,2,0,2,1,4,3,1,4,2,0,2,1
4,0,0,4,0,0,0,0,0,0,4,4,0,0,0,0,0,0,4,4,0,0,0,0
1,1,4,4,28,8,20,18,1,4,1,4,20,5,15,13,1,4,1,4,15,4,11,9
4,0,3,3,22,19,3,2,0,3,4,3,3,2,1,0,0,3,4,3,1,0,1,0
2,3,1,1,13,6,7,2,3,1,2,1,7,3,4,1,3,1,2,1,4,1,3,0
4,3,2,1,11,9,2,0,3,2,4,1,2,1,1,0,3,2,4,1,1,0,1,0
0,4,1,3,3,0,3,2,4,1,0,3,3,0,3,2,4,1,0,3,3,0,3,2
1,2,3,3,18,5,13,9,2,3,1,3,13,3,10,7,2,3,1,3,10,2,8,5
4,1,2,4,17,15,2,1,1,2,4,4,2,1,1,0,1,2,4,4,1,0,1,0
0,2,1,2,24,2,22,10,2,1,0,2,22,2,20,9,2,1,0,2,20,1,19,9
3,3,0,3,8,5,3,2,3,0,3,3,3,2,1,0,3,0,3,3,1,0,1,0
4,2,0,0,10,8,2,0,2,0,4,0,2,1,1,0,2,0,4,0,1,0,1,0
0,4,2,2,9,0,9,4,4,2,0,2,9,0,9,4,4,2,0,2,9,0,9,4
2,3,1,2,1,0,1,0,3,1,2,2,1,0,1,0,3,1,2,2,1,0,1,0
3,2,0,0,0,0,0,0,2,0,3,0,0,0,0,0,2,0,3,0,0,0,0,0
2,4,1,4,3,1,2,1,4,1,2,4,2,1,1,0,4,1,2,4,1,0,1,0
3,2,1,1,10,6,4,1,2,1,3,1,4,2,2,0,2,1,3,1,2,1,1,0
2,2,0,2,2,0,2,0,2,0,2,2,2,1,1,0,2,0,2,2,1,0,1,0
0,3,4,0,10,0,10,0,3,4,0,0,10,0,10,1,3,4,0,0,10,1,9,0
0,2,1,4,9,0,9,8,2,1,0,4,9,0,9,8,2,1,0,4,9,0,9,8
3,2,1,2,5,3,2,0,2,1,3,2,2,1,1,0,2,1,3,2,1,0,1,0
2,3,0,2,8,3,5,2,3,0,2,2,5,2,3,1,3,0,2,2,3,1,2,1
1,3,3,3,8,2,6,4,3,3,1,3,6,1,5,3,3,3,1,3,5,1,4,2
4,2,0,3,1,0,1,0,2,0,4,3,1,0,1,0,2,0,4,3,1,0,1,0
3,4,2,0,5,3,2,0,4,2,3,0,2,1,1,0,4,2,3,0,1,0,1,0
4,1,4,1,24,21,3,0,1,4,4,1,3,2,1,0,1,4,4,1,1,0,1,0
3,2,3,4,12,8,4,3,2,3,3,4,4,2,2,1,2,3,3,4,2,1,1,0
1,4,3,0,0,0,0,0,4,3,1,0,0,0,0,0,4,3,1,0,0,0,0,0
3,1,0,4,2,1,1,0,1,0,3,4,1,0,1,0,1,0,3,4,1,0,1,0
1,4,0,3,1,0,1,0,4,0,1,3,1,0,1,0,4,0,1,3,1,0,1,0
2,0,0,1,4,2,2,0,0,0,2,1,2,0,2,0,0,0,2,1,2,1,1,0
2,2,2,4,5,2,3,2,2,2,2,4,3,1,2,1,2,2,2,4,2,1,1,0
1,2,1,3,7,2,5,3,2,1,1,3,5,1,4,2,2,1,1,3,4,1,3,2
4,1,2,1,9,8,1,0,1,2,4,1,1,0,1,0,1,2,4,1,1,0,1,0
1,0,3,4,24,7,17,15,0,3,1,4,17,5,12,10,0,3,1,4,12,3,9,8
0,3,0,3,0,0,0,0,3,0,0,3,0,0,0,0,3,0,0,3,0,0,0,0
0,0,2,0,18,1,17,1,0,2,0,0,17,1,16,1,0,2,0,0,16,1,15,1
1,1,0,0,3,0,3,0,1,0,1,0,3,0,3,0,1,0,1,0,3,0,3,0
1,2,3,3,19,5,14,9,2,3,1,3,14,4,10,6,2,3,1,3,10,3,7,4
2,1,1,3,9,4,5,3,1,1,2,3,5,2,3,2,1,1,2,3,3,1,2,1
1,0,0,1,4,1,3,0,0,0,1,1,3,0,3,0,0,0,1,1,3,0,3,0
4,0,0,3,10,8,2,1,0,0,4,3,2,1,1,0,0,0,4,3,1,0,1,0
1,3,4,1,21,6,15,4,3,4,1,1,15,4,11,3,3,4,1,1,11,3,8,2
2,3,2,4,18,9,9,8,3,2,2,4,9,4,5,4,3,2,2,4,5,2,3,2
4,2,2,4,7,6,1,0,2,2,4,4,1,0,1,0,2,2,4,4,1,0,1,0
1,1,0,2,0,0,0,0,1,0,1,2,0,0,0,0,1,0,1,2,0,0,0,0
0,4,3,0,6,0,6,0,4,3,0,0,6,0,6,0,4,3,0,0,6,0,6,0
2,4,1,3,3,1,2,1,4,1,2,3,2,0,2,1,4,1,2,3,2,0,2,1
3,0,2,1,19,13,6,1,0,2,3,1,6,4,2,0,0,2,3,1,2,1,1,0
3,2,1,4,8,5,3,2,2,1,3,4,3,2,1,0,2,1,3,4,1,0,1,0
0,2,1,0,15,1,14,1,2,1,0,0,14,1,13,1,2,1,0,0,13,1,12,1
0,3,0,2,4,0,4,2,3,0,0,2,4,0,4,1,3,0,0,2,4,0,4,1
2,0,1,0,16,8,8,0,0,1,2,0,8,3,5,0,0,1,2,0,5,2,3,0
4,0,4,2,21,18,3,1,0,4,4,2,3,2,1,0,0,4,4,2,1,0,1,0
3,3,4,0,16,11,5,0,3,4,3,0,5,3,2,0,3,4,3,0,2,1,1,0
4,3,3,4,12,10,2,1,3,3,4,4,2,1,1,0,3,3,4,4,1,0,1,0
1,0,4,1,24,7,17,5,0,4,1,1,17,5,12,3,0,4,1,1,12,3,9,2
4,2,2,1,17,15,2,0,2,2,4,1,2,1,1,0,2,2,4,1,1,0,1,0
2,3,2,2,2,1,1,0,3,2,2,2,1,0,1,0,3,2,2,2,1,0,1,0
0,4,3,0,6,0,6,0,4,3,0,0,6,0,6,0,4,3,0,0,6,0,6,0
2,0,3,4,26,13,13,11,0,3,2,4,13,6,7,6,0,3,2,4,7,3,4,3
0,1,1,4,13,1,12,10,1,1,0,4,12,1,11,9,1,1,0,4,11,1,10,8
3,2,1,4,5,3,2,1,2,1,3,4,2,1,1,0,2,1,3,4,1,0,1,0
1,3,4,1,12,3,9,2,3,4,1,1,9,2,7,2,3,4,1,1,7,2,5,1
3,2,2,0,15,10,5,0,2,2,3,0,5,3,2,0,2,2,3,0,2,1,1,0
1,1,4,2,29,8,21,10,1,4,1,2,21,6,15,7,1,4,1,2,15,4,11,5
3,2,1,4,5,3,2,1,2,1,3,4,2,1,1,0,2,1,3,4,1,0,1,0
4,2,3,4,18,16,2,1,2,3,4,4,2,1,1,0,2,3,4,4,1,0,1,0
4,2,0,3,2,1,1,0,2,0,4,3,1,0,1,0,2,0,4,3,1,0,1,0
2,1,4,4,25,12,13,11,1,4,2,4,13,6,7,6,1,4,2,4,7,3,4,3
1,4,4,3,8,2,6,4,4,4,1,3,6,1,5,3,4,4,1,3,5,1,4,2
3,4,1,2,5,3,2,1,4,1,3,2,2,1,1,0,4,1,3,2,1,0,1,0
3,2,4,0,11,7,4,0,2,4,3,0,4,2,2,0,2,4,3,0,2,1,1,0
0,4,0,3,2,0,2,1,4,0,0,3,2,0,2,1,4,0,0,3,2,0,2,1
4,3,0,0,9,8,1,0,3,0,4,0,1,0,1,0,3,0,4,0,1,0,1,0
3,2,2,2,11,7,4,1,2,2,3,2,4,2,2,1,2,2,3,2,2,1,1,0
0,3,1,1,4,0,4,1,3,1,0,1,4,0,4,1,3,1,0,1,4,0,4,1
0,1,2,0,22,2,20,1,1,2,0,0,20,1,19,1,1,2,0,0,19,1,18,1
2,0,3,3,24,11,13,9,0,3,2,3,13,6,7,4,0,3,2,3,7,3,4,2
3,0,3,4,29,20,9,8,0,3,3,4,9,6,3,2,0,3,3,4,3,2,1,0
4,3,3,2,7,6,1,0,3,3,4,2,1,0,1,0,3,3,4,2,1,0,1,0
4,1,4,2,29,26,3,1,1,4,4,2,3,2,1,0,1,4,4,2,1,0,1,0
4,1,2,0,21,18,3,0,1,2,4,0,3,2,1,0,1,2,4,0,1,0,1,0
0,4,1,1,6,0,6,1,4,1,0,1,6,0,6,1,4,1,0,1,6,0,6,1
4,3,3,2,9,8,1,0,3,3,4,2,1,0,1,0,3,3,4,2,1,0,1,0
4,4,2,0,11,9,2,0,4,2,4,0,2,1,1,0,4,2,4,0,1,0,1,0
2,0,0,3,8,4,4,2,0,0,2,3,4,1,3,2,0,0,2,3,3,1,2,1
1,2,2,2,14,4,10,4,2,2,1,2,10,2,8,4,2,2,1,2,8,2,6,3
0,2,2,3,18,1,17,11,2,2,0,3,17,1,16,11,2,2,0,3,16,1,15,10
3,4,3,4,21,14,7,6,4,3,3,4,7,4,3,2,4,3,3,4,3,2,1,0
2,3,1,4,1,0,1,0,3,1,2,4,1,0,1,0,3,1,2,4,1,0,1,0
4,2,1,1,9,8,1,0,2,1,4,1,1,0,1,0,2,1,4,1,1,0,1,0
2,3,0,3,9,4,5,3,3,0,2,3,5,2,3,2,3,0,2,3,3,1,2,1
3,0,2,3,23,16,7,4,0,2,3,3,7,4,3,2,0,2,3,3,3,2,1,0
1,1,1,1,17,5,12,3,1,1,1,1,12,3,9,2,1,1,1,1,9,2,7,2
4,1,1,4,4,3,1,0,1,1,4,4,1,0,1,0,1,1,4,4,1,0,1,0
2,1,4,1,21,10,11,3,1,4,2,1,11,5,6,1,1,4,2,1,6,2,4,1
2,3,4,3,12,5,7,4,3,4,2,3,7,3,4,2,3,4,2,3,4,1,3,2
2,4,4,3,4,1,3,2,4,4,2,3,3,1,2,1,4,4,2,3,2,1,1,0
0,4,2,4,9,0,9,8,4,2,0,4,9,0,9,8,4,2,0,4,9,0,9,8
4,4,0,2,2,1,1,0,4,0,4,2,1,0,1,0,4,0,4,2,1,0,1,0
2,0,3,4,25,12,13,11,0,3,2,4,13,6,7,6,0,3,2,4,7,3,4,3
4,4,3,4,1,0,1,0,4,3,4,4,1,0,1,0,4,3,4,4,1,0,1,0
4,3,3,0,7,6,1,0,3,3,4,0,1,0,1,0,3,3,4,0,1,0,1,0
0,4,3,3,3,0,3,2,4,3,0,3,3,0,3,2,4,3,0,3,3,0,3,2
1,1,1,3,5,1,4,2,1,1,1,3,4,1,3,2,1,1,1,3,3,0,3,2
4,2,0,3,9,8,1,0,2,0,4,3,1,0,1,0,2,0,4,3,1,0,1,0
1,0,2,1,23,6,17,5,0,2,1,1,17,5,12,3,0,2,1,1,12,3,9,2
2,4,2,0,8,3,5,0,4,2,2,0,5,2,3,0,4,2,2,0,3,1,2,0
3,0,4,2,28,19,9,4,0,4,3,2,9,6,3,1,0,4,3,2,3,2,1,0
4,4,4,3,5,4,1,0,4,4,4,3,1,0,1,0,4,4,4,3,1,0,1,0
1,1,0,3,8,2,6,4,1,0,1,3,6,1,5,3,1,0,1,3,5,1,4,2
1,0,0,1,7,2,5,1,0,0,1,1,5,1,4,1,0,0,1,1,4,1,3,0
2,2,4,1,25,12,13,3,2,4,2,1,13,6,7,2,2,4,2,1,7,3,4,1
1,1,1,1,12,3,9,2,1,1,1,1,9,2,7,2,1,1,1,1,7,2,5,1
0,2,0,2,1,0,1,0,2,0,0,2,1,0,1,0,2,0,0,2,1,0,1,0
3,3,0,3,5,3,2,1,3,0,3,3,2,1,1,0,3,0,3,3,1,0,1,0
1,4,0,1,1,0,1,0,4,0,1,1,1,0,1,0,4,0,1,1,1,0,1,0
0,1,4,3,24,2,22,15,1,4,0,3,22,2,20,14,1,4,0,3,20,2,18,12
2,0,0,3,13,6,7,4,0,0,2,3,7,3,4,2,0,0,2,3,4,2,2,1
4,4,3,1,9,8,1,0,4,3,4,1,1,0,1,0,4,3,4,1,1,0,1,0
4,0,0,1,10,8,2,0,0,0,4,1,2,1,1,0,0,0,4,1,1,0,1,0
0,1,3,1,19,1,18,5,1,3,0,1,18,1,17,5,1,3,0,1,17,1,16,4
1,1,4,0,28,8,20,2,1,4,1,0,20,5,15,1,1,4,1,0,15,4,11,1
3,1,4,0,24,16,8,0,1,4,3,0,8,5,3,0,1,4,3,0,3,2,1,0
4,0,1,1,12,10,2,0,0,1,4,1,2,1,1,0,0,1,4,1,1,0,1,0
1,1,3,1,13,3,10,2,1,3,1,1,10,2,8,2,1,3,1,1,8,2,6,1
2,4,0,1,7,3,4,1,4,0,2,1,4,2,2,0,4,0,2,1,2,0,2,0
0,0,1,4,10,1,9,8,0,1,0,4,9,0,9,8,0,1,0,4,9,0,9,8
3,0,1,0,12,8,4,0,0,1,3,0,4,2,2,0,0,1,3,0,2,1,1,0
3,2,2,1,6,4,2,0,2,2,3,1,2,1,1,0,2,2,3,1,1,0,1,0
3,1,3,3,17,11,6,4,1,3,3,3,6,4,2,1,1,3,3,3,2,1,1,0
2,3,2,0,13,6,7,0,3,2,2,0,7,3,4,0,3,2,2,0,4,2,2,0
3,1,3,0,22,15,7,0,1,3,3,0,7,4,3,0,1,3,3,0,3,2,1,0
3,4,1,1,9,6,3,0,4,1,3,1,3,2,1,0,4,1,3,1,1,0,1,0
3,2,4,4,22,15,7,6,2,4,3,4,7,4,3,2,2,4,3,4,3,2,1,0
2,1,1,4,8,4,4,3,1,1,2,4,4,2,2,1,1,1,2,4,2,1,1,0
1,3,1,3,10,3,7,4,3,1,1,3,7,2,5,3,3,1,1,3,5,1,4,2
0,3,4,3,16,1,15,10,3,4,0,3,15,1,14,9,3,4,0,3,14,1,13,9
0,4,0,3,5,0,5,3,4,0,0,3,5,0,5,3,4,0,0,3,5,0,5,3
4,0,4,3,23,20,3,2,0,4,4,3,3,2,1,0,0,4,4,3,1,0,1,0
3,2,3,0,23,16,7,0,2,3,3,0,7,4,3,0,2,3,3,0,3,2,1,0
0,0,1,2,17,1,16,8,0,1,0,2,16,1,15,7,0,1,0,2,15,1,14,7
4,1,3,4,22,19,3,2,1,3,4,4,3,2,1,0,1,3,4,4,1,0,1,0
4,1,4,1,29,26,3,0,1,4,4,1,3,2,1,0,1,4,4,1,1,0,1,0
0,4,1,2,0,0,0,0,4,1,0,2,0,0,0,0,4,1,0,2,0,0,0,0
0,3,3,2,4,0,4,1,3,3,0,2,4,0,4,2,3,3,0,2,4,0,4,2
1,0,3,2,24,7,17,8,0,3,1,2,17,5,12,6,0,3,1,2,12,3,9,4
2,1,3,3,28,14,14,9,1,3,2,3,14,7,7,4,1,3,2,3,7,3,4,2
4,2,3,2,24,21,3,1,2,3,4,2,3,2,1,0,2,3,4,2,1,0,1,0
0,2,0,1,3,0,3,0,2,0,0,1,3,0,3,0,2,0,0,1,3,0,3,0
3,0,4,1,29,20,9,2,0,4,3,1,9,6,3,0,0,4,3,1,3,2,1,0
2,0,3,1,26,12,14,4,0,3,2,1,14,7,7,2,0,3,2,1,7,3,4,1
0,3,3,1,10,0,10,2,3,3,0,1,10,1,9,2,3,3,0,1,9,0,9,2
4,2,1,2,12,10,2,1,2,1,4,2,2,1,1,0,2,1,4,2,1,0,1,0
2,4,1,4,4,2,2,1,4,1,2,4,2,0,2,1,4,1,2,4,2,0,2,1
3,1,0,2,5,3,2,0,1,0,3,2,2,1,1,0,1,0,3,2,1,0,1,0
0,1,3,0,27,2,25,2,1,3,0,0,25,2,23,2,1,3,0,0,23,2,21,2
0,4,3,3,9,0,9,6,4,3,0,3,9,0,9,6,4,3,0,3,9,0,9,6
3,0,2,2,23,16,7,3,0,2,3,2,7,4,3,1,0,2,3,2,3,2,1,0
3,3,0,4,0,0,0,0,3,0,3,4,0,0,0,0,3,0,3,4,0,0,0,0
3,0,0,2,12,8,4,2,0,0,3,2,4,2,2,1,0,0,3,2,2,1,1,0
0,3,3,2,19,1,18,9,3,3,0,2,18,1,17,8,3,3,0,2,17,1,16,8
0,4,1,0,0,0,0,0,4,1,0,0,0,0,0,0,4,1,0,0,0,0,0,0
4,3,1,2,11,9,2,1,3,1,4,2,2,1,1,0,3,1,4,2,1,0,1,0
2,4,4,0,11,5,6,0,4,4,2,0,6,3,3,0,4,4,2,0,3,1,2,0
2,3,4,3,17,8,9,6,3,4,2,3,9,4,5,3,3,4,2,3,5,2,3,2
0,1,0,4,8,0,8,7,1,0,0,4,8,0,8,7,1,0,0,4,8,0,8,7
1,1,2,0,19,5,14,1,1,2,1,0,14,4,10,1,1,2,1,0,10,3,7,0
3,3,0,0,6,4,2,0,3,0,3,0,2,1,1,0,3,0,3,0,1,0,1,0
2,2,4,3,23,11,12,8,2,4,2,3,12,6,6,4,2,4,2,3,6,2,4,2
0,2,3,4,24,2,22,19,2,3,0,4,22,2,20,18,2,3,0,4,20,2,18,16
2,2,1,0,16,7,9,0,2,1,2,0,9,4,5,0,2,1,2,0,5,2,3,0
4,0,4,4,28,25,3,2,0,4,4,4,3,2,1,0,0,4,4,4,1,0,1,0
2,3,1,1,10,5,5,1,3,1,2,1,5,2,3,0,3,1,2,1,3,1,2,0
0,2,0,1,7,0,7,2,2,0,0,1,7,0,7,2,2,0,0,1,7,0,7,2
3,3,4,3,15,10,5,3,3,4,3,3,5,3,2,1,3,4,3,3,2,1,1,0
4,2,2,3,13,11,2,1,2,2,4,3,2,1,1,0,2,2,4,3,1,0,1,0
3,2,2,4,13,9,4,3,2,2,3,4,4,2,2,1,2,2,3,4,2,1,1,0
1,1,1,2,27,8,19,9,1,1,1,2,19,5,14,6,1,1,1,2,14,4,10,4
0,0,1,1,11,1,10,3,0,1,0,1,10,1,9,2,0,1,0,1,9,0,9,2
4,3,3,4,15,13,2,1,3,3,4,4,2,1,1,0,3,3,4,4,1,0,1,0
3,1,4,3,22,15,7,4,1,4,3,3,7,4,3,2,1,4,3,3,3,2,1,0
3,1,1,1,10,6,4,1,1,1,3,1,4,2,2,0,1,1,3,1,2,1,1,0
1,0,2,4,23,6,17,15,0,2,1,4,17,5,12,10,0,2,1,4,12,3,9,8
0,3,1,0,14,1,13,1,3,1,0,0,13,1,12,1,3,1,0,0,12,1,11,1
2,2,4,3,22,11,11,7,2,4,2,3,11,5,6,4,2,4,2,3,6,2,4,2
3,2,1,1,0,0,0,0,2,1,3,1,0,0,0,0,2,1,3,1,0,0,0,0
3,2,3,3,19,13,6,4,2,3,3,3,6,4,2,1,2,3,3,3,2,1,1,0
1,3,2,4,13,3,10,9,3,2,1,4,10,3,7,6,3,2,1,4,7,2,5,4
0,2,0,1,4,0,4,1,2,0,0,1,4,0,4,1,2,0,0,1,4,0,4,1
2,4,1,2,2,1,1,0,4,1,2,2,1,0,1,0,4,1,2,2,1,0,1,0
2,1,1,3,7,3,4,2,1,1,2,3,4,2,2,1,1,1,2,3,2,1,1,0
2,0,2,0,20,10,10,0,0,2,2,0,10,4,6,0,0,2,2,0,6,2,4,0
3,0,4,1,29,20,9,2,0,4,3,1,9,6,3,0,0,4,3,1,3,2,1,0
2,3,0,4,3,1,2,1,3,0,2,4,2,0,2,1,3,0,2,4,2,1,1,0
1,2,1,3,7,2,5,3,2,1,1,3,5,1,4,2,2,1,1,3,4,1,3,2
0,2,4,3,19,1,18,12,2,4,0,3,18,1,17,11,2,4,0,3,17,1,16,11
0,3,0,1,7,0,7,2,3,0,0,1,7,0,7,2,3,0,0,1,7,0,7,2
0,2,0,2,2,0,2,1,2,0,0,2,2,0,2,1,2,0,0,2,2,0,2,0
1,2,2,0,13,3,10,0,2,2,1,0,10,3,7,0,2,2,1,0,7,2,5,0
2,0,3,3,27,13,14,9,0,3,2,3,14,6,8,5,0,3,2,3,8,3,5,3
0,1,2,2,21,2,19,9,1,2,0,2,19,1,18,9,1,2,0,2,18,1,17,8
0,2,4,2,16,1,15,7,2,4,0,2,15,1,14,7,2,4,0,2,14,1,13,6
0,0,4,4,29,2,27,24,0,4,0,4,27,2,25,22,0,4,0,4,25,2,23,20
3,3,1,4,1,0,1,0,3,1,3,4,1,0,1,0,3,1,3,4,1,0,1,0
1,3,4,1,22,6,16,4,3,4,1,1,16,4,12,3,3,4,1,1,12,3,9,2
2,4,2,2,5,2,3,1,4,2,2,2,3,1,2,1,4,2,2,2,2,1,1,0
0,0,2,2,25,2,23,11,0,2,0,2,23,2,21,10,0,2,0,2,21,2,19,9
4,4,0,4,2,1,1,0,4,0,4,4,1,0,1,0,4,0,4,4,1,0,1,0
2,4,0,3,6,2,4,2,4,0,2,3,4,1,3,2,4,0,2,3,3,1,2,1
3,3,4,3,1,0,1,0,3,4,3,3,1,0,1,0,3,4,3,3,1,0,1,0
3,4,0,1,0,0,0,0,4,0,3,1,0,0,0,0,4,0,3,1,0,0,0,0
1,2,3,2,17,5,12,5,2,3,1,2,12,3,9,4,2,3,1,2,9,2,7,3
3,1,2,3,17,11,6,4,1,2,3,3,6,4,2,1,1,2,3,3,2,1,1,0
3,2,2,1,12,8,4,1,2,2,3,1,4,2,2,0,2,2,3,1,2,1,1,0
3,3,0,2,0,0,0,0,3,0,3,2,0,0,0,0,3,0,3,2,0,0,0,0
4,3,1,4,8,7,1,0,3,1,4,4,1,0,1,0,3,1,4,4,1,0,1,0
0,3,0,3,5,0,5,3,3,0,0,3,5,0,5,3,3,0,0,3,5,0,5,3
1,1,3,1,14,4,10,2,1,3,1,1,10,3,7,2,1,3,1,1,7,2,5,1
0,1,1,4,12,1,11,9,1,1,0,4,11,1,10,8,1,1,0,4,10,0,10,9
2,0,4,0,29,14,15,1,0,4,2,0,15,7,8,0,0,4,2,0,8,3,5,0
1,2,4,4,22,6,16,14,2,4,1,4,16,4,12,10,2,4,1,4,12,3,9,8
4,0,3,3,23,20,3,2,0,3,4,3,3,2,1,0,0,3,4,3,1,0,1,0
2,4,3,1,0,0,0,0,4,3,2,1,0,0,0,0,4,3,2,1,0,0,0,0
0,4,2,3,3,0,3,2,4,2,0,3,3,0,3,2,4,2,0,3,3,0,3,2
3,2,2,3,14,9,5,3,2,2,3,3,5,3,2,1,2,2,3,3,2,1,1,0
0,1,4,3,24,2,22,15,1,4,0,3,22,2,20,13,1,4,0,3,20,1,19,13
4,0,2,3,25,22,3,2,0,2,4,3,3,2,1,0,0,2,4,3,1,0,1,0
4,1,3,2,21,18,3,1,1,3,4,2,3,2,1,0,1,3,4,2,1,0,1,0
4,3,2,3,3,2,1,0,3,2,4,3,1,0,1,0,3,2,4,3,1,0,1,0
0,3,2,3,9,0,9,6,3,2,0,3,9,0,9,6,3,2,0,3,9,0,9,6
1,3,3,2,5,1,4,2,3,3,1,2,4,1,3,1,3,3,1,2,3,0,3,1
2,1,4,1,25,12,13,3,1,4,2,1,13,6,7,2,1,4,2,1,7,3,4,1
3,3,1,0,1,0,1,0,3,1,3,0,1,0,1,0,3,1,3,0,1,0,1,0
2,0,2,1,22,11,11,3,0,2,2,1,11,5,6,1,0,2,2,1,6,2,4,1
0,4,3,3,7,0,7,4,4,3,0,3,7,0,7,4,4,3,0,3,7,0,7,4
3,1,1,2,13,9,4,2,1,1,3,2,4,2,2,1,1,1,3,2,2,1,1,0
2,4,1,0,3,1,2,0,4,1,2,0,2,1,1,0,4,1,2,0,1,0,1,0
0,1,4,4,24,2,22,19,1,4,0,4,22,2,20,17,1,4,0,4,20,2,18,16
0,4,1,4,4,0,4,3,4,1,0,4,4,0,4,3,4,1,0,4,4,0,4,3
0,1,4,4,26,2,24,21,1,4,0,4,24,2,22,19,1,4,0,4,22,2,20,18
2,4,0,2,2,0,2,0,4,0,2,2,2,1,1,0,4,0,2,2,1,0,1,0
3,0,2,2,19,13,6,3,0,2,3,2,6,4,2,1,0,2,3,2,2,1,1,0
3,4,2,3,0,0,0,0,4,2,3,3,0,0,0,0,4,2,3,3,0,0,0,0
1,4,2,4,8,2,6,5,4,2,1,4,6,1,5,4,4,2,1,4,5,1,4,3
1,1,0,2,9,2,7,3,1,0,1,2,7,2,5,2,1,0,1,2,5,1,4,2
2,1,0,3,6,2,4,2,1,0,2,3,4,2,2,1,1,0,2,3,2,0,2,1
3,3,1,0,2,1,1,0,3,1,3,0,1,0,1,0,3,1,3,0,1,0,1,0
0,2,4,3,24,2,22,15,2,4,0,3,22,2,20,14,2,4,0,3,20,2,18,12
2,2,4,0,23,11,12,1,2,4,2,0,12,6,6,0,2,4,2,0,6,3,3,0
4,1,2,3,19,17,2,1,1,2,4,3,2,1,1,0,1,2,4,3,1,0,1,0
1,4,4,3,4,1,3,2,4,4,1,3,3,0,3,2,4,4,1,3,3,0,3,2
0,4,3,1,1,0,1,0,4,3,0,1,1,0,1,0,4,3,0,1,1,0,1,0
2,2,1,4,11,5,6,5,2,1,2,4,6,3,3,2,2,1,2,4,3,1,2,1
0,3,0,1,6,0,6,1,3,0,0,1,6,0,6,1,3,0,0,1,6,0,6,1
1,4,2,4,3,0,3,2,4,2,1,4,3,0,3,2,4,2,1,4,3,0,3,2
3,3,0,3,0,0,0,0,3,0,3,3,0,0,0,0,3,0,3,3,0,0,0,0
2,3,3,1,11,5,6,1,3,3,2,1,6,3,3,0,3,3,2,1,3,1,2,0
4,1,4,4,29,26,3,2,1,4,4,4,3,2,1,0,1,4,4,4,1,0,1,0
2,3,2,1,12,5,7,2,3,2,2,1,7,3,4,1,3,2,2,1,4,1,3,0
2,2,3,4,5,2,3,2,2,3,2,4,3,1,2,1,2,3,2,4,2,1,1,0
3,4,2,2,8,5,3,1,4,2,3,2,3,2,1,0,4,2,3,2,1,0,1,0
3,4,3,0,11,7,4,0,4,3,3,0,4,2,2,0,4,3,3,0,2,1,1,0
1,0,1,4,15,4,11,9,0,1,1,4,11,3,8,7,0,1,1,4,8,2,6,5
2,2,2,1,15,7,8,2,2,2,2,1,8,3,5,1,2,2,2,1,5,2,3,0
4,4,1,3,9,8,1,0,4,1,4,3,1,0,1,0,4,1,4,3,1,0,1,0
3,2,1,3,9,6,3,2,2,1,3,3,3,2,1,0,2,1,3,3,1,0,1,0
1,2,4,0,24,7,17,1,2,4,1,0,17,5,12,1,2,4,1,0,12,3,9,0
4,4,0,1,1,0,1,0,4,0,4,1,1,0,1,0,4,0,4,1,1,0,1,0
1,4,4,4,7,2,5,4,4,4,1,4,5,1,4,3,4,4,1,4,4,1,3,2
4,4,2,3,2,1,1,0,4,2,4,3,1,0,1,0,4,2,4,3,1,0,1,0
0,2,0,3,10,0,10,7,2,0,0,3,10,0,10,7,2,0,0,3,10,0,10,6
4,4,2,1,2,1,1,0,4,2,4,1,1,0,1,0,4,2,4,1,1,0,1,0
0,1,1,4,9,0,9,8,1,1,0,4,9,0,9,8,1,1,0,4,9,0,9,8
1,0,0,0,11,3,8,0,0,0,1,0,8,2,6,0,0,0,1,0,6,1,5,0
0,4,0,4,6,0,6,5,4,0,0,4,6,0,6,5,4,0,0,4,6,0,6,5
2,4,3,0,0,0,0,0,4,3,2,0,0,0,0,0,4,3,2,0,0,0,0,0
4,2,0,2,9,8,1,0,2,0,4,2,1,0,1,0,2,0,4,2,1,0,1,0
4,3,2,2,12,10,2,1,3,2,4,2,2,1,1,0,3,2,4,2,1,0,1,0
2,4,0,0,6,2,4,0,4,0,2,0,4,2,2,0,4,0,2,0,2,1,1,0
1,0,0,4,15,4,11,9,0,0,1,4,11,3,8,7,0,0,1,4,8,2,6,5
1,0,0,4,11,3,8,7,0,0,1,4,8,2,6,5,0,0,1,4,6,1,5,4
4,4,4,2,7,6,1,0,4,4,4,2,1,0,1,0,4,4,4,2,1,0,1,0
0,2,2,4,7,0,7,6,2,2,0,4,7,0,7,6,2,2,0,4,7,0,7,6
0,3,4,3,17,1,16,11,3,4,0,3,16,1,15,10,3,4,0,3,15,1,14,9
4,2,3,4,21,18,3,2,2,3,4,4,3,2,1,0,2,3,4,4,1,0,1,0
2,1,4,4,27,13,14,12,1,4,2,4,14,6,8,7,1,4,2,4,8,4,4,3
0,0,0,3,8,0,8,5,0,0,0,3,8,0,8,5,0,0,0,3,8,0,8,5
4,4,3,1,8,7,1,0,4,3,4,1,1,0,1,0,4,3,4,1,1,0,1,0
3,2,1,1,14,9,5,1,2,1,3,1,5,3,2,0,2,1,3,1,2,1,1,0
0,1,1,1,2,0,2,0,1,1,0,1,2,0,2,0,1,1,0,1,2,0,2,0
0,0,2,4,16,1,15,13,0,2,0,4,15,1,14,12,0,2,0,4,14,1,13,11
1,3,1,3,5,1,4,2,3,1,1,3,4,1,3,2,3,1,1,3,3,0,3,2
3,3,1,0,16,11,5,0,3,1,3,0,5,3,2,0,3,1,3,0,2,1,1,0
0,3,4,4,14,1,13,11,3,4,0,4,13,1,12,10,3,4,0,4,12,1,11,9
0,0,1,2,10,0,10,5,0,1,0,2,10,0,10,4,0,1,0,2,10,1,9,4
0,0,3,1,28,2,26,7,0,3,0,1,26,2,24,7,0,3,0,1,24,2,22,6
0,2,4,3,17,1,16,11,2,4,0,3,16,1,15,10,2,4,0,3,15,1,14,9
1,2,2,3,12,3,9,6,2,2,1,3,9,2,7,4,2,2,1,3,7,2,5,3
3,1,4,4,27,18,9,8,1,4,3,4,9,6,3,2,1,4,3,4,3,2,1,0
0,3,1,1,6,0,6,1,3,1,0,1,6,0,6,1,3,1,0,1,6,0,6,1
4,4,0,4,5,4,1,0,4,0,4,4,1,0,1,0,4,0,4,4,1,0,1,0
4,0,1,3,16,14,2,1,0,1,4,3,2,1,1,0,0,1,4,3,1,0,1,0
2,0,4,4,26,12,14,12,0,4,2,4,14,7,7,6,0,4,2,4,7,3,4,3
4,3,0,0,4,3,1,0,3,0,4,0,1,0,1,0,3,0,4,0,1,0,1,0
0,4,2,2,2,0,2,0,4,2,0,2,2,0,2,1,4,2,0,2,2,0,2,1
4,4,2,4,12,10,2,1,4,2,4,4,2,1,1,0,4,2,4,4,1,0,1,0
0,3,4,4,16,1,15,13,3,4,0,4,15,1,14,12,3,4,0,4,14,1,13,11
4,0,4,1,25,22,3,0,0,4,4,1,3,2,1,0,0,4,4,1,1,0,1,0
3,2,4,2,26,18,8,4,2,4,3,2,8,5,3,1,2,4,3,2,3,2,1,0
4,1,1,0,23,20,3,0,1,1,4,0,3,2,1,0,1,1,4,0,1,0,1,0
2,0,2,0,15,7,8,0,0,2,2,0,8,3,5,0,0,2,2,0,5,2,3,0
2,4,3,0,5,2,3,0,4,3,2,0,3,1,2,0,4,3,2,0,2,1,1,0
3,4,2,2,5,3,2,1,4,2,3,2,2,1,1,0,4,2,3,2,1,0,1,0
1,2,2,0,12,3,9,0,2,2,1,0,9,2,7,0,2,2,1,0,7,2,5,0
4,2,4,4,17,15,2,1,2,4,4,4,2,1,1,0,2,4,4,4,1,0,1,0
0,4,0,1,7,0,7,2,4,0,0,1,7,0,7,2,4,0,0,1,7,0,7,2
0,3,0,0,4,0,4,0,3,0,0,0,4,0,4,0,3,0,0,0,4,0,4,0
3,3,2,2,11,7,4,1,3,2,3,2,4,2,2,1,3,2,3,2,2,1,1,0
4,2,3,0,14,12,2,0,2,3,4,0,2,1,1,0,2,3,4,0,1,0,1,0
3,3,0,2,9,6,3,1,3,0,3,2,3,2,1,0,3,0,3,2,1,0,1,0
1,2,2,4,7,2,5,4,2,2,1,4,5,1,4,3,2,2,1,4,4,1,3,2
3,0,2,0,19,13,6,0,0,2,3,0,6,4,2,0,0,2,3,0,2,1,1,0
0,1,1,2,19,1,18,8,1,1,0,2,18,1,17,8,1,1,0,2,17,1,16,8
4,0,4,2,28,25,3,1,0,4,4,2,3,2,1,0,0,4,4,2,1,0,1,0
0,2,3,1,12,1,11,3,2,3,0,1,11,1,10,3,2,3,0,1,10,0,10,2
0,4,1,2,5,0,5,2,4,1,0,2,5,0,5,2,4,1,0,2,5,0,5,2
4,4,1,1,2,1,1,0,4,1,4,1,1,0,1,0,4,1,4,1,1,0,1,0
0,1,2,3,18,1,17,11,1,2,0,3,17,1,16,11,1,2,0,3,16,1,15,10
1,0,0,1,6,1,5,1,0,0,1,1,5,1,4,1,0,0,1,1,4,1,3,0
1,4,4,1,3,0,3,0,4,4,1,1,3,0,3,0,4,4,1,1,3,0,3,0
3,0,0,4,3,2,1,0,0,0,3,4,1,0,1,0,0,0,3,4,1,0,1,0
4,0,0,2,3,2,1,0,0,0,4,2,1,0,1,0,0,0,4,2,1,0,1,0
0,4,4,4,8,0,8,7,4,4,0,4,8,0,8,7,4,4,0,4,8,0,8,7
2,3,2,2,5,2,3,1,3,2,2,2,3,1,2,0,3,2,2,2,2,0,2,1
1,2,2,4,16,4,12,10,2,2,1,4,12,3,9,8,2,2,1,4,9,2,7,6
0,3,0,4,1,0,1,0,3,0,0,4,1,0,1,0,3,0,0,4,1,0,1,0
3,4,1,1,5,3,2,0,4,1,3,1,2,1,1,0,4,1,3,1,1,0,1,0
3,2,3,1,17,11,6,1,2,3,3,1,6,4,2,0,2,3,3,1,2,1,1,0
1,3,0,1,9,2,7,2,3,0,1,1,7,2,5,1,3,0,1,1,5,1,4,1
0,3,2,1,12,1,11,3,3,2,0,1,11,1,10,2,3,2,0,1,10,0,10,2
4,2,3,2,19,17,2,0,2,3,4,2,2,1,1,0,2,3,4,2,1,0,1,0
3,3,3,4,21,14,7,6,3,3,3,4,7,4,3,2,3,3,3,4,3,2,1,0
4,4,0,3,6,5,1,0,4,0,4,3,1,0,1,0,4,0,4,3,1,0,1,0
3,2,1,1,11,7,4,1,2,1,3,1,4,2,2,0,2,1,3,1,2,1,1,0
0,3,3,1,23,2,21,6,3,3,0,1,21,2,19,5,3,3,0,1,19,1,18,5
1,3,3,1,6,1,5,1,3,3,1,1,5,1,4,1,3,3,1,1,4,1,3,0
2,1,3,2,16,8,8,3,1,3,2,2,8,4,4,1,1,3,2,2,4,1,3,1
1,0,2,1,20,6,14,4,0,2,1,1,14,4,10,3,0,2,1,1,10,3,7,2
2,2,4,1,16,7,9,2,2,4,2,1,9,4,5,1,2,4,2,1,5,2,3,0
4,4,2,3,9,8,1,0,4,2,4,3,1,0,1,0,4,2,4,3,1,0,1,0
2,3,4,3,15,7,8,5,3,4,2,3,8,4,4,2,3,4,2,3,4,1,3,2
1,3,3,1,2,0,2,0,3,3,1,1,2,0,2,0,3,3,1,1,2,0,2,0
4,3,3,3,7,6,1,0,3,3,4,3,1,0,1,0,3,3,4,3,1,0,1,0
2,1,4,0,28,13,15,1,1,4,2,0,15,7,8,0,1,4,2,0,8,4,4,0
2,4,3,4,1,0,1,0,4,3,2,4,1,0,1,0,4,3,2,4,1,0,1,0
1,1,4,4,19,5,14,12,1,4,1,4,14,4,10,8,1,4,1,4,10,3,7,6
3,1,4,4,28,19,9,8,1,4,3,4,9,6,3,2,1,4,3,4,3,2,1,0
4,3,1,3,7,6,1,0,3,1,4,3,1,0,1,0,3,1,4,3,1,0,1,0
2,3,2,2,18,9,9,4,3,2,2,2,9,4,5,2,3,2,2,2,5,2,3,1
3,2,2,4,17,11,6,5,2,2,3,4,6,4,2,1,2,2,3,4,2,1,1,0
2,1,3,4,26,13,13,11,1,3,2,4,13,6,7,6,1,3,2,4,7,3,4,3
4,2,4,1,23,20,3,0,2,4,4,1,3,2,1,0,2,4,4,1,1,0,1,0
1,0,2,2,15,4,11,5,0,2,1,2,11,3,8,4,0,2,1,2,8,2,6,2
1,3,3,2,14,4,10,5,3,3,1,2,10,2,8,4,3,3,1,2,8,2,6,3
1,4,1,3,1,0,1,0,4,1,1,3,1,0,1,0,4,1,1,3,1,0,1,0
3,1,0,3,12,8,4,2,1,0,3,3,4,2,2,1,1,0,3,3,2,1,1,0
4,2,2,2,10,9,1,0,2,2,4,2,1,0,1,0,2,2,4,2,1,0,1,0
0,0,4,1,28,2,26,7,0,4,0,1,26,2,24,7,0,4,0,1,24,2,22,6
3,2,2,0,13,9,4,0,2,2,3,0,4,2,2,0,2,2,3,0,2,1,1,0
2,3,4,2,18,9,9,4,3,4,2,2,9,4,5,2,3,4,2,2,5,2,3,1
4,4,4,1,5,4,1,0,4,4,4,1,1,0,1,0,4,4,4,1,1,0,1,0
2,0,3,0,25,12,13,1,0,3,2,0,13,6,7,0,0,3,2,0,7,3,4,0
1,3,3,2,19,5,14,6,3,3,1,2,14,4,10,5,3,3,1,2,10,2,8,4
1,4,0,2,0,0,0,0,4,0,1,2,0,0,0,0,4,0,1,2,0,0,0,0
4,3,4,0,11,9,2,0,3,4,4,0,2,1,1,0,3,4,4,0,1,0,1,0
2,3,4,3,11,5,6,4,3,4,2,3,6,3,3,2,3,4,2,3,3,1,2,1
2,0,1,2,5,2,3,1,0,1,2,2,3,1,2,1,0,1,2,2,2,0,2,0
2,1,4,4,27,13,14,12,1,4,2,4,14,6,8,7,1,4,2,4,8,3,5,4
1,1,4,1,22,6,16,4,1,4,1,1,16,4,12,3,1,4,1,1,12,3,9,2
0,4,0,4,1,0,1,0,4,0,0,4,1,0,1,0,4,0,0,4,1,0,1,0
3,1,1,1,19,13,6,1,1,1,3,1,6,4,2,0,1,1,3,1,2,1,1,0
2,3,0,4,8,3,5,4,3,0,2,4,5,2,3,2,3,0,2,4,3,1,2,1
2,3,4,1,9,4,5,1,3,4,2,1,5,2,3,0,3,4,2,1,3,1,2,0
0,0,4,3,28,2,26,18,0,4,0,3,26,2,24,16,0,4,0,3,24,2,22,15
1,2,4,1,22,6,16,4,2,4,1,1,16,4,12,3,2,4,1,1,12,3,9,2
2,2,0,4,1,0,1,0,2,0,2,4,1,0,1,0,2,0,2,4,1,0,1,0
3,0,4,3,29,20,9,6,0,4,3,3,9,6,3,2,0,4,3,3,3,2,1,0
2,4,4,3,4,1,3,2,4,4,2,3,3,1,2,1,4,4,2,3,2,1,1,0
3,0,2,1,23,16,7,2,0,2,3,1,7,4,3,0,0,2,3,1,3,2,1,0
0,2,1,1,1,0,1,0,2,1,0,1,1,0,1,0,2,1,0,1,1,0,1,0
2,4,1,1,12,6,6,1,4,1,2,1,6,3,3,0,4,1,2,1,3,1,2,0
0,4,1,0,6,0,6,0,4,1,0,0,6,0,6,0,4,1,0,0,6,0,6,0
3,0,4,2,27,18,9,4,0,4,3,2,9,6,3,1,0,4,3,2,3,2,1,0
4,0,3,1,26,23,3,0,0,3,4,1,3,2,1,0,0,3,4,1,1,0,1,0
0,2,3,3,10,1,9,6,2,3,0,3,9,0,9,6,2,3,0,3,9,0,9,6
4,2,4,1,21,18,3,0,2,4,4,1,3,2,1,0,2,4,4,1,1,0,1,0
4,1,2,4,8,7,1,0,1,2,4,4,1,0,1,0,1,2,4,4,1,0,1,0
4,1,0,3,8,7,1,0,1,0,4,3,1,0,1,0,1,0,4,3,1,0,1,0
4,3,1,2,5,4,1,0,3,1,4,2,1,0,1,0,3,1,4,2,1,0,1,0
2,3,2,0,6,3,3,0,3,2,2,0,3,1,2,0,3,2,2,0,2,1,1,0
0,2,2,4,14,1,13,11,2,2,0,4,13,1,12,10,2,2,0,4,12,1,11,9
2,1,2,1,15,7,8,2,1,2,2,1,8,4,4,1,1,2,2,1,4,1,3,0
3,0,4,0,29,20,9,0,0,4,3,0,9,6,3,0,0,4,3,0,3,2,1,0
0,0,0,2,15,1,14,7,0,0,0,2,14,1,13,6,0,0,0,2,13,1,12,6
1,0,3,4,19,5,14,12,0,3,1,4,14,4,10,8,0,3,1,4,10,2,8,7
4,0,3,3,25,22,3,2,0,3,4,3,3,2,1,0,0,3,4,3,1,0,1,0
0,2,2,3,12,1,11,7,2,2,0,3,11,1,10,6,2,2,0,3,10,1,9,6
4,2,2,4,17,15,2,1,2,2,4,4,2,1,1,0,2,2,4,4,1,0,1,0
3,3,4,0,7,4,3,0,3,4,3,0,3,2,1,0,3,4,3,0,1,0,1,0
2,4,2,0,3,1,2,0,4,2,2,0,2,0,2,0,4,2,2,0,2,0,2,0
0,1,0,4,2,0,2,1,1,0,0,4,2,0,2,1,1,0,0,4,2,0,2,1
3,0,0,2,5,3,2,1,0,0,3,2,2,1,1,0,0,0,3,2,1,0,1,0
0,1,4,0,21,2,19,1,1,4,0,0,19,1,18,1,1,4,0,0,18,1,17,1
4,4,0,4,3,2,1,0,4,0,4,4,1,0,1,0,4,0,4,4,1,0,1,0
0,0,1,0,11,1,10,1,0,1,0,0,10,1,9,0,0,1,0,0,9,0,9,0
3,2,3,1,19,13,6,1,2,3,3,1,6,4,2,0,2,3,3,1,2,1,1,0
2,3,2,1,1,0,1,0,3,2,2,1,1,0,1,0,3,2,2,1,1,0,1,0
0,3,2,2,4,0,4,2,3,2,0,2,4,0,4,2,3,2,0,2,4,0,4,2
4,1,3,0,26,23,3,0,1,3,4,0,3,2,1,0,1,3,4,0,1,0,1,0
0,2,2,2,15,1,14,7,2,2,0,2,14,1,13,6,2,2,0,2,13,1,12,6
1,3,1,3,3,0,3,2,3,1,1,3,3,0,3,2,3,1,1,3,3,0,3,2
1,3,1,1,10,3,7,2,3,1,1,1,7,2,5,1,3,1,1,1,5,1,4,1
0,1,2,1,18,1,17,5,1,2,0,1,17,1,16,4,1,2,0,1,16,1,15,4
4,2,1,1,4,3,1,0,2,1,4,1,1,0,1,0,2,1,4,1,1,0,1,0
3,2,1,1,5,3,2,0,2,1,3,1,2,1,1,0,2,1,3,1,1,0,1,0
2,3,0,4,1,0,1,0,3,0,2,4,1,0,1,0,3,0,2,4,1,0,1,0
0,1,0,0,5,0,5,0,1,0,0,0,5,0,5,0,1,0,0,0,5,0,5,0
3,1,0,1,6,4,2,0,1,0,3,1,2,1,1,0,1,0,3,1,1,0,1,0
1,0,1,4,14,4,10,9,0,1,1,4,10,3,7,6,0,1,1,4,7,2,5,4
4,2,2,2,7,6,1,0,2,2,4,2,1,0,1,0,2,2,4,2,1,0,1,0
2,1,0,1,12,6,6,1,1,0,2,1,6,3,3,0,1,0,2,1,3,1,2,0
0,1,3,3,29,2,27,18,1,3,0,3,27,2,25,17,1,3,0,3,25,2,23,16
0,4,3,3,4,0,4,2,4,3,0,3,4,0,4,2,4,3,0,3,4,0,4,2
0,0,1,4,15,1,14,12,0,1,0,4,14,1,13,11,0,1,0,4,13,1,12,10
2,4,4,0,7,3,4,0,4,4,2,0,4,1,3,0,4,4,2,0,3,1,2,0
3,0,4,3,28,19,9,6,0,4,3,3,9,6,3,2,0,4,3,3,3,2,1,0
2,2,3,0,9,4,5,0,2,3,2,0,5,2,3,0,2,3,2,0,3,1,2,0
4,3,1,2,10,9,1,0,3,1,4,2,1,0,1,0,3,1,4,2,1,0,1,0
1,4,0,2,0,0,0,0,4,0,1,2,0,0,0,0,4,0,1,2,0,0,0,0
3,0,2,0,24,16,8,0,0,2,3,0,8,5,3,0,0,2,3,0,3,2,1,0
0,0,0,4,7,0,7,6,0,0,0,4,7,0,7,6,0,0,0,4,7,0,7,6
4,2,3,1,13,11,2,0,2,3,4,1,2,1,1,0,2,3,4,1,1,0,1,0
1,0,1,1,18,5,13,3,0,1,1,1,13,3,10,3,0,1,1,1,10,2,8,2
4,0,0,2,3,2,1,0,0,0,4,2,1,0,1,0,0,0,4,2,1,0,1,0
0,1,4,4,27,2,25,22,1,4,0,4,25,2,23,20,1,4,0,4,23,2,21,18
3,1,2,1,26,18,8,2,1,2,3,1,8,5,3,0,1,2,3,1,3,2,1,0
2,4,1,3,5,2,3,2,4,1,2,3,3,1,2,1,4,1,2,3,2,0,2,1
2,2,4,3,15,7,8,5,2,4,2,3,8,4,4,2,2,4,2,3,4,1,3,2
3,2,4,0,24,16,8,0,2,4,3,0,8,5,3,0,2,4,3,0,3,2,1,0
4,4,1,4,16,14,2,1,4,1,4,4,2,1,1,0,4,1,4,4,1,0,1,0
3,4,1,4,0,0,0,0,4,1,3,4,0,0,0,0,4,1,3,4,0,0,0,0
0,0,0,1,4,0,4,1,0,0,0,1,4,0,4,1,0,0,0,1,4,0,4,1
0,3,0,4,3,0,3,2,3,0,0,4,3,0,3,2,3,0,0,4,3,0,3,2
0,4,0,0,5,0,5,0,4,0,0,0,5,0,5,0,4,0,0,0,5,0,5,0
2,3,3,3,14,6,8,5,3,3,2,3,8,3,5,3,3,3,2,3,5,2,3,2
3,3,3,3,8,5,3,2,3,3,3,3,3,2,1,0,3,3,3,3,1,0,1,0
1,2,2,4,13,3,10,8,2,2,1,4,10,2,8,7,2,2,1,4,8,2,6,5
0,0,4,4,28,2,26,23,0,4,0,4,26,2,24,21,0,4,0,4,24,2,22,19
3,1,0,1,11,7,4,1,1,0,3,1,4,2,2,0,1,0,3,1,2,1,1,0
4,1,2,2,11,9,2,0,1,2,4,2,2,1,1,0,1,2,4,2,1,0,1,0
1,3,1,1,8,2,6,1,3,1,1,1,6,1,5,1,3,1,1,1,5,1,4,1
1,4,3,0,8,2,6,0,4,3,1,0,6,1,5,0,4,3,1,0,5,1,4,0
3,3,1,0,8,5,3,0,3,1,3,0,3,2,1,0,3,1,3,0,1,0,1,0
0,1,2,1,20,2,18,5,1,2,0,1,18,1,17,5,1,2,0,1,17,1,16,4
3,2,4,2,25,17,8,3,2,4,3,2,8,5,3,1,2,4,3,2,3,2,1,0
0,4,3,1,4,0,4,1,4,3,0,1,4,0,4,1,4,3,0,1,4,0,4,1
3,1,4,1,29,20,9,2,1,4,3,1,9,6,3,0,1,4,3,1,3,2,1,0
1,2,2,1,17,5,12,3,2,2,1,1,12,3,9,2,2,2,1,1,9,2,7,2
3,4,4,0,5,3,2,0,4,4,3,0,2,1,1,0,4,4,3,0,1,0,1,0
3,4,4,1,5,3,2,0,4,4,3,1,2,1,1,0,4,4,3,1,1,0,1,0
2,4,4,2,9,4,5,2,4,4,2,2,5,2,3,1,4,4,2,2,3,1,2,0
4,1,0,3,4,3,1,0,1,0,4,3,1,0,1,0,1,0,4,3,1,0,1,0
3,0,1,4,15,10,5,4,0,1,3,4,5,3,2,1,0,1,3,4,2,1,1,0
1,4,2,0,6,1,5,0,4,2,1,0,5,1,4,0,4,2,1,0,4,1,3,0
4,4,4,0,16,14,2,0,4,4,4,0,2,1,1,0,4,4,4,0,1,0,1,0
4,4,1,3,1,0,1,0,4,1,4,3,1,0,1,0,4,1,4,3,1,0,1,0
4,3,4,1,14,12,2,0,3,4,4,1,2,1,1,0,3,4,4,1,1,0,1,0
3,1,0,2,2,1,1,0,1,0,3,2,1,0,1,0,1,0,3,2,1,0,1,0
3,1,4,4,26,18,8,7,1,4,3,4,8,5,3,2,1,4,3,4,3,2,1,0
3,3,4,4,13,9,4,3,3,4,3,4,4,2,2,1,3,4,3,4,2,1,1,0
2,0,0,2,14,7,7,3,0,0,2,2,7,3,4,2,0,0,2,2,4,2,2,1
3,4,1,4,3,2,1,0,4,1,3,4,1,0,1,0,4,1,3,4,1,0,1,0
1,2,3,0,13,3,10,1,2,3,1,0,10,3,7,0,2,3,1,0,7,2,5,0
1,4,3,1,7,2,5,1,4,3,1,1,5,1,4,1,4,3,1,1,4,1,3,0
0,2,3,3,13,1,12,8,2,3,0,3,12,1,11,7,2,3,0,3,11,1,10,6
0,2,3,1,22,2,20,5,2,3,0,1,20,2,18,5,2,3,0,1,18,1,17,5
2,1,1,4,9,4,5,4,1,1,2,4,5,2,3,2,1,1,2,4,3,1,2,1
4,4,3,1,12,10,2,0,4,3,4,1,2,1,1,0,4,3,4,1,1,0,1,0
1,4,2,3,7,2,5,3,4,2,1,3,5,1,4,2,4,2,1,3,4,1,3,2
4,3,2,0,7,6,1,0,3,2,4,0,1,0,1,0,3,2,4,0,1,0,1,0
2,3,4,0,17,8,9,0,3,4,2,0,9,4,5,0,3,4,2,0,5,2,3,0
1,3,1,1,6,1,5,1,3,1,1,1,5,1,4,1,3,1,1,1,4,1,3,0
3,1,0,3,12,8,4,2,1,0,3,3,4,2,2,1,1,0,3,3,2,1,1,0
4,3,2,3,11,9,2,1,3,2,4,3,2,1,1,0,3,2,4,3,1,0,1,0
3,0,3,1,25,17,8,2,0,3,3,1,8,5,3,0,0,3,3,1,3,2,1,0
3,3,1,0,2,1,1,0,3,1,3,0,1,0,1,0,3,1,3,0,1,0,1,0
3,2,2,2,7,4,3,1,2,2,3,2,3,2,1,0,2,2,3,2,1,0,1,0
0,0,0,2,9,0,9,4,0,0,0,2,9,0,9,4,0,0,0,2,9,0,9,4
3,1,3,1,29,20,9,2,1,3,3,1,9,6,3,0,1,3,3,1,3,2,1,0
1,1,3,0,18,5,13,1,1,3,1,0,13,3,10,1,1,3,1,0,10,3,7,0
4,4,4,4,4,3,1,0,4,4,4,4,1,0,1,0,4,4,4,4,1,0,1,0
1,3,0,3,0,0,0,0,3,0,1,3,0,0,0,0,3,0,1,3,0,0,0,0
0,0,3,3,27,2,25,17,0,3,0,3,25,2,23,16,0,3,0,3,23,2,21,14
4,0,0,0,11,9,2,0,0,0,4,0,2,1,1,0,0,0,4,0,1,0,1,0
3,2,0,0,2,1,1,0,2,0,3,0,1,0,1,0,2,0,3,0,1,0,1,0
1,1,1,4,12,3,9,8,1,1,1,4,9,2,7,6,1,1,1,4,7,2,5,4
1,4,0,3,2,0,2,1,4,0,1,3,2,0,2,1,4,0,1,3,2,0,2,1
1,3,2,3,12,3,9,6,3,2,1,3,9,2,7,4,3,2,1,3,7,2,5,3
2,4,3,3,6,2,4,2,4,3,2,3,4,2,2,1,4,3,2,3,2,0,2,1
4,1,2,0,13,11,2,0,1,2,4,0,2,1,1,0,1,2,4,0,1,0,1,0
4,2,2,4,13,11,2,1,2,2,4,4,2,1,1,0,2,2,4,4,1,0,1,0
3,3,3,2,11,7,4,1,3,3,3,2,4,2,2,0,3,3,3,2,2,1,1,0
4,3,1,0,6,5,1,0,3,1,4,0,1,0,1,0,3,1,4,0,1,0,1,0
4,1,2,4,20,17,3,2,1,2,4,4,3,2,1,0,1,2,4,4,1,0,1,0
0,0,4,4,27,2,25,22,0,4,0,4,25,2,23,20,0,4,0,4,23,2,21,18
2,4,0,4,5,2,3,2,4,0,2,4,3,1,2,1,4,0,2,4,2,1,1,0
3,1,0,2,0,0,0,0,1,0,3,2,0,0,0,0,1,0,3,2,0,0,0,0
4,3,1,0,13,11,2,0,3,1,4,0,2,1,1,0,3,1,4,0,1,0,1,0
2,4,2,0,3,1,2,0,4,2,2,0,2,0,2,0,4,2,2,0,2,0,2,0
1,2,1,1,15,4,11,3,2,1,1,1,11,3,8,2,2,1,1,1,8,2,6,1
3,1,1,0,13,9,4,0,1,1,3,0,4,2,2,0,1,1,3,0,2,1,1,0
3,2,1,2,5,3,2,1,2,1,3,2,2,1,1,0,2,1,3,2,1,0,1,0
0,2,3,3,22,2,20,13,2,3,0,3,20,2,18,12,2,3,0,3,18,1,17,11
4,4,1,4,0,0,0,0,4,1,4,4,0,0,0,0,4,1,4,4,0,0,0,0
2,2,0,1,5,2,3,0,2,0,2,1,3,1,2,0,2,0,2,1,2,0,2,0
4,0,2,3,26,23,3,2,0,2,4,3,3,2,1,0,0,2,4,3,1,0,1,0
1,0,3,0,24,7,17,1,0,3,1,0,17,5,12,1,0,3,1,0,12,3,9,0
1,0,4,4,26,7,19,17,0,4,1,4,19,5,14,12,0,4,1,4,14,4,10,9
1,2,1,3,8,2,6,4,2,1,1,3,6,1,5,3,2,1,1,3,5,1,4,2
4,4,2,3,8,7,1,0,4,2,4,3,1,0,1,0,4,2,4,3,1,0,1,0
3,4,4,4,7,4,3,2,4,4,3,4,3,2,1,0,4,4,3,4,1,0,1,0
3,0,4,1,29,20,9,2,0,4,3,1,9,6,3,0,0,4,3,1,3,2,1,0
4,3,1,2,3,2,1,0,3,1,4,2,1,0,1,0,3,1,4,2,1,0,1,0
0,1,3,3,19,1,18,12,1,3,0,3,18,1,17,11,1,3,0,3,17,1,16,11
3,1,2,3,22,15,7,4,1,2,3,3,7,4,3,2,1,2,3,3,3,2,1,0
4,4,3,2,7,6,1,0,4,3,4,2,1,0,1,0,4,3,4,2,1,0,1,0
4,1,3,1,25,22,3,0,1,3,4,1,3,2,1,0,1,3,4,1,1,0,1,0
1,2,3,2,19,5,14,6,2,3,1,2,14,4,10,5,2,3,1,2,10,2,8,4
1,0,0,3,7,2,5,3,0,0,1,3,5,1,4,2,0,0,1,3,4,1,3,2
0,0,4,1,28,2,26,7,0,4,0,1,26,2,24,7,0,4,0,1,24,2,22,6
1,4,0,4,0,0,0,0,4,0,1,4,0,0,0,0,4,0,1,4,0,0,0,0
1,3,1,2,20,5,15,7,3,1,1,2,15,4,11,5,3,1,1,2,11,3,8,3
4,4,1,4,8,7,1,0,4,1,4,4,1,0,1,0,4,1,4,4,1,0,1,0
4,4,4,3,10,9,1,0,4,4,4,3,1,0,1,0,4,4,4,3,1,0,1,0
1,1,4,0,29,8,21,2,1,4,1,0,21,6,15,1,1,4,1,0,15,4,11,1
1,3,4,4,15,4,11,9,3,4,1,4,11,3,8,7,3,4,1,4,8,2,6,5
0,3,1,1,10,1,9,2,3,1,0,1,9,0,9,2,3,1,0,1,9,0,9,2
1,4,0,0,5,1,4,0,4,0,1,0,4,1,3,0,4,0,1,0,3,0,3,0
1,1,2,0,20,6,14,1,1,2,1,0,14,4,10,0,1,2,1,0,10,3,7,0
4,4,4,0,3,2,1,0,4,4,4,0,1,0,1,0,4,4,4,0,1,0,1,0
3,3,2,2,6,4,2,0,3,2,3,2,2,1,1,0,3,2,3,2,1,0,1,0
4,0,3,0,28,25,3,0,0,3,4,0,3,2,1,0,0,3,4,0,1,0,1,0
2,0,4,1,27,13,14,4,0,4,2,1,14,7,7,2,0,4,2,1,7,3,4,1
1,3,3,4,11,3,8,7,3,3,1,4,8,2,6,5,3,3,1,4,6,1,5,4
2,3,4,3,12,6,6,4,3,4,2,3,6,3,3,2,3,4,2,3,3,1,2,1
2,4,0,2,0,0,0,0,4,0,2,2,0,0,0,0,4,0,2,2,0,0,0,0
0,0,3,3,25,2,23,16,0,3,0,3,23,2,21,14,0,3,0,3,21,2,19,13
0,3,1,1,3,0,3,0,3,1,0,1,3,0,3,0,3,1,0,1,3,0,3,0
2,1,2,4,14,7,7,6,1,2,2,4,7,3,4,3,1,2,2,4,4,1,3,2
4,2,1,1,7,6,1,0,2,1,4,1,1,0,1,0,2,1,4,1,1,0,1,0
0,3,2,3,3,0,3,2,3,2,0,3,3,0,3,2,3,2,0,3,3,0,3,2
2,1,3,3,16,7,9,6,1,3,2,3,9,4,5,3,1,3,2,3,5,2,3,2
2,0,4,0,27,13,14,1,0,4,2,0,14,7,7,0,0,4,2,0,7,3,4,0
3,3,2,4,13,9,4,3,3,2,3,4,4,2,2,1,3,2,3,4,2,1,1,0
2,0,3,2,26,12,14,7,0,3,2,2,14,7,7,3,0,3,2,2,7,3,4,2
4,0,1,1,14,12,2,0,0,1,4,1,2,1,1,0,0,1,4,1,1,0,1,0
0,0,1,3,16,1,15,10,0,1,0,3,15,1,14,9,0,1,0,3,14,1,13,9
0,2,3,2,18,1,17,8,2,3,0,2,17,1,16,7,2,3,0,2,16,1,15,7
3,4,2,2,4,2,2,1,4,2,3,2,2,1,1,0,4,2,3,2,1,0,1,0
2,2,4,1,28,13,15,4,2,4,2,1,15,7,8,2,2,4,2,1,8,3,5,1
2,4,1,0,9,4,5,0,4,1,2,0,5,2,3,0,4,1,2,0,3,1,2,0
4,3,3,3,15,13,2,1,3,3,4,3,2,1,1,0,3,3,4,3,1,0,1,0
4,2,3,0,15,13,2,0,2,3,4,0,2,1,1,0,2,3,4,0,1,0,1,0
1,0,0,4,3,0,3,2,0,0,1,4,3,0,3,2,0,0,1,4,3,0,3,2
3,0,3,1,21,14,7,2,0,3,3,1,7,4,3,0,0,3,3,1,3,2,1,0
1,0,1,2,12,3,9,4,0,1,1,2,9,2,7,3,0,1,1,2,7,2,5,2
0,1,1,3,9,0,9,6,1,1,0,3,9,0,9,6,1,1,0,3,9,0,9,6
2,1,2,4,18,9,9,8,1,2,2,4,9,4,5,4,1,2,2,4,5,2,3,2
4,4,0,1,0,0,0,0,4,0,4,1,0,0,0,0,4,0,4,1,0,0,0,0
1,3,1,4,3,0,3,2,3,1,1,4,3,0,3,2,3,1,1,4,3,0,3,2
1,2,2,1,17,5,12,3,2,2,1,1,12,3,9,2,2,2,1,1,9,2,7,2
3,3,3,1,11,7,4,1,3,3,3,1,4,2,2,0,3,3,3,1,2,1,1,0
4,0,3,0,25,22,3,0,0,3,4,0,3,2,1,0,0,3,4,0,1,0,1,0
1,2,3,3,15,4,11,7,2,3,1,3,11,3,8,5,2,3,1,3,8,2,6,4
4,2,0,1,10,9,1,0,2,0,4,1,1,0,1,0,2,0,4,1,1,0,1,0
0,0,3,2,25,2,23,11,0,3,0,2,23,2,21,10,0,3,0,2,21,2,19,9
3,2,0,0,3,2,1,0,2,0,3,0,1,0,1,0,2,0,3,0,1,0,1,0
1,1,2,0,14,4,10,0,1,2,1,0,10,3,7,0,1,2,1,0,7,2,5,0
4,0,4,0,29,26,3,0,0,4,4,0,3,2,1,0,0,4,4,0,1,0,1,0
2,2,2,2,13,6,7,3,2,2,2,2,7,3,4,2,2,2,2,2,4,2,2,0
4,0,2,1,23,20,3,0,0,2,4,1,3,2,1,0,0,2,4,1,1,0,1,0
1,4,4,4,7,2,5,4,4,4,1,4,5,1,4,3,4,4,1,4,4,1,3,2
1,0,2,1,26,7,19,5,0,2,1,1,19,5,14,4,0,2,1,1,14,4,10,2
4,0,0,4,9,8,1,0,0,0,4,4,1,0,1,0,0,0,4,4,1,0,1,0
2,1,0,0,11,5,6,0,1,0,2,0,6,3,3,0,1,0,2,0,3,1,2,0
3,2,1,2,9,6,3,1,2,1,3,2,3,2,1,0,2,1,3,2,1,0,1,0
0,0,4,2,29,2,27,13,0,4,0,2,27,2,25,12,0,4,0,2,25,2,23,11
4,0,3,0,26,23,3,0,0,3,4,0,3,2,1,0,0,3,4,0,1,0,1,0
4,4,4,0,3,2,1,0,4,4,4,0,1,0,1,0,4,4,4,0,1,0,1,0
0,3,3,2,15,1,14,7,3,3,0,2,14,1,13,6,3,3,0,2,13,1,12,6
3,4,1,3,5,3,2,1,4,1,3,3,2,1,1,0,4,1,3,3,1,0,1,0
3,1,1,0,18,12,6,0,1,1,3,0,6,4,2,0,1,1,3,0,2,1,1,0
2,3,4,4,14,7,7,6,3,4,2,4,7,3,4,3,3,4,2,4,4,1,3,2
3,4,4,3,7,4,3,2,4,4,3,3,3,2,1,0,4,4,3,3,1,0,1,0
1,2,3,0,12,3,9,0,2,3,1,0,9,2,7,0,2,3,1,0,7,2,5,0
3,2,2,4,8,5,3,2,2,2,3,4,3,2,1,0,2,2,3,4,1,0,1,0
3,1,3,2,22,15,7,3,1,3,3,2,7,4,3,1,1,3,3,2,3,2,1,0
1,0,1,0,17,5,12,1,0,1,1,0,12,3,9,0,0,1,1,0,9,2,7,0
3,0,3,3,27,18,9,6,0,3,3,3,9,6,3,2,0,3,3,3,3,2,1,0
4,2,1,2,4,3,1,0,2,1,4,2,1,0,1,0,2,1,4,2,1,0,1,0
1,3,1,3,6,1,5,3,3,1,1,3,5,1,4,2,3,1,1,3,4,1,3,2
2,2,1,1,10,4,6,1,2,1,2,1,6,3,3,0,2,1,2,1,3,1,2,0
1,0,0,0,7,2,5,0,0,0,1,0,5,1,4,0,0,0,1,0,4,1,3,0
2,4,3,3,5,2,3,2,4,3,2,3,3,1,2,1,4,3,2,3,2,0,2,1
3,2,2,2,5,3,2,1,2,2,3,2,2,1,1,0,2,2,3,2,1,0,1,0
2,2,1,4,2,0,2,1,2,1,2,4,2,1,1,0,2,1,2,4,1,0,1,0
4,1,2,4,21,18,3,2,1,2,4,4,3,2,1,0,1,2,4,4,1,0,1,0
2,3,2,3,9,4,5,3,3,2,2,3,5,2,3,2,3,2,2,3,3,1,2,1
1,1,0,4,15,4,11,9,1,0,1,4,11,3,8,7,1,0,1,4,8,2,6,5
0,1,1,3,14,1,13,9,1,1,0,3,13,1,12,8,1,1,0,3,12,1,11,7
2,4,2,0,7,3,4,0,4,2,2,0,4,1,3,0,4,2,2,0,3,1,2,0
4,3,2,1,16,14,2,0,3,2,4,1,2,1,1,0,3,2,4,1,1,0,1,0
1,2,0,4,3,0,3,2,2,0,1,4,3,0,3,2,2,0,1,4,3,0,3,2
4,0,1,1,21,18,3,0,0,1,4,1,3,2,1,0,0,1,4,1,1,0,1,0
4,4,4,1,6,5,1,0,4,4,4,1,1,0,1,0,4,4,4,1,1,0,1,0
4,0,0,2,8,7,1,0,0,0,4,2,1,0,1,0,0,0,4,2,1,0,1,0
0,0,4,0,27,2,25,2,0,4,0,0,25,2,23,2,0,4,0,0,23,2,21,2
3,2,2,1,18,12,6,1,2,2,3,1,6,4,2,0,2,2,3,1,2,1,1,0
2,3,4,1,10,5,5,1,3,4,2,1,5,2,3,0,3,4,2,1,3,1,2,0
3,4,3,2,9,6,3,1,4,3,3,2,3,2,1,0,4,3,3,2,1,0,1,0
0,2,0,0,10,1,9,0,2,0,0,0,9,0,9,0,2,0,0,0,9,0,9,0
4,2,1,4,6,5,1,0,2,1,4,4,1,0,1,0,2,1,4,4,1,0,1,0
2,1,4,3,24,11,13,9,1,4,2,3,13,6,7,4,1,4,2,3,7,3,4,2
1,0,2,0,14,4,10,1,0,2,1,0,10,2,8,0,0,2,1,0,8,2,6,0
4,2,1,4,9,8,1,0,2,1,4,4,1,0,1,0,2,1,4,4,1,0,1,0
2,3,3,3,8,4,4,2,3,3,2,3,4,1,3,2,3,3,2,3,3,1,2,1
2,3,1,2,2,0,2,0,3,1,2,2,2,0,2,1,3,1,2,2,2,1,1,0
2,1,2,0,18,9,9,0,1,2,2,0,9,4,5,0,1,2,2,0,5,2,3,0
1,0,1,0,15,4,11,1,0,1,1,0,11,3,8,0,0,1,1,0,8,2,6,0
2,3,4,1,14,6,8,2,3,4,2,1,8,3,5,1,3,4,2,1,5,2,3,0
4,3,0,4,2,1,1,0,3,0,4,4,1,0,1,0,3,0,4,4,1,0,1,0
0,3,1,3,11,1,10,6,3,1,0,3,10,1,9,6,3,1,0,3,9,0,9,6
4,3,2,0,4,3,1,0,3,2,4,0,1,0,1,0,3,2,4,0,1,0,1,0
0,4,1,2,8,0,8,4,4,1,0,2,8,0,8,4,4,1,0,2,8,0,8,3
3,1,3,0,22,15,7,0,1,3,3,0,7,4,3,0,1,3,3,0,3,2,1,0
3,0,4,1,29,20,9,2,0,4,3,1,9,6,3,0,0,4,3,1,3,2,1,0
3,4,1,3,15,10,5,3,4,1,3,3,5,3,2,1,4,1,3,3,2,1,1,0
2,3,1,0,3,1,2,0,3,1,2,0,2,0,2,0,3,1,2,0,2,0,2,0
3,1,2,2,13,9,4,1,1,2,3,2,4,2,2,1,1,2,3,2,2,1,1,0
0,3,0,3,0,0,0,0,3,0,0,3,0,0,0,0,3,0,0,3,0,0,0,0
2,1,0,0,3,1,2,0,1,0,2,0,2,0,2,0,1,0,2,0,2,1,1,0
2,2,1,1,20,10,10,3,2,1,2,1,10,4,6,1,2,1,2,1,6,3,3,0
4,0,1,2,19,17,2,0,0,1,4,2,2,1,1,0,0,1,4,2,1,0,1,0
1,4,2,3,3,0,3,2,4,2,1,3,3,0,3,2,4,2,1,3,3,0,3,2
0,2,0,2,2,0,2,1,2,0,0,2,2,0,2,1,2,0,0,2,2,0,2,0
4,3,4,1,12,10,2,0,3,4,4,1,2,1,1,0,3,4,4,1,1,0,1,0
0,0,0,4,9,0,9,8,0,0,0,4,9,0,9,8,0,0,0,4,9,0,9,8
3,2,1,1,1,0,1,0,2,1,3,1,1,0,1,0,2,1,3,1,1,0,1,0
0,1,0,4,14,1,13,11,1,0,0,4,13,1,12,10,1,0,0,4,12,1,11,9
2,4,4,0,11,5,6,0,4,4,2,0,6,2,4,0,4,4,2,0,4,2,2,0
1,3,1,2,6,1,5,2,3,1,1,2,5,1,4,1,3,1,1,2,4,1,3,1
4,4,4,2,7,6,1,0,4,4,4,2,1,0,1,0,4,4,4,2,1,0,1,0
0,4,0,2,0,0,0,0,4,0,0,2,0,0,0,0,4,0,0,2,0,0,0,0
2,3,3,3,6,3,3,2,3,3,2,3,3,1,2,1,3,3,2,3,2,1,1,0
4,2,1,0,16,14,2,0,2,1,4,0,2,1,1,0,2,1,4,0,1,0,1,0
4,0,4,3,29,26,3,2,0,4,4,3,3,2,1,0,0,4,4,3,1,0,1,0
1,2,0,0,5,1,4,0,2,0,1,0,4,1,3,0,2,0,1,0,3,0,3,0
0,4,3,4,8,0,8,7,4,3,0,4,8,0,8,7,4,3,0,4,8,0,8,7
1,3,2,0,10,2,8,0,3,2,1,0,8,2,6,0,3,2,1,0,6,1,5,0
1,2,3,2,19,5,14,6,2,3,1,2,14,4,10,5,2,3,1,2,10,2,8,4
4,2,4,3,17,15,2,1,2,4,4,3,2,1,1,0,2,4,4,3,1,0,1,0
4,0,2,2,26,23,3,1,0,2,4,2,3,2,1,0,0,2,4,2,1,0,1,0
4,0,3,2,28,25,3,1,0,3,4,2,3,2,1,0,0,3,4,2,1,0,1,0
3,2,2,4,11,7,4,3,2,2,3,4,4,2,2,1,2,2,3,4,2,1,1,0
2,4,4,2,4,2,2,0,4,4,2,2,2,0,2,0,4,4,2,2,2,0,2,1
0,3,3,0,10,1,9,0,3,3,0,0,9,0,9,0,3,3,0,0,9,0,9,0
4,0,2,3,19,17,2,1,0,2,4,3,2,1,1,0,0,2,4,3,1,0,1,0
3,1,0,1,1,0,1,0,1,0,3,1,1,0,1,0,1,0,3,1,1,0,1,0
3,1,2,3,13,9,4,2,1,2,3,3,4,2,2,1,1,2,3,3,2,1,1,0
0,0,0,2,2,0,2,0,0,0,0,2,2,0,2,1,0,0,0,2,2,0,2,0
4,2,1,4,7,6,1,0,2,1,4,4,1,0,1,0,2,1,4,4,1,0,1,0
3,1,0,3,5,3,2,1,1,0,3,3,2,1,1,0,1,0,3,3,1,0,1,0
4,3,0,4,6,5,1,0,3,0,4,4,1,0,1,0,3,0,4,4,1,0,1,0
2,4,0,4,2,1,1,0,4,0,2,4,1,0,1,0,4,0,2,4,1,0,1,0
2,2,4,0,23,11,12,1,2,4,2,0,12,5,7,0,2,4,2,0,7,3,4,0
3,2,2,0,21,14,7,0,2,2,3,0,7,4,3,0,2,2,3,0,3,2,1,0
1,1,0,2,11,3,8,4,1,0,1,2,8,2,6,3,1,0,1,2,6,1,5,2
4,2,0,2,2,1,1,0,2,0,4,2,1,0,1,0,2,0,4,2,1,0,1,0
0,3,2,0,6,0,6,0,3,2,0,0,6,0,6,0,3,2,0,0,6,0,6,0
3,3,1,4,10,6,4,3,3,1,3,4,4,2,2,1,3,1,3,4,2,1,1,0
3,2,4,3,26,18,8,5,2,4,3,3,8,5,3,2,2,4,3,3,3,2,1,0
3,1,3,4,20,14,6,5,1,3,3,4,6,4,2,1,1,3,3,4,2,1,1,0
0,0,4,4,29,2,27,24,0,4,0,4,27,2,25,22,0,4,0,4,25,2,23,20
1,2,4,3,19,5,14,9,2,4,1,3,14,4,10,7,2,4,1,3,10,2,8,5
1,0,2,4,28,8,20,18,0,2,1,4,20,5,15,13,0,2,1,4,15,4,11,9
4,0,0,3,7,6,1,0,0,0,4,3,1,0,1,0,0,0,4,3,1,0,1,0
4,2,4,3,23,20,3,2,2,4,4,3,3,2,1,0,2,4,4,3,1,0,1,0
1,4,3,3,2,0,2,1,4,3,1,3,2,0,2,1,4,3,1,3,2,0,2,1
3,2,0,4,8,5,3,2,2,0,3,4,3,2,1,0,2,0,3,4,1,0,1,0
0,3,1,4,0,0,0,0,3,1,0,4,0,0,0,0,3,1,0,4,0,0,0,0
3,0,1,4,11,7,4,3,0,1,3,4,4,2,2,1,0,1,3,4,2,1,1,0
4,1,1,3,16,14,2,1,1,1,4,3,2,1,1,0,1,1,4,3,1,0,1,0
3,0,0,1,10,7,3,0,0,0,3,1,3,2,1,0,0,0,3,1,1,0,1,0
4,2,1,2,14,12,2,0,2,1,4,2,2,1,1,0,2,1,4,2,1,0,1,0
4,2,3,3,12,10,2,1,2,3,4,3,2,1,1,0,2,3,4,3,1,0,1,0
4,2,3,3,12,10,2,1,2,3,4,3,2,1,1,0,2,3,4,3,1,0,1,0
4,2,1,0,2,1,1,0,2,1,4,0,1,0,1,0,2,1,4,0,1,0,1,0
0,4,3,2,7,0,7,3,4,3,0,2,7,0,7,3,4,3,0,2,7,0,7,3
0,1,0,3,10,0,10,7,1,0,0,3,10,1,9,6,1,0,0,3,9,0,9,6
4,3,2,2,16,14,2,1,3,2,4,2,2,1,1,0,3,2,4,2,1,0,1,0
3,4,4,3,11,7,4,2,4,4,3,3,4,2,2,1,4,4,3,3,2,1,1,0
1,3,2,0,9,2,7,0,3,2,1,0,7,2,5,0,3,2,1,0,5,1,4,0
0,3,4,2,4,0,4,1,3,4,0,2,4,0,4,1,3,4,0,2,4,0,4,2
2,0,4,2,29,14,15,7,0,4,2,2,15,7,8,3,0,4,2,2,8,3,5,2
2,0,4,2,21,10,11,5,0,4,2,2,11,5,6,2,0,4,2,2,6,3,3,1
4,3,2,4,6,5,1,0,3,2,4,4,1,0,1,0,3,2,4,4,1,0,1,0
1,4,2,3,7,2,5,3,4,2,1,3,5,1,4,2,4,2,1,3,4,1,3,2
0,2,0,4,8,0,8,7,2,0,0,4,8,0,8,7,2,0,0,4,8,0,8,7
2,2,3,3,18,8,10,6,2,3,2,3,10,5,5,3,2,3,2,3,5,2,3,2
3,1,3,1,24,16,8,2,1,3,3,1,8,5,3,0,1,3,3,1,3,2,1,0
0,0,3,1,24,2,22,6,0,3,0,1,22,2,20,6,0,3,0,1,20,1,19,5
3,4,1,1,2,1,1,0,4,1,3,1,1,0,1,0,4,1,3,1,1,0,1,0
0,0,3,4,25,2,23,20,0,3,0,4,23,2,21,18,0,3,0,4,21,2,19,17
2,0,2,3,25,12,13,9,0,2,2,3,13,6,7,4,0,2,2,3,7,3,4,2
0,0,3,1,26,2,24,7,0,3,0,1,24,2,22,6,0,3,0,1,22,2,20,6
2,4,4,2,7,3,4,2,4,4,2,2,4,2,2,1,4,4,2,2,2,0,2,1
2,4,4,3,8,4,4,2,4,4,2,3,4,1,3,2,4,4,2,3,3,1,2,1
2,2,2,0,12,6,6,0,2,2,2,0,6,2,4,0,2,2,2,0,4,2,2,0
0,1,4,3,23,2,21,14,1,4,0,3,21,2,19,13,1,4,0,3,19,1,18,12
4,0,1,4,9,8,1,0,0,1,4,4,1,0,1,0,0,1,4,4,1,0,1,0
4,3,3,3,16,14,2,1,3,3,4,3,2,1,1,0,3,3,4,3,1,0,1,0
2,2,3,2,7,3,4,1,2,3,2,2,4,1,3,1,2,3,2,2,3,1,2,0
0,3,2,3,13,1,12,8,3,2,0,3,12,1,11,7,3,2,0,3,11,1,10,6
2,0,3,2,26,12,14,7,0,3,2,2,14,6,8,3,0,3,2,2,8,4,4,2
3,0,2,1,27,18,9,2,0,2,3,1,9,6,3,0,0,2,3,1,3,2,1,0
4,3,4,1,19,17,2,0,3,4,4,1,2,1,1,0,3,4,4,1,1,0,1,0
3,3,2,2,16,11,5,2,3,2,3,2,5,3,2,0,3,2,3,2,2,1,1,0
1,1,3,1,20,5,15,4,1,3,1,1,15,4,11,3,1,3,1,1,11,3,8,2
4,4,3,1,5,4,1,0,4,3,4,1,1,0,1,0,4,3,4,1,1,0,1,0
2,3,3,3,18,9,9,6,3,3,2,3,9,4,5,3,3,3,2,3,5,2,3,2
1,1,1,4,19,5,14,12,1,1,1,4,14,4,10,8,1,1,1,4,10,2,8,7
0,4,0,2,3,0,3,1,4,0,0,2,3,0,3,1,4,0,0,2,3,0,3,1
4,0,1,3,15,13,2,1,0,1,4,3,2,1,1,0,0,1,4,3,1,0,1,0
4,3,0,2,4,3,1,0,3,0,4,2,1,0,1,0,3,0,4,2,1,0,1,0
0,2,2,2,18,1,17,8,2,2,0,2,17,1,16,7,2,2,0,2,16,1,15,7
2,0,2,3,19,9,10,6,0,2,2,3,10,5,5,3,0,2,2,3,5,2,3,2
0,1,4,2,26,2,24,11,1,4,0,2,24,2,22,11,1,4,0,2,22,2,20,9
1,0,2,0,27,8,19,1,0,2,1,0,19,5,14,1,0,2,1,0,14,4,10,0
0,0,1,1,12,1,11,3,0,1,0,1,11,1,10,3,0,1,0,1,10,0,10,2
3,0,1,4,8,5,3,2,0,1,3,4,3,2,1,0,0,1,3,4,1,0,1,0
3,4,0,2,5,3,2,1,4,0,3,2,2,1,1,0,4,0,3,2,1,0,1,0
0,3,3,2,14,1,13,6,3,3,0,2,13,1,12,5,3,3,0,2,12,1,11,5
4,4,1,2,0,0,0,0,4,1,4,2,0,0,0,0,4,1,4,2,0,0,0,0
4,3,0,2,8,7,1,0,3,0,4,2,1,0,1,0,3,0,4,2,1,0,1,0
2,1,2,4,18,9,9,8,1,2,2,4,9,4,5,4,1,2,2,4,5,2,3,2
4,4,1,4,6,5,1,0,4,1,4,4,1,0,1,0,4,1,4,4,1,0,1,0
1,3,1,1,0,0,0,0,3,1,1,1,0,0,0,0,3,1,1,1,0,0,0,0
0,2,4,4,22,2,20,18,2,4,0,4,20,1,19,17,2,4,0,4,19,1,18,16
2,3,3,3,9,4,5,3,3,3,2,3,5,2,3,2,3,3,2,3,3,1,2,1
2,2,1,3,12,5,7,4,2,1,2,3,7,3,4,2,2,1,2,3,4,1,3,2
1,1,2,3,19,5,14,9,1,2,1,3,14,4,10,7,1,2,1,3,10,2,8,5
2,3,0,1,4,1,3,0,3,0,2,1,3,1,2,0,3,0,2,1,2,0,2,0
4,4,4,1,11,9,2,0,4,4,4,1,2,1,1,0,4,4,4,1,1,0,1,0
3,3,2,3,12,8,4,2,3,2,3,3,4,2,2,1,3,2,3,3,2,1,1,0
2,3,0,1,6,3,3,0,3,0,2,1,3,1,2,0,3,0,2,1,2,1,1,0
0,1,1,0,11,1,10,0,1,1,0,0,10,1,9,0,1,1,0,0,9,0,9,0
0,4,2,4,3,0,3,2,4,2,0,4,3,0,3,2,4,2,0,4,3,0,3,2
3,3,1,1,9,6,3,0,3,1,3,1,3,2,1,0,3,1,3,1,1,0,1,0
4,3,2,0,18,16,2,0,3,2,4,0,2,1,1,0,3,2,4,0,1,0,1,0
3,2,4,1,13,9,4,1,2,4,3,1,4,2,2,0,2,4,3,1,2,1,1,0
1,3,4,4,17,5,12,10,3,4,1,4,12,3,9,8,3,4,1,4,9,2,7,6
1,0,1,0,6,1,5,0,0,1,1,0,5,1,4,0,0,1,1,0,4,1,3,0
1,0,2,3,17,5,12,8,0,2,1,3,12,3,9,6,0,2,1,3,9,2,7,4
2,2,3,0,15,7,8,0,2,3,2,0,8,4,4,0,2,3,2,0,4,1,3,0
3,4,3,2,3,2,1,0,4,3,3,2,1,0,1,0,4,3,3,2,1,0,1,0
3,0,2,0,26,18,8,0,0,2,3,0,8,5,3,0,0,2,3,0,3,2,1,0
2,2,3,4,19,9,10,9,2,3,2,4,10,5,5,4,2,3,2,4,5,2,3,2
2,1,0,1,2,0,2,0,1,0,2,1,2,0,2,0,1,0,2,1,2,0,2,0
0,1,2,0,18,1,17,1,1,2,0,0,17,1,16,1,1,2,0,0,16,1,15,1
1,1,4,0,26,7,19,1,1,4,1,0,19,5,14,1,1,4,1,0,14,4,10,1
2,2,2,2,6,2,4,1,2,2,2,2,4,1,3,1,2,2,2,2,3,1,2,1
3,3,1,2,5,3,2,0,3,1,3,2,2,1,1,0,3,1,3,2,1,0,1,0
4,2,0,1,5,4,1,0,2,0,4,1,1,0,1,0,2,0,4,1,1,0,1,0
4,0,4,1,28,25,3,0,0,4,4,1,3,2,1,0,0,4,4,1,1,0,1,0
3,4,2,0,6,4,2,0,4,2,3,0,2,1,1,0,4,2,3,0,1,0,1,0
2,2,3,2,19,9,10,4,2,3,2,2,10,5,5,2,2,3,2,2,5,2,3,1
1,0,4,4,26,7,19,17,0,4,1,4,19,5,14,12,0,4,1,4,14,4,10,8
4,3,4,4,21,18,3,2,3,4,4,4,3,2,1,0,3,4,4,4,1,0,1,0
1,0,1,2,16,4,12,5,0,1,1,2,12,3,9,4,0,1,1,2,9,2,7,3
2,3,2,2,9,4,5,2,3,2,2,2,5,2,3,1,3,2,2,2,3,1,2,0
3,4,4,1,3,2,1,0,4,4,3,1,1,0,1,0,4,4,3,1,1,0,1,0
1,2,3,2,23,6,17,8,2,3,1,2,17,5,12,6,2,3,1,2,12,3,9,4
0,0,0,1,13,1,12,3,0,0,0,1,12,1,11,3,0,0,0,1,11,1,10,2
1,4,1,2,8,2,6,3,4,1,1,2,6,1,5,2,4,1,1,2,5,1,4,2
4,3,4,3,22,19,3,2,3,4,4,3,3,2,1,0,3,4,4,3,1,0,1,0
1,1,1,3,2,0,2,1,1,1,1,3,2,0,2,1,1,1,1,3,2,0,2,1
0,2,4,0,21,2,19,1,2,4,0,0,19,1,18,1,2,4,0,0,18,1,17,1
3,2,4,1,11,7,4,1,2,4,3,1,4,2,2,0,2,4,3,1,2,1,1,0
0,2,2,2,21,2,19,9,2,2,0,2,19,1,18,8,2,2,0,2,18,1,17,8
0,3,1,0,13,1,12,1,3,1,0,0,12,1,11,1,3,1,0,0,11,1,10,0
3,4,0,1,3,2,1,0,4,0,3,1,1,0,1,0,4,0,3,1,1,0,1,0
3,0,4,4,29,20,9,8,0,4,3,4,9,6,3,2,0,4,3,4,3,2,1,0
0,3,3,4,3,0,3,2,3,3,0,4,3,0,3,2,3,3,0,4,3,0,3,2
4,0,4,3,29,26,3,2,0,4,4,3,3,2,1,0,0,4,4,3,1,0,1,0
4,1,0,0,5,4,1,0,1,0,4,0,1,0,1,0,1,0,4,0,1,0,1,0
3,1,2,2,22,15,7,3,1,2,3,2,7,4,3,1,1,2,3,2,3,2,1,0
4,0,1,1,24,21,3,0,0,1,4,1,3,2,1,0,0,1,4,1,1,0,1,0
3,2,3,0,25,17,8,0,2,3,3,0,8,5,3,0,2,3,3,0,3,2,1,0
4,3,2,3,11,9,2,1,3,2,4,3,2,1,1,0,3,2,4,3,1,0,1,0
4,1,4,1,23,20,3,0,1,4,4,1,3,2,1,0,1,4,4,1,1,0,1,0
0,1,4,1,27,2,25,7,1,4,0,1,25,2,23,6,1,4,0,1,23,2,21,6
3,4,0,0,9,6,3,0,4,0,3,0,3,2,1,0,4,0,3,0,1,0,1,0
4,3,1,4,7,6,1,0,3,1,4,4,1,0,1,0,3,1,4,4,1,0,1,0
3,2,3,1,16,11,5,1,2,3,3,1,5,3,2,0,2,3,3,1,2,1,1,0
0,2,4,0,18,1,17,1,2,4,0,0,17,1,16,1,2,4,0,0,16,1,15,1
2,2,0,2,4,1,3,1,2,0,2,2,3,1,2,1,2,0,2,2,2,0,2,1
3,2,4,4,16,11,5,4,2,4,3,4,5,3,2,1,2,4,3,4,2,1,1,0
1,4,0,1,18,5,13,3,4,0,1,1,13,3,10,3,4,0,1,1,10,2,8,2
1,0,1,2,22,6,16,8,0,1,1,2,16,4,12,6,0,1,1,2,12,3,9,4
0,2,3,4,16,1,15,13,2,3,0,4,15,1,14,12,2,3,0,4,14,1,13,11
0,3,1,1,13,1,12,3,3,1,0,1,12,1,11,3,3,1,0,1,11,1,10,3
0,2,2,1,21,2,19,5,2,2,0,1,19,1,18,5,2,2,0,1,18,1,17,5
2,2,4,0,19,9,10,0,2,4,2,0,10,5,5,0,2,4,2,0,5,2,3,0
0,0,3,1,29,2,27,8,0,3,0,1,27,2,25,7,0,3,0,1,25,2,23,6
4,0,2,2,22,19,3,1,0,2,4,2,3,2,1,0,0,2,4,2,1,0,1,0
2,1,3,2,13,6,7,3,1,3,2,2,7,3,4,1,1,3,2,2,4,1,3,1
4,4,1,0,3,2,1,0,4,1,4,0,1,0,1,0,4,1,4,0,1,0,1,0
4,1,1,4,13,11,2,1,1,1,4,4,2,1,1,0,1,1,4,4,1,0,1,0
3,3,2,3,4,2,2,1,3,2,3,3,2,1,1,0,3,2,3,3,1,0,1,0
3,1,0,1,11,7,4,1,1,0,3,1,4,2,2,0,1,0,3,1,2,1,1,0
3,2,2,4,21,14,7,6,2,2,3,4,7,4,3,2,2,2,3,4,3,2,1,0
3,0,3,3,24,16,8,5,0,3,3,3,8,5,3,2,0,3,3,3,3,2,1,0
2,1,3,3,24,12,12,8,1,3,2,3,12,5,7,4,1,3,2,3,7,3,4,2
0,0,4,3,27,2,25,17,0,4,0,3,25,2,23,16,0,4,0,3,23,2,21,14
1,1,4,0,27,8,19,1,1,4,1,0,19,5,14,1,1,4,1,0,14,4,10,1
4,1,0,3,16,14,2,1,1,0,4,3,2,1,1,0,1,0,4,3,1,0,1,0
0,2,1,1,16,1,15,4,2,1,0,1,15,1,14,4,2,1,0,1,14,1,13,3
4,2,0,0,8,7,1,0,2,0,4,0,1,0,1,0,2,0,4,0,1,0,1,0
0,4,3,4,5,0,5,4,4,3,0,4,5,0,5,4,4,3,0,4,5,0,5,4
3,3,2,2,14,9,5,2,3,2,3,2,5,3,2,0,3,2,3,2,2,1,1,0
1,4,4,3,20,6,14,9,4,4,1,3,14,4,10,7,4,4,1,3,10,3,7,4
2,2,4,4,23,11,12,10,2,4,2,4,12,6,6,5,2,4,2,4,6,2,4,3
0,2,1,2,3,0,3,1,2,1,0,2,3,0,3,1,2,1,0,2,3,0,3,1
1,1,2,3,21,6,15,10,1,2,1,3,15,4,11,7,1,2,1,3,11,3,8,5
4,0,1,1,23,20,3,0,0,1,4,1,3,2,1,0,0,1,4,1,1,0,1,0
0,4,4,4,4,0,4,3,4,4,0,4,4,0,4,3,4,4,0,4,4,0,4,3
4,2,0,3,1,0,1,0,2,0,4,3,1,0,1,0,2,0,4,3,1,0,1,0
3,3,1,0,11,7,4,0,3,1,3,0,4,2,2,0,3,1,3,0,2,1,1,0
3,3,3,4,4,2,2,1,3,3,3,4,2,1,1,0,3,3,3,4,1,0,1,0
1,3,1,1,5,1,4,1,3,1,1,1,4,1,3,0,3,1,1,1,3,0,3,0
2,0,3,2,19,9,10,5,0,3,2,2,10,4,6,2,0,3,2,2,6,2,4,2
3,2,2,0,15,10,5,0,2,2,3,0,5,3,2,0,2,2,3,0,2,1,1,0
4,4,1,1,5,4,1,0,4,1,4,1,1,0,1,0,4,1,4,1,1,0,1,0
4,2,2,1,6,5,1,0,2,2,4,1,1,0,1,0,2,2,4,1,1,0,1,0
0,0,0,3,6,0,6,4,0,0,0,3,6,0,6,4,0,0,0,3,6,0,6,4
4,4,3,3,6,5,1,0,4,3,4,3,1,0,1,0,4,3,4,3,1,0,1,0
0,4,4,0,5,0,5,0,4,4,0,0,5,0,5,0,4,4,0,0,5,0,5,0
3,2,2,1,14,9,5,1,2,2,3,1,5,3,2,0,2,2,3,1,2,1,1,0
3,4,4,1,3,2,1,0,4,4,3,1,1,0,1,0,4,4,3,1,1,0,1,0
0,3,3,0,12,1,11,1,3,3,0,0,11,1,10,1,3,3,0,0,10,0,10,0
2,3,1,2,6,2,4,1,3,1,2,2,4,1,3,1,3,1,2,2,3,1,2,0
2,4,2,3,5,2,3,2,4,2,2,3,3,1,2,1,4,2,2,3,2,0,2,1
2,0,1,3,13,6,7,4,0,1,2,3,7,3,4,2,0,1,2,3,4,1,3,2
1,3,3,1,11,3,8,2,3,3,1,1,8,2,6,1,3,3,1,1,6,1,5,1
0,0,2,4,26,2,24,21,0,2,0,4,24,2,22,19,0,2,0,4,22,2,20,17
1,4,0,0,3,0,3,0,4,0,1,0,3,0,3,0,4,0,1,0,3,0,3,0
4,4,4,2,14,12,2,0,4,4,4,2,2,1,1,0,4,4,4,2,1,0,1,0
1,2,3,2,11,3,8,3,2,3,1,2,8,2,6,3,2,3,1,2,6,1,5,2
3,1,1,0,15,10,5,0,1,1,3,0,5,3,2,0,1,1,3,0,2,1,1,0
0,4,2,0,5,0,5,0,4,2,0,0,5,0,5,0,4,2,0,0,5,0,5,0
4,2,2,2,14,12,2,1,2,2,4,2,2,1,1,0,2,2,4,2,1,0,1,0
3,1,2,0,24,16,8,0,1,2,3,0,8,5,3,0,1,2,3,0,3,2,1,0
3,1,4,1,25,17,8,2,1,4,3,1,8,5,3,0,1,4,3,1,3,2,1,0
3,3,1,2,8,5,3,1,3,1,3,2,3,2,1,0,3,1,3,2,1,0,1,0
2,0,1,0,14,6,8,0,0,1,2,0,8,4,4,0,0,1,2,0,4,2,2,0
3,3,0,1,6,4,2,0,3,0,3,1,2,1,1,0,3,0,3,1,1,0,1,0
4,4,2,2,6,5,1,0,4,2,4,2,1,0,1,0,4,2,4,2,1,0,1,0
1,1,1,3,19,5,14,9,1,1,1,3,14,4,10,7,1,1,1,3,10,2,8,5
1,0,3,1,25,7,18,5,0,3,1,1,18,5,13,3,0,3,1,1,13,3,10,3
1,4,0,4,6,1,5,4,4,0,1,4,5,1,4,3,4,0,1,4,4,1,3,2
3,3,2,1,7,4,3,0,3,2,3,1,3,2,1,0,3,2,3,1,1,0,1,0
3,4,1,1,5,3,2,0,4,1,3,1,2,1,1,0,4,1,3,1,1,0,1,0
3,0,4,2,29,20,9,4,0,4,3,2,9,6,3,1,0,4,3,2,3,2,1,0
2,2,2,4,11,5,6,5,2,2,2,4,6,3,3,2,2,2,2,4,3,1,2,1
2,1,2,4,16,7,9,8,1,2,2,4,9,4,5,4,1,2,2,4,5,2,3,2
2,1,0,1,5,2,3,0,1,0,2,1,3,1,2,0,1,0,2,1,2,0,2,0
2,2,0,4,2,1,1,0,2,0,2,4,1,0,1,0,2,0,2,4,1,0,1,0
0,3,4,1,15,1,14,4,3,4,0,1,14,1,13,3,3,4,0,1,13,1,12,3
4,3,2,3,18,16,2,1,3,2,4,3,2,1,1,0,3,2,4,3,1,0,1,0
4,2,3,3,25,22,3,2,2,3,4,3,3,2,1,0,2,3,4,3,1,0,1,0
4,4,4,0,3,2,1,0,4,4,4,0,1,0,1,0,4,4,4,0,1,0,1,0
3,0,4,4,27,18,9,8,0,4,3,4,9,6,3,2,0,4,3,4,3,2,1,0
3,0,1,2,26,18,8,3,0,1,3,2,8,5,3,1,0,1,3,2,3,2,1,0
2,1,0,3,1,0,1,0,1,0,2,3,1,0,1,0,1,0,2,3,1,0,1,0
1,3,3,0,10,2,8,0,3,3,1,0,8,2,6,0,3,3,1,0,6,1,5,0
2,1,2,2,9,4,5,2,1,2,2,2,5,2,3,1,1,2,2,2,3,1,2,1
3,0,1,1,6,4,2,0,0,1,3,1,2,1,1,0,0,1,3,1,1,0,1,0
0,1,0,4,2,0,2,1,1,0,0,4,2,0,2,1,1,0,0,4,2,0,2,1
1,3,0,2,9,2,7,3,3,0,1,2,7,2,5,2,3,0,1,2,5,1,4,2
1,4,0,2,3,0,3,1,4,0,1,2,3,0,3,1,4,0,1,2,3,0,3,1
3,1,0,0,8,5,3,0,1,0,3,0,3,2,1,0,1,0,3,0,1,0,1,0
4,1,0,1,7,6,1,0,1,0,4,1,1,0,1,0,1,0,4,1,1,0,1,0
3,1,1,4,7,4,3,2,1,1,3,4,3,2,1,0,1,1,3,4,1,0,1,0
3,4,3,0,4,2,2,0,4,3,3,0,2,1,1,0,4,3,3,0,1,0,1,0
1,3,2,0,3,0,3,0,3,2,1,0,3,0,3,0,3,2,1,0,3,0,3,0
3,1,3,4,22,15,7,6,1,3,3,4,7,4,3,2,1,3,3,4,3,2,1,0
3,1,1,4,6,4,2,1,1,1,3,4,2,1,1,0,1,1,3,4,1,0,1,0
0,4,4,2,5,0,5,2,4,4,0,2,5,0,5,2,4,4,0,2,5,0,5,2
0,0,3,1,27,2,25,7,0,3,0,1,25,2,23,6,0,3,0,1,23,2,21,6
1,3,3,0,15,4,11,1,3,3,1,0,11,3,8,0,3,3,1,0,8,2,6,0
2,2,3,3,12,5,7,4,2,3,2,3,7,3,4,2,2,3,2,3,4,1,3,2
3,2,2,3,14,9,5,3,2,2,3,3,5,3,2,1,2,2,3,3,2,1,1,0
0,1,4,1,20,1,19,5,1,4,0,1,19,1,18,5,1,4,0,1,18,1,17,5
0,4,1,2,13,1,12,5,4,1,0,2,12,1,11,5,4,1,0,2,11,1,10,5
4,4,2,0,7,6,1,0,4,2,4,0,1,0,1,0,4,2,4,0,1,0,1,0
3,1,1,4,7,4,3,2,1,1,3,4,3,2,1,0,1,1,3,4,1,0,1,0
1,3,1,0,0,0,0,0,3,1,1,0,0,0,0,0,3,1,1,0,0,0,0,0
1,4,0,0,15,4,11,1,4,0,1,0,11,3,8,0,4,0,1,0,8,2,6,0
0,4,2,2,9,0,9,4,4,2,0,2,9,0,9,4,4,2,0,2,9,0,9,4
0,1,3,1,24,2,22,6,1,3,0,1,22,2,20,5,1,3,0,1,20,1,19,5
3,4,0,0,2,1,1,0,4,0,3,0,1,0,1,0,4,0,3,0,1,0,1,0
1,3,3,0,12,3,9,0,3,3,1,0,9,2,7,0,3,3,1,0,7,2,5,0
1,3,2,0,6,1,5,0,3,2,1,0,5,1,4,0,3,2,1,0,4,1,3,0
0,3,1,3,7,0,7,4,3,1,0,3,7,0,7,4,3,1,0,3,7,0,7,4
3,4,4,1,6,4,2,0,4,4,3,1,2,1,1,0,4,4,3,1,1,0,1,0
3,0,2,0,22,15,7,0,0,2,3,0,7,4,3,0,0,2,3,0,3,2,1,0
1,1,0,3,6,1,5,3,1,0,1,3,5,1,4,2,1,0,1,3,4,1,3,2
0,4,2,0,8,0,8,0,4,2,0,0,8,0,8,0,4,2,0,0,8,0,8,0
2,2,4,1,27,13,14,4,2,4,2,1,14,6,8,2,2,4,2,1,8,3,5,1
0,1,2,3,15,1,14,9,1,2,0,3,14,1,13,9,1,2,0,3,13,1,12,8
4,2,2,1,12,10,2,0,2,2,4,1,2,1,1,0,2,2,4,1,1,0,1,0
3,0,0,0,10,6,4,0,0,0,3,0,4,2,2,0,0,0,3,0,2,1,1,0
2,3,4,0,23,11,12,1,3,4,2,0,12,5,7,0,3,4,2,0,7,3,4,0
2,0,4,4,24,11,13,11,0,4,2,4,13,6,7,6,0,4,2,4,7,3,4,3
1,1,4,1,27,8,19,5,1,4,1,1,19,5,14,4,1,4,1,1,14,4,10,2
4,3,0,3,2,1,1,0,3,0,4,3,1,0,1,0,3,0,4,3,1,0,1,0
1,4,0,4,4,1,3,2,4,0,1,4,3,0,3,2,4,0,1,4,3,0,3,2
3,4,3,1,14,9,5,1,4,3,3,1,5,3,2,0,4,3,3,1,2,1,1,0
0,0,1,0,13,1,12,1,0,1,0,0,12,1,11,1,0,1,0,0,11,1,10,0
3,4,3,4,4,2,2,1,4,3,3,4,2,1,1,0,4,3,3,4,1,0,1,0
0,0,2,2,22,2,20,9,0,2,0,2,20,2,18,8,0,2,0,2,18,1,17,8
4,3,0,1,0,0,0,0,3,0,4,1,0,0,0,0,3,0,4,1,0,0,0,0
4,0,2,2,26,23,3,1,0,2,4,2,3,2,1,0,0,2,4,2,1,0,1,0
2,1,4,4,20,9,11,9,1,4,2,4,11,5,6,5,1,4,2,4,6,3,3,2
2,4,1,0,5,2,3,0,4,1,2,0,3,1,2,0,4,1,2,0,2,0,2,0
4,4,2,3,5,4,1,0,4,2,4,3,1,0,1,0,4,2,4,3,1,0,1,0
1,4,4,1,8,2,6,1,4,4,1,1,6,1,5,1,4,4,1,1,5,1,4,1
0,4,1,1,2,0,2,0,4,1,0,1,2,0,2,0,4,1,0,1,2,0,2,0
2,3,1,3,2,1,1,0,3,1,2,3,1,0,1,0,3,1,2,3,1,0,1,0
4,0,2,0,19,17,2,0,0,2,4,0,2,1,1,0,0,2,4,0,1,0,1,0
4,2,1,0,10,9,1,0,2,1,4,0,1,0,1,0,2,1,4,0,1,0,1,0
1,1,0,3,5,1,4,2,1,0,1,3,4,1,3,2,1,0,1,3,3,0,3,2
0,0,4,1,28,2,26,7,0,4,0,1,26,2,24,7,0,4,0,1,24,2,22,6
0,1,2,2,22,2,20,9,1,2,0,2,20,1,19,9,1,2,0,2,19,1,18,8
2,0,2,4,25,12,13,11,0,2,2,4,13,6,7,6,0,2,2,4,7,3,4,3
2,3,0,2,0,0,0,0,3,0,2,2,0,0,0,0,3,0,2,2,0,0,0,0
4,2,1,1,25,22,3,0,2,1,4,1,3,2,1,0,2,1,4,1,1,0,1,0
3,0,3,1,22,15,7,2,0,3,3,1,7,4,3,0,0,3,3,1,3,2,1,0
0,2,3,2,19,1,18,9,2,3,0,2,18,1,17,8,2,3,0,2,17,1,16,7
4,3,3,3,20,18,2,1,3,3,4,3,2,1,1,0,3,3,4,3,1,0,1,0
3,2,3,4,15,10,5,4,2,3,3,4,5,3,2,1,2,3,3,4,2,1,1,0
1,4,2,0,1,0,1,0,4,2,1,0,1,0,1,0,4,2,1,0,1,0,1,0
0,3,2,3,19,1,18,12,3,2,0,3,18,1,17,11,3,2,0,3,17,1,16,11
0,4,2,2,12,1,11,5,4,2,0,2,11,1,10,5,4,2,0,2,10,0,10,5
0,3,4,3,9,0,9,6,3,4,0,3,9,0,9,6,3,4,0,3,9,0,9,6
0,1,4,3,29,2,27,18,1,4,0,3,27,2,25,17,1,4,0,3,25,2,23,16
3,1,3,2,26,18,8,4,1,3,3,2,8,5,3,1,1,3,3,2,3,2,1,0
3,2,3,3,14,9,5,3,2,3,3,3,5,3,2,1,2,3,3,3,2,1,1,0
3,3,1,3,4,2,2,1,3,1,3,3,2,1,1,0,3,1,3,3,1,0,1,0
2,4,0,3,3,1,2,1,4,0,2,3,2,1,1,0,4,0,2,3,1,0,1,0
0,3,1,0,10,1,9,0,3,1,0,0,9,0,9,0,3,1,0,0,9,0,9,0
0,1,1,1,3,0,3,0,1,1,0,1,3,0,3,0,1,1,0,1,3,0,3,0
2,2,2,2,22,11,11,5,2,2,2,2,11,5,6,3,2,2,2,2,6,3,3,1
4,2,2,3,18,16,2,1,2,2,4,3,2,1,1,0,2,2,4,3,1,0,1,0
3,2,2,2,18,12,6,3,2,2,3,2,6,4,2,1,2,2,3,2,2,1,1,0
4,4,2,4,4,3,1,0,4,2,4,4,1,0,1,0,4,2,4,4,1,0,1,0
4,4,1,2,2,1,1,0,4,1,4,2,1,0,1,0,4,1,4,2,1,0,1,0
4,3,3,4,8,7,1,0,3,3,4,4,1,0,1,0,3,3,4,4,1,0,1,0
2,4,4,4,6,2,4,3,4,4,2,4,4,1,3,2,4,4,2,4,3,1,2,1
0,2,3,0,18,1,17,1,2,3,0,0,17,1,16,1,2,3,0,0,16,1,15,1
4,0,3,1,29,26,3,0,0,3,4,1,3,2,1,0,0,3,4,1,1,0,1,0
3,3,3,1,8,5,3,0,3,3,3,1,3,2,1,0,3,3,3,1,1,0,1,0
1,3,1,2,0,0,0,0,3,1,1,2,0,0,0,0,3,1,1,2,0,0,0,0
3,0,2,1,16,11,5,1,0,2,3,1,5,3,2,0,0,2,3,1,2,1,1,0
3,2,2,3,10,7,3,2,2,2,3,3,3,2,1,0,2,2,3,3,1,0,1,0
1,2,4,1,19,5,14,4,2,4,1,1,14,4,10,2,2,4,1,1,10,2,8,2
1,2,1,2,7,2,5,2,2,1,1,2,5,1,4,2,2,1,1,2,4,1,3,1
2,1,0,3,9,4,5,3,1,0,2,3,5,2,3,2,1,0,2,3,3,1,2,1
4,3,4,0,15,13,2,0,3,4,4,0,2,1,1,0,3,4,4,0,1,0,1,0
3,4,1,3,5,3,2,1,4,1,3,3,2,1,1,0,4,1,3,3,1,0,1,0
0,0,2,4,19,1,18,16,0,2,0,4,18,1,17,15,0,2,0,4,17,1,16,14
1,2,4,2,19,5,14,6,2,4,1,2,14,4,10,4,2,4,1,2,10,2,8,3
1,4,2,4,7,2,5,4,4,2,1,4,5,1,4,3,4,2,1,4,4,1,3,2
3,4,0,3,1,0,1,0,4,0,3,3,1,0,1,0,4,0,3,3,1,0,1,0
0,0,0,3,10,0,10,6,0,0,0,3,10,0,10,7,0,0,0,3,10,1,9,6
4,2,2,0,8,7,1,0,2,2,4,0,1,0,1,0,2,2,4,0,1,0,1,0
2,4,0,0,7,3,4,0,4,0,2,0,4,2,2,0,4,0,2,0,2,1,1,0
2,1,3,1,26,12,14,4,1,3,2,1,14,7,7,2,1,3,2,1,7,3,4,1
1,1,0,3,4,1,3,2,1,0,1,3,3,0,3,2,1,0,1,3,3,0,3,2
3,3,3,4,12,8,4,3,3,3,3,4,4,2,2,1,3,3,3,4,2,1,1,0
4,0,2,3,22,19,3,2,0,2,4,3,3,2,1,0,0,2,4,3,1,0,1,0
3,4,4,3,6,4,2,1,4,4,3,3,2,1,1,0,4,4,3,3,1,0,1,0
0,2,3,3,10,1,9,6,2,3,0,3,9,0,9,6,2,3,0,3,9,0,9,6
4,2,4,0,24,21,3,0,2,4,4,0,3,2,1,0,2,4,4,0,1,0,1,0
3,1,3,2,19,13,6,3,1,3,3,2,6,4,2,0,1,3,3,2,2,1,1,0
2,2,0,3,10,4,6,4,2,0,2,3,6,3,3,2,2,0,2,3,3,1,2,1
4,0,2,4,19,17,2,1,0,2,4,4,2,1,1,0,0,2,4,4,1,0,1,0
3,3,0,3,5,3,2,1,3,0,3,3,2,1,1,0,3,0,3,3,1,0,1,0
3,0,1,2,17,11,6,2,0,1,3,2,6,4,2,1,0,1,3,2,2,1,1,0
3,1,0,0,8,5,3,0,1,0,3,0,3,2,1,0,1,0,3,0,1,0,1,0
4,4,2,1,6,5,1,0,4,2,4,1,1,0,1,0,4,2,4,1,1,0,1,0
0,4,1,4,6,0,6,5,4,1,0,4,6,0,6,5,4,1,0,4,6,0,6,5
4,1,4,2,28,25,3,1,1,4,4,2,3,2,1,0,1,4,4,2,1,0,1,0
0,3,0,2,5,0,5,2,3,0,0,2,5,0,5,2,3,0,0,2,5,0,5,2
0,1,0,3,3,0,3,2,1,0,0,3,3,0,3,2,1,0,0,3,3,0,3,2
3,0,4,1,28,19,9,2,0,4,3,1,9,6,3,0,0,4,3,1,3,2,1,0
1,1,1,2,20,6,14,6,1,1,1,2,14,4,10,5,1,1,1,2,10,3,7,3
3,0,2,2,24,16,8,3,0,2,3,2,8,5,3,1,0,2,3,2,3,2,1,0
2,4,3,3,14,7,7,4,4,3,2,3,7,3,4,2,4,3,2,3,4,2,2,1
2,4,1,4,1,0,1,0,4,1,2,4,1,0,1,0,4,1,2,4,1,0,1,0
4,3,1,2,13,11,2,0,3,1,4,2,2,1,1,0,3,1,4,2,1,0,1,0
1,3,3,4,12,3,9,8,3,3,1,4,9,2,7,6,3,3,1,4,7,2,5,4
2,2,2,0,9,4,5,0,2,2,2,0,5,2,3,0,2,2,2,0,3,1,2,0
3,0,0,1,0,0,0,0,0,0,3,1,0,0,0,0,0,0,3,1,0,0,0,0
3,4,2,2,2,1,1,0,4,2,3,2,1,0,1,0,4,2,3,2,1,0,1,0
3,3,4,0,10,6,4,0,3,4,3,0,4,2,2,0,3,4,3,0,2,1,1,0
3,0,4,0,29,20,9,0,0,4,3,0,9,6,3,0,0,4,3,0,3,2,1,0
2,2,1,1,10,4,6,1,2,1,2,1,6,2,4,1,2,1,2,1,4,1,3,0
1,0,2,0,29,8,21,2,0,2,1,0,21,6,15,1,0,2,1,0,15,4,11,1
4,2,1,1,1,0,1,0,2,1,4,1,1,0,1,0,2,1,4,1,1,0,1,0
0,3,2,1,13,1,12,3,3,2,0,1,12,1,11,3,3,2,0,1,11,1,10,3
4,4,1,1,6,5,1,0,4,1,4,1,1,0,1,0,4,1,4,1,1,0,1,0
1,0,4,0,28,8,20,1,0,4,1,0,20,5,15,1,0,4,1,0,15,4,11,1
2,1,0,2,6,2,4,2,1,0,2,2,4,2,2,0,1,0,2,2,2,0,2,1
2,1,3,4,25,12,13,11,1,3,2,4,13,6,7,6,1,3,2,4,7,3,4,3
0,0,3,2,29,2,27,13,0,3,0,2,27,2,25,12,0,3,0,2,25,2,23,11
1,4,4,0,14,4,10,1,4,4,1,0,10,2,8,0,4,4,1,0,8,2,6,0
2,0,3,1,28,13,15,4,0,3,2,1,15,7,8,2,0,3,2,1,8,3,5,1
1,1,0,3,13,3,10,7,1,0,1,3,10,2,8,5,1,0,1,3,8,2,6,4
1,4,4,0,4,1,3,0,4,4,1,0,3,0,3,0,4,4,1,0,3,0,3,0
4,4,4,0,5,4,1,0,4,4,4,0,1,0,1,0,4,4,4,0,1,0,1,0
4,0,0,1,1,0,1,0,0,0,4,1,1,0,1,0,0,0,4,1,1,0,1,0
2,3,3,1,19,9,10,2,3,3,2,1,10,4,6,1,3,3,2,1,6,2,4,1
4,3,1,1,14,12,2,0,3,1,4,1,2,1,1,0,3,1,4,1,1,0,1,0
1,0,0,0,6,1,5,0,0,0,1,0,5,1,4,0,0,0,1,0,4,1,3,0
4,3,3,4,16,14,2,1,3,3,4,4,2,1,1,0,3,3,4,4,1,0,1,0
3,0,0,3,1,0,1,0,0,0,3,3,1,0,1,0,0,0,3,3,1,0,1,0
3,3,2,2,13,9,4,2,3,2,3,2,4,2,2,0,3,2,3,2,2,1,1,0
4,4,1,0,0,0,0,0,4,1,4,0,0,0,0,0,4,1,4,0,0,0,0,0
4,1,2,2,9,8,1,0,1,2,4,2,1,0,1,0,1,2,4,2,1,0,1,0
4,3,4,4,19,17,2,1,3,4,4,4,2,1,1,0,3,4,4,4,1,0,1,0
1,1,1,2,6,1,5,2,1,1,1,2,5,1,4,2,1,1,1,2,4,1,3,1
1,4,3,1,5,1,4,1,4,3,1,1,4,1,3,0,4,3,1,1,3,0,3,0
2,2,2,1,4,1,3,0,2,2,2,1,3,1,2,0,2,2,2,1,2,1,1,0
1,4,0,1,4,1,3,0,4,0,1,1,3,0,3,0,4,0,1,1,3,0,3,0
1,3,2,3,15,4,11,7,3,2,1,3,11,3,8,5,3,2,1,3,8,2,6,4
0,2,1,1,7,0,7,2,2,1,0,1,7,0,7,2,2,1,0,1,7,0,7,2
1,1,2,4,19,5,14,12,1,2,1,4,14,4,10,8,1,2,1,4,10,3,7,6
4,4,3,0,6,5,1,0,4,3,4,0,1,0,1,0,4,3,4,0,1,0,1,0
4,3,0,3,5,4,1,0,3,0,4,3,1,0,1,0,3,0,4,3,1,0,1,0
4,3,2,3,9,8,1,0,3,2,4,3,1,0,1,0,3,2,4,3,1,0,1,0
2,1,3,1,26,12,14,4,1,3,2,1,14,6,8,2,1,3,2,1,8,3,5,1
0,4,0,1,2,0,2,0,4,0,0,1,2,0,2,0,4,0,0,1,2,0,2,0
1,1,0,0,6,1,5,0,1,0,1,0,5,1,4,0,1,0,1,0,4,1,3,0
4,3,0,2,2,1,1,0,3,0,4,2,1,0,1,0,3,0,4,2,1,0,1,0
3,1,2,1,15,10,5,1,1,2,3,1,5,3,2,0,1,2,3,1,2,1,1,0
2,3,4,0,26,12,14,1,3,4,2,0,14,7,7,0,3,4,2,0,7,3,4,0
2,1,3,0,22,10,12,1,1,3,2,0,12,6,6,0,1,3,2,0,6,2,4,0
2,2,1,0,16,7,9,0,2,1,2,0,9,4,5,0,2,1,2,0,5,2,3,0
3,2,2,3,7,4,3,2,2,2,3,3,3,2,1,0,2,2,3,3,1,0,1,0
4,0,1,1,10,8,2,0,0,1,4,1,2,1,1,0,0,1,4,1,1,0,1,0
1,2,1,0,6,1,5,0,2,1,1,0,5,1,4,0,2,1,1,0,4,1,3,0
1,4,2,0,8,2,6,0,4,2,1,0,6,1,5,0,4,2,1,0,5,1,4,0
0,2,3,0,17,1,16,1,2,3,0,0,16,1,15,1,2,3,0,0,15,1,14,1
2,1,0,1,13,6,7,2,1,0,2,1,7,3,4,1,1,0,2,1,4,2,2,0
3,0,3,4,24,16,8,7,0,3,3,4,8,5,3,2,0,3,3,4,3,2,1,0
1,2,4,2,18,5,13,6,2,4,1,2,13,3,10,4,2,4,1,2,10,3,7,3
0,1,3,2,22,2,20,10,1,3,0,2,20,2,18,9,1,3,0,2,18,1,17,8
1,4,2,3,2,0,2,1,4,2,1,3,2,0,2,1,4,2,1,3,2,0,2,1
4,4,2,1,2,1,1,0,4,2,4,1,1,0,1,0,4,2,4,1,1,0,1,0
2,4,4,3,5,2,3,2,4,4,2,3,3,1,2,1,4,4,2,3,2,1,1,0
2,1,0,1,2,1,1,0,1,0,2,1,1,0,1,0,1,0,2,1,1,0,1,0
0,2,0,4,7,0,7,6,2,0,0,4,7,0,7,6,2,0,0,4,7,0,7,6
4,4,2,4,2,1,1,0,4,2,4,4,1,0,1,0,4,2,4,4,1,0,1,0
0,3,2,1,8,0,8,2,3,2,0,1,8,0,8,2,3,2,0,1,8,0,8,2
0,0,0,4,6,0,6,5,0,0,0,4,6,0,6,5,0,0,0,4,6,0,6,5
1,3,0,1,6,1,5,1,3,0,1,1,5,1,4,1,3,0,1,1,4,1,3,0
4,3,2,0,10,9,1,0,3,2,4,0,1,0,1,0,3,2,4,0,1,0,1,0
0,0,0,4,6,0,6,5,0,0,0,4,6,0,6,5,0,0,0,4,6,0,6,5
0,1,1,1,26,2,24,7,1,1,0,1,24,2,22,6,1,1,0,1,22,2,20,5
2,1,2,0,9,4,5,0,1,2,2,0,5,2,3,0,1,2,2,0,3,1,2,0
4,3,4,4,18,16,2,1,3,4,4,4,2,1,1,0,3,4,4,4,1,0,1,0
3,1,1,1,10,6,4,1,1,1,3,1,4,2,2,0,1,1,3,1,2,1,1,0
4,4,3,1,13,11,2,0,4,3,4,1,2,1,1,0,4,3,4,1,1,0,1,0
2,1,4,1,24,12,12,3,1,4,2,1,12,5,7,2,1,4,2,1,7,3,4,1
0,2,1,0,10,0,10,0,2,1,0,0,10,0,10,1,2,1,0,0,10,0,10,0
3,0,2,3,18,12,6,4,0,2,3,3,6,4,2,1,0,2,3,3,2,1,1,0
0,1,2,4,19,1,18,16,1,2,0,4,18,1,17,15,1,2,0,4,17,1,16,14
1,1,0,1,6,1,5,1,1,0,1,1,5,1,4,1,1,0,1,1,4,1,3,0
3,1,0,4,6,4,2,1,1,0,3,4,2,1,1,0,1,0,3,4,1,0,1,0
4,4,1,0,5,4,1,0,4,1,4,0,1,0,1,0,4,1,4,0,1,0,1,0
3,2,2,2,4,2,2,0,2,2,3,2,2,1,1,0,2,2,3,2,1,0,1,0
3,1,0,1,12,8,4,1,1,0,3,1,4,2,2,0,1,0,3,1,2,1,1,0
1,1,1,3,13,3,10,7,1,1,1,3,10,3,7,4,1,1,1,3,7,2,5,3
3,0,0,1,13,9,4,1,0,0,3,1,4,2,2,0,0,0,3,1,2,1,1,0
2,1,0,4,0,0,0,0,1,0,2,4,0,0,0,0,1,0,2,4,0,0,0,0
2,0,0,1,9,4,5,1,0,0,2,1,5,2,3,0,0,0,2,1,3,1,2,0
3,2,1,1,3,2,1,0,2,1,3,1,1,0,1,0,2,1,3,1,1,0,1,0
0,1,4,0,26,2,24,2,1,4,0,0,24,2,22,2,1,4,0,0,22,2,20,1
3,2,0,0,5,3,2,0,2,0,3,0,2,1,1,0,2,0,3,0,1,0,1,0
1,2,4,0,17,5,12,1,2,4,1,0,12,3,9,0,2,4,1,0,9,2,7,0
0,3,0,3,6,0,6,4,3,0,0,3,6,0,6,4,3,0,0,3,6,0,6,4
1,2,2,4,9,2,7,6,2,2,1,4,7,2,5,4,2,2,1,4,5,1,4,3
2,4,2,2,4,2,2,1,4,2,2,2,2,0,2,1,4,2,2,2,2,0,2,1
1,2,2,1,6,1,5,1,2,2,1,1,5,1,4,1,2,2,1,1,4,1,3,0
0,3,0,0,3,0,3,0,3,0,0,0,3,0,3,0,3,0,0,0,3,0,3,0
1,1,3,4,27,8,19,17,1,3,1,4,19,5,14,12,1,3,1,4,14,4,10,8
1,4,0,4,0,0,0,0,4,0,1,4,0,0,0,0,4,0,1,4,0,0,0,0
4,4,3,0,10,8,2,0,4,3,4,0,2,1,1,0,4,3,4,0,1,0,1,0
2,3,4,1,13,6,7,2,3,4,2,1,7,3,4,1,3,4,2,1,4,2,2,0
1,3,3,3,13,3,10,6,3,3,1,3,10,3,7,4,3,3,1,3,7,2,5,3
4,2,0,3,2,1,1,0,2,0,4,3,1,0,1,0,2,0,4,3,1,0,1,0
1,3,0,0,6,1,5,0,3,0,1,0,5,1,4,0,3,0,1,0,4,1,3,0
0,3,1,0,4,0,4,0,3,1,0,0,4,0,4,0,3,1,0,0,4,0,4,0
3,2,3,4,28,19,9,8,2,3,3,4,9,6,3,2,2,3,3,4,3,2,1,0
0,0,3,4,25,2,23,20,0,3,0,4,23,2,21,18,0,3,0,4,21,2,19,17
1,2,0,0,7,2,5,0,2,0,1,0,5,1,4,0,2,0,1,0,4,1,3,0
2,2,3,1,13,6,7,2,2,3,2,1,7,3,4,1,2,3,2,1,4,2,2,0
3,4,0,1,7,4,3,0,4,0,3,1,3,2,1,0,4,0,3,1,1,0,1,0
1,0,1,0,8,2,6,0,0,1,1,0,6,1,5,0,0,1,1,0,5,1,4,0
2,3,2,3,11,5,6,4,3,2,2,3,6,2,4,2,3,2,2,3,4,1,3,2
1,2,4,1,19,5,14,4,2,4,1,1,14,4,10,3,2,4,1,1,10,3,7,2
3,1,0,4,0,0,0,0,1,0,3,4,0,0,0,0,1,0,3,4,0,0,0,0
4,1,3,4,29,26,3,2,1,3,4,4,3,2,1,0,1,3,4,4,1,0,1,0
2,4,1,2,4,2,2,0,4,1,2,2,2,0,2,1,4,1,2,2,2,1,1,0
1,0,3,4,26,7,19,17,0,3,1,4,19,5,14,12,0,3,1,4,14,4,10,8
4,1,1,2,8,7,1,0,1,1,4,2,1,0,1,0,1,1,4,2,1,0,1,0
1,1,1,1,16,4,12,3,1,1,1,1,12,3,9,2,1,1,1,1,9,2,7,2
4,1,1,3,14,12,2,1,1,1,4,3,2,1,1,0,1,1,4,3,1,0,1,0
1,3,0,2,10,3,7,3,3,0,1,2,7,2,5,2,3,0,1,2,5,1,4,2
1,1,1,2,5,1,4,2,1,1,1,2,4,1,3,1,1,1,1,2,3,0,3,1
2,0,1,3,15,7,8,5,0,1,2,3,8,3,5,3,0,1,2,3,5,2,3,2
4,1,3,3,27,24,3,2,1,3,4,3,3,2,1,0,1,3,4,3,1,0,1,0
0,3,0,0,1,0,1,0,3,0,0,0,1,0,1,0,3,0,0,0,1,0,1,0
4,2,4,1,23,20,3,0,2,4,4,1,3,2,1,0,2,4,4,1,1,0,1,0
3,4,4,2,10,6,4,2,4,4,3,2,4,2,2,0,4,4,3,2,2,1,1,0
4,4,4,4,12,10,2,1,4,4,4,4,2,1,1,0,4,4,4,4,1,0,1,0
0,1,3,4,17,1,16,14,1,3,0,4,16,1,15,13,1,3,0,4,15,1,14,12
2,1,2,4,21,10,11,9,1,2,2,4,11,5,6,5,1,2,2,4,6,3,3,2
4,0,3,0,27,24,3,0,0,3,4,0,3,2,1,0,0,3,4,0,1,0,1,0
1,3,0,1,1,0,1,0,3,0,1,1,1,0,1,0,3,0,1,1,1,0,1,0
1,1,1,1,22,6,16,4,1,1,1,1,16,4,12,3,1,1,1,1,12,3,9,2
1,1,3,2,19,5,14,7,1,3,1,2,14,4,10,4,1,3,1,2,10,2,8,3
3,2,0,1,5,3,2,0,2,0,3,1,2,1,1,0,2,0,3,1,1,0,1,0
3,0,0,1,8,5,3,0,0,0,3,1,3,2,1,0,0,0,3,1,1,0,1,0
2,2,4,4,21,10,11,9,2,4,2,4,11,5,6,5,2,4,2,4,6,3,3,2
2,2,4,3,27,13,14,9,2,4,2,3,14,7,7,4,2,4,2,3,7,3,4,2
1,1,2,3,22,6,16,11,1,2,1,3,16,4,12,8,1,2,1,3,12,3,9,6
4,1,2,3,10,9,1,0,1,2,4,3,1,0,1,0,1,2,4,3,1,0,1,0
3,4,1,4,4,2,2,1,4,1,3,4,2,1,1,0,4,1,3,4,1,0,1,0
0,2,3,4,13,1,12,10,2,3,0,4,12,1,11,9,2,3,0,4,11,1,10,8
0,1,4,1,29,2,27,8,1,4,0,1,27,2,25,7,1,4,0,1,25,2,23,6
1,2,3,3,20,6,14,9,2,3,1,3,14,4,10,6,2,3,1,3,10,3,7,4
0,3,3,0,5,0,5,0,3,3,0,0,5,0,5,0,3,3,0,0,5,0,5,0
0,2,2,3,16,1,15,10,2,2,0,3,15,1,14,9,2,2,0,3,14,1,13,9
0,4,4,3,13,1,12,8,4,4,0,3,12,1,11,7,4,4,0,3,11,1,10,7
3,2,4,2,14,9,5,2,2,4,3,2,5,3,2,0,2,4,3,2,2,1,1,0
3,2,3,3,21,14,7,4,2,3,3,3,7,4,3,2,2,3,3,3,3,2,1,0
4,0,0,1,2,1,1,0,0,0,4,1,1,0,1,0,0,0,4,1,1,0,1,0
1,4,0,2,0,0,0,0,4,0,1,2,0,0,0,0,4,0,1,2,0,0,0,0
1,2,3,1,12,3,9,2,2,3,1,1,9,2,7,2,2,3,1,1,7,2,5,1
4,4,2,1,8,7,1,0,4,2,4,1,1,0,1,0,4,2,4,1,1,0,1,0
0,1,3,0,23,2,21,2,1,3,0,0,21,2,19,1,1,3,0,0,19,1,18,1
1,0,0,2,0,0,0,0,0,0,1,2,0,0,0,0,0,0,1,2,0,0,0,0
3,0,4,2,29,20,9,4,0,4,3,2,9,6,3,1,0,4,3,2,3,2,1,0
3,0,4,1,29,20,9,2,0,4,3,1,9,6,3,0,0,4,3,1,3,2,1,0
0,0,4,1,29,2,27,8,0,4,0,1,27,2,25,7,0,4,0,1,25,2,23,6
3,0,2,0,10,6,4,0,0,2,3,0,4,2,2,0,0,2,3,0,2,1,1,0
1,0,3,4,20,5,15,13,0,3,1,4,15,4,11,9,0,3,1,4,11,3,8,7
2,4,1,1,0,0,0,0,4,1,2,1,0,0,0,0,4,1,2,1,0,0,0,0
2,3,2,2,4,2,2,0,3,2,2,2,2,1,1,0,3,2,2,2,1,0,1,0
3,4,3,1,2,1,1,0,4,3,3,1,1,0,1,0,4,3,3,1,1,0,1,0
2,4,2,2,11,5,6,2,4,2,2,2,6,3,3,1,4,2,2,2,3,1,2,1
0,4,1,3,9,0,9,6,4,1,0,3,9,0,9,6,4,1,0,3,9,0,9,6
2,4,4,2,2,0,2,1,4,4,2,2,2,0,2,1,4,4,2,2,2,1,1,0
3,4,4,1,10,6,4,1,4,4,3,1,4,2,2,0,4,4,3,1,2,1,1,0
4,4,1,4,15,13,2,1,4,1,4,4,2,1,1,0,4,1,4,4,1,0,1,0
4,4,2,3,2,1,1,0,4,2,4,3,1,0,1,0,4,2,4,3,1,0,1,0
2,2,4,0,16,8,8,0,2,4,2,0,8,3,5,0,2,4,2,0,5,2,3,0
2,1,3,0,21,10,11,1,1,3,2,0,11,5,6,0,1,3,2,0,6,2,4,0
0,4,4,2,9,0,9,4,4,4,0,2,9,0,9,4,4,4,0,2,9,0,9,4
4,4,0,4,2,1,1,0,4,0,4,4,1,0,1,0,4,0,4,4,1,0,1,0
4,1,3,3,27,24,3,2,1,3,4,3,3,2,1,0,1,3,4,3,1,0,1,0
0,0,0,0,8,0,8,0,0,0,0,0,8,0,8,0,0,0,0,0,8,0,8,0
0,1,2,3,26,2,24,16,1,2,0,3,24,2,22,15,1,2,0,3,22,2,20,13
1,4,2,2,2,0,2,0,4,2,1,2,2,0,2,0,4,2,1,2,2,0,2,0
1,0,2,3,19,5,14,9,0,2,1,3,14,4,10,7,0,2,1,3,10,3,7,4
0,1,3,1,25,2,23,6,1,3,0,1,23,2,21,6,1,3,0,1,21,2,19,5
1,2,3,4,26,7,19,17,2,3,1,4,19,5,14,12,2,3,1,4,14,4,10,8
3,3,1,0,2,1,1,0,3,1,3,0,1,0,1,0,3,1,3,0,1,0,1,0
0,1,4,1,28,2,26,7,1,4,0,1,26,2,24,7,1,4,0,1,24,2,22,6
0,2,4,4,13,1,12,10,2,4,0,4,12,1,11,9,2,4,0,4,11,1,10,9
2,1,2,2,21,10,11,5,1,2,2,2,11,5,6,3,1,2,2,2,6,2,4,1
0,0,2,1,22,2,20,5,0,2,0,1,20,2,18,5,0,2,0,1,18,1,17,5
0,2,3,4,15,1,14,12,2,3,0,4,14,1,13,11,2,3,0,4,13,1,12,10
0,3,3,2,5,0,5,2,3,3,0,2,5,0,5,2,3,3,0,2,5,0,5,2
0,0,1,0,21,2,19,1,0,1,0,0,19,1,18,1,0,1,0,0,18,1,17,1
3,4,1,3,2,1,1,0,4,1,3,3,1,0,1,0,4,1,3,3,1,0,1,0
1,1,1,0,9,2,7,0,1,1,1,0,7,2,5,0,1,1,1,0,5,1,4,0
1,1,1,3,10,3,7,4,1,1,1,3,7,2,5,3,1,1,1,3,5,1,4,2
4,4,4,4,9,8,1,0,4,4,4,4,1,0,1,0,4,4,4,4,1,0,1,0
1,2,2,4,7,2,5,4,2,2,1,4,5,1,4,3,2,2,1,4,4,1,3,2
4,4,0,0,3,2,1,0,4,0,4,0,1,0,1,0,4,0,4,0,1,0,1,0
2,1,2,0,16,7,9,0,1,2,2,0,9,4,5,0,1,2,2,0,5,2,3,0
0,2,4,1,20,2,18,5,2,4,0,1,18,1,17,5,2,4,0,1,17,1,16,4
0,2,0,0,11,1,10,1,2,0,0,0,10,1,9,0,2,0,0,0,9,0,9,0
3,3,0,0,3,2,1,0,3,0,3,0,1,0,1,0,3,0,3,0,1,0,1,0
4,0,3,2,27,24,3,1,0,3,4,2,3,2,1,0,0,3,4,2,1,0,1,0
4,3,1,3,6,5,1,0,3,1,4,3,1,0,1,0,3,1,4,3,1,0,1,0
0,0,0,3,1,0,1,0,0,0,0,3,1,0,1,0,0,0,0,3,1,0,1,0
2,2,3,1,17,8,9,2,2,3,2,1,9,4,5,1,2,3,2,1,5,2,3,0
0,0,4,1,29,2,27,8,0,4,0,1,27,2,25,7,0,4,0,1,25,2,23,6
0,0,3,0,29,2,27,2,0,3,0,0,27,2,25,2,0,3,0,0,25,2,23,2
1,3,2,0,1,0,1,0,3,2,1,0,1,0,1,0,3,2,1,0,1,0,1,0
0,3,2,0,4,0,4,0,3,2,0,0,4,0,4,0,3,2,0,0,4,0,4,0
4,2,2,4,8,7,1,0,2,2,4,4,1,0,1,0,2,2,4,4,1,0,1,0
3,0,0,0,12,8,4,0,0,0,3,0,4,2,2,0,0,0,3,0,2,1,1,0
3,3,2,1,23,16,7,2,3,2,3,1,7,4,3,0,3,2,3,1,3,2,1,0
4,2,0,4,16,14,2,1,2,0,4,4,2,1,1,0,2,0,4,4,1,0,1,0
3,3,2,1,10,7,3,0,3,2,3,1,3,2,1,0,3,2,3,1,1,0,1,0
4,2,2,3,10,8,2,1,2,2,4,3,2,1,1,0,2,2,4,3,1,0,1,0
3,2,4,4,13,9,4,3,2,4,3,4,4,2,2,1,2,4,3,4,2,1,1,0
0,4,0,4,2,0,2,1,4,0,0,4,2,0,2,1,4,0,0,4,2,0,2,1
1,4,3,0,2,0,2,0,4,3,1,0,2,0,2,0,4,3,1,0,2,0,2,0
0,1,1,3,11,1,10,6,1,1,0,3,10,1,9,6,1,1,0,3,9,0,9,6
1,4,2,4,0,0,0,0,4,2,1,4,0,0,0,0,4,2,1,4,0,0,0,0
2,2,1,4,6,3,3,2,2,1,2,4,3,1,2,1,2,1,2,4,2,1,1,0
3,1,2,1,21,14,7,2,1,2,3,1,7,4,3,0,1,2,3,1,3,2,1,0
0,1,3,2,14,1,13,6,1,3,0,2,13,1,12,5,1,3,0,2,12,1,11,5
3,1,3,2,24,16,8,4,1,3,3,2,8,5,3,1,1,3,3,2,3,2,1,0
1,3,3,0,18,5,13,1,3,3,1,0,13,3,10,0,3,3,1,0,10,3,7,0
0,0,4,0,28,2,26,2,0,4,0,0,26,2,24,2,0,4,0,0,24,2,22,2
3,3,0,0,4,2,2,0,3,0,3,0,2,1,1,0,3,0,3,0,1,0,1,0
3,1,1,0,9,6,3,0,1,1,3,0,3,2,1,0,1,1,3,0,1,0,1,0
1,4,1,3,12,3,9,6,4,1,1,3,9,2,7,4,4,1,1,3,7,2,5,3
2,2,2,3,23,11,12,8,2,2,2,3,12,5,7,4,2,2,2,3,7,3,4,2
4,1,3,0,21,18,3,0,1,3,4,0,3,2,1,0,1,3,4,0,1,0,1,0
3,2,3,0,18,12,6,0,2,3,3,0,6,4,2,0,2,3,3,0,2,1,1,0
2,3,1,2,7,3,4,2,3,1,2,2,4,2,2,0,3,1,2,2,2,1,1,0
1,0,2,3,21,6,15,10,0,2,1,3,15,4,11,7,0,2,1,3,11,3,8,5
2,3,0,1,5,2,3,0,3,0,2,1,3,1,2,0,3,0,2,1,2,1,1,0
0,3,0,4,6,0,6,5,3,0,0,4,6,0,6,5,3,0,0,4,6,0,6,5
4,4,3,2,7,6,1,0,4,3,4,2,1,0,1,0,4,3,4,2,1,0,1,0
0,2,2,3,9,0,9,6,2,2,0,3,9,0,9,6,2,2,0,3,9,0,9,6
0,2,3,3,18,1,17,11,2,3,0,3,17,1,16,11,2,3,0,3,16,1,15,10
2,2,3,3,22,10,12,8,2,3,2,3,12,5,7,4,2,3,2,3,7,3,4,2
4,0,3,0,26,23,3,0,0,3,4,0,3,2,1,0,0,3,4,0,1,0,1,0
0,4,2,4,6,0,6,5,4,2,0,4,6,0,6,5,4,2,0,4,6,0,6,5
3,2,0,3,3,2,1,0,2,0,3,3,1,0,1,0,2,0,3,3,1,0,1,0
4,2,3,1,22,19,3,0,2,3,4,1,3,2,1,0,2,3,4,1,1,0,1,0
2,4,1,0,8,3,5,0,4,1,2,0,5,2,3,0,4,1,2,0,3,1,2,0
2,0,1,3,3,1,2,1,0,1,2,3,2,1,1,0,0,1,2,3,1,0,1,0
2,1,0,3,5,2,3,2,1,0,2,3,3,1,2,1,1,0,2,3,2,0,2,1
0,2,2,2,13,1,12,5,2,2,0,2,12,1,11,5,2,2,0,2,11,1,10,5
4,0,4,3,22,19,3,2,0,4,4,3,3,2,1,0,0,4,4,3,1,0,1,0
3,1,3,2,24,16,8,4,1,3,3,2,8,5,3,1,1,3,3,2,3,2,1,0
0,0,0,4,8,0,8,7,0,0,0,4,8,0,8,7,0,0,0,4,8,0,8,7
2,3,1,4,1,0,1,0,3,1,2,4,1,0,1,0,3,1,2,4,1,0,1,0
1,4,2,3,5,1,4,2,4,2,1,3,4,1,3,2,4,2,1,3,3,0,3,2
4,2,3,0,17,15,2,0,2,3,4,0,2,1,1,0,2,3,4,0,1,0,1,0
3,4,4,0,10,7,3,0,4,4,3,0,3,2,1,0,4,4,3,0,1,0,1,0
1,4,3,4,3,0,3,2,4,3,1,4,3,0,3,2,4,3,1,4,3,0,3,2
2,0,2,2,19,9,10,5,0,2,2,2,10,5,5,2,0,2,2,2,5,2,3,1
3,0,3,4,26,18,8,7,0,3,3,4,8,5,3,2,0,3,3,4,3,2,1,0
1,1,0,1,4,1,3,0,1,0,1,1,3,0,3,0,1,0,1,1,3,0,3,0
0,4,1,1,8,0,8,2,4,1,0,1,8,0,8,2,4,1,0,1,8,0,8,2
3,2,3,4,18,12,6,5,2,3,3,4,6,4,2,1,2,3,3,4,2,1,1,0
4,0,1,2,26,23,3,1,0,1,4,2,3,2,1,0,0,1,4,2,1,0,1,0
2,4,3,4,3,1,2,1,4,3,2,4,2,1,1,0,4,3,2,4,1,0,1,0
2,4,4,0,7,3,4,0,4,4,2,0,4,1,3,0,4,4,2,0,3,1,2,0
1,2,2,2,13,3,10,5,2,2,1,2,10,2,8,4,2,2,1,2,8,2,6,2
0,1,0,0,2,0,2,0,1,0,0,0,2,0,2,0,1,0,0,0,2,0,2,0
0,0,2,3,19,1,18,12,0,2,0,3,18,1,17,11,0,2,0,3,17,1,16,11
0,0,4,3,28,2,26,18,0,4,0,3,26,2,24,16,0,4,0,3,24,2,22,15
4,2,1,3,14,12,2,1,2,1,4,3,2,1,1,0,2,1,4,3,1,0,1,0
0,4,0,3,4,0,4,2,4,0,0,3,4,0,4,2,4,0,0,3,4,0,4,2
1,4,3,3,7,2,5,3,4,3,1,3,5,1,4,2,4,3,1,3,4,1,3,2
1,0,4,3,29,8,21,14,0,4,1,3,21,6,15,10,0,4,1,3,15,4,11,7
1,4,1,4,2,0,2,1,4,1,1,4,2,0,2,1,4,1,1,4,2,0,2,1
2,1,3,1,24,11,13,3,1,3,2,1,13,6,7,2,1,3,2,1,7,3,4,1
4,0,0,1,4,3,1,0,0,0,4,1,1,0,1,0,0,0,4,1,1,0,1,0
4,3,2,0,10,8,2,0,3,2,4,0,2,1,1,0,3,2,4,0,1,0,1,0
4,4,1,0,4,3,1,0,4,1,4,0,1,0,1,0,4,1,4,0,1,0,1,0
1,3,2,3,5,1,4,2,3,2,1,3,4,1,3,2,3,2,1,3,3,0,3,2
4,4,4,0,1,0,1,0,4,4,4,0,1,0,1,0,4,4,4,0,1,0,1,0
1,0,1,4,11,3,8,7,0,1,1,4,8,2,6,5,0,1,1,4,6,1,5,4
0,2,2,3,16,1,15,10,2,2,0,3,15,1,14,9,2,2,0,3,14,1,13,9
3,2,2,1,11,7,4,1,2,2,3,1,4,2,2,0,2,2,3,1,2,1,1,0
4,4,2,2,0,0,0,0,4,2,4,2,0,0,0,0,4,2,4,2,0,0,0,0
2,2,3,3,16,8,8,5,2,3,2,3,8,4,4,2,2,3,2,3,4,2,2,1
4,2,4,2,26,23,3,1,2,4,4,2,3,2,1,0,2,4,4,2,1,0,1,0
0,1,3,1,19,1,18,5,1,3,0,1,18,1,17,5,1,3,0,1,17,1,16,4
3,3,2,2,15,10,5,2,3,2,3,2,5,3,2,0,3,2,3,2,2,1,1,0
3,1,1,1,13,9,4,1,1,1,3,1,4,2,2,0,1,1,3,1,2,1,1,0
1,4,1,0,4,1,3,0,4,1,1,0,3,0,3,0,4,1,1,0,3,0,3,0
1,1,0,1,8,2,6,1,1,0,1,1,6,1,5,1,1,0,1,1,5,1,4,1
4,0,4,3,29,26,3,2,0,4,4,3,3,2,1,0,0,4,4,3,1,0,1,0
0,0,1,0,17,1,16,1,0,1,0,0,16,1,15,1,0,1,0,0,15,1,14,1
4,2,2,3,4,3,1,0,2,2,4,3,1,0,1,0,2,2,4,3,1,0,1,0
3,0,2,1,19,13,6,1,0,2,3,1,6,4,2,0,0,2,3,1,2,1,1,0
3,0,1,2,12,8,4,2,0,1,3,2,4,2,2,0,0,1,3,2,2,1,1,0
1,2,1,3,12,3,9,6,2,1,1,3,9,2,7,4,2,1,1,3,7,2,5,3
1,0,0,2,13,3,10,4,0,0,1,2,10,2,8,4,0,0,1,2,8,2,6,3
2,2,2,1,12,5,7,2,2,2,2,1,7,3,4,1,2,2,2,1,4,2,2,0
2,3,1,3,6,3,3,2,3,1,2,3,3,1,2,1,3,1,2,3,2,0,2,1
4,3,3,4,12,10,2,1,3,3,4,4,2,1,1,0,3,3,4,4,1,0,1,0
4,4,3,2,2,1,1,0,4,3,4,2,1,0,1,0,4,3,4,2,1,0,1,0
4,4,1,4,8,7,1,0,4,1,4,4,1,0,1,0,4,1,4,4,1,0,1,0
4,4,3,3,6,5,1,0,4,3,4,3,1,0,1,0,4,3,4,3,1,0,1,0
4,0,3,2,27,24,3,1,0,3,4,2,3,2,1,0,0,3,4,2,1,0,1,0
2,1,3,4,20,9,11,9,1,3,2,4,11,5,6,5,1,3,2,4,6,3,3,2
4,4,0,2,7,6,1,0,4,0,4,2,1,0,1,0,4,0,4,2,1,0,1,0
3,2,2,2,13,9,4,2,2,2,3,2,4,2,2,1,2,2,3,2,2,1,1,0
3,3,1,1,8,5,3,0,3,1,3,1,3,2,1,0,3,1,3,1,1,0,1,0
3,3,0,0,5,3,2,0,3,0,3,0,2,1,1,0,3,0,3,0,1,0,1,0
3,1,1,0,5,3,2,0,1,1,3,0,2,1,1,0,1,1,3,0,1,0,1,0
4,1,4,3,21,18,3,2,1,4,4,3,3,2,1,0,1,4,4,3,1,0,1,0
3,0,1,4,12,8,4,3,0,1,3,4,4,2,2,1,0,1,3,4,2,1,1,0
0,3,2,2,6,0,6,3,3,2,0,2,6,0,6,3,3,2,0,2,6,0,6,2
4,2,0,3,1,0,1,0,2,0,4,3,1,0,1,0,2,0,4,3,1,0,1,0
3,4,4,4,10,6,4,3,4,4,3,4,4,2,2,1,4,4,3,4,2,1,1,0
3,3,2,3,2,1,1,0,3,2,3,3,1,0,1,0,3,2,3,3,1,0,1,0
0,1,3,2,23,2,21,10,1,3,0,2,21,2,19,9,1,3,0,2,19,1,18,9
2,1,3,3,20,9,11,7,1,3,2,3,11,5,6,4,1,3,2,3,6,3,3,2
4,1,2,4,9,8,1,0,1,2,4,4,1,0,1,0,1,2,4,4,1,0,1,0
1,4,4,4,3,0,3,2,4,4,1,4,3,0,3,2,4,4,1,4,3,0,3,2
4,0,3,3,29,26,3,2,0,3,4,3,3,2,1,0,0,3,4,3,1,0,1,0
1,0,0,3,3,0,3,2,0,0,1,3,3,0,3,2,0,0,1,3,3,0,3,2
1,4,2,4,6,1,5,4,4,2,1,4,5,1,4,3,4,2,1,4,4,1,3,2
1,0,4,4,27,8,19,17,0,4,1,4,19,5,14,12,0,4,1,4,14,4,10,8
3,4,0,2,3,2,1,0,4,0,3,2,1,0,1,0,4,0,3,2,1,0,1,0
3,3,2,2,14,9,5,2,3,2,3,2,5,3,2,0,3,2,3,2,2,1,1,0
3,0,4,0,29,20,9,0,0,4,3,0,9,6,3,0,0,4,3,0,3,2,1,0
2,3,1,4,10,4,6,5,3,1,2,4,6,3,3,2,3,1,2,4,3,1,2,1
4,0,1,0,15,13,2,0,0,1,4,0,2,1,1,0,0,1,4,0,1,0,1,0
1,2,4,3,17,5,12,8,2,4,1,3,12,3,9,6,2,4,1,3,9,2,7,4
4,0,3,3,25,22,3,2,0,3,4,3,3,2,1,0,0,3,4,3,1,0,1,0
1,2,1,4,10,3,7,6,2,1,1,4,7,2,5,4,2,1,1,4,5,1,4,3
3,0,4,1,28,19,9,2,0,4,3,1,9,6,3,0,0,4,3,1,3,2,1,0
1,2,0,1,7,2,5,1,2,0,1,1,5,1,4,1,2,0,1,1,4,1,3,0
1,1,3,4,14,4,10,8,1,3,1,4,10,3,7,6,1,3,1,4,7,2,5,4
1,1,0,2,5,1,4,2,1,0,1,2,4,1,3,1,1,0,1,2,3,0,3,1
3,0,3,3,15,10,5,3,0,3,3,3,5,3,2,1,0,3,3,3,2,1,1,0
2,3,4,0,17,8,9,0,3,4,2,0,9,4,5,0,3,4,2,0,5,2,3,0
0,2,0,0,2,0,2,0,2,0,0,0,2,0,2,0,2,0,0,0,2,0,2,0
0,2,2,2,10,0,10,5,2,2,0,2,10,1,9,4,2,2,0,2,9,0,9,4
2,4,3,0,0,0,0,0,4,3,2,0,0,0,0,0,4,3,2,0,0,0,0,0
3,1,2,0,22,15,7,0,1,2,3,0,7,4,3,0,1,2,3,0,3,2,1,0
0,1,2,3,19,1,18,12,1,2,0,3,18,1,17,11,1,2,0,3,17,1,16,11
4,4,1,4,8,7,1,0,4,1,4,4,1,0,1,0,4,1,4,4,1,0,1,0
0,0,3,3,27,2,25,17,0,3,0,3,25,2,23,16,0,3,0,3,23,2,21,14
1,1,1,3,7,2,5,3,1,1,1,3,5,1,4,2,1,1,1,3,4,1,3,2
1,1,2,3,4,1,3,2,1,2,1,3,3,0,3,2,1,2,1,3,3,0,3,2
3,2,0,1,1,0,1,0,2,0,3,1,1,0,1,0,2,0,3,1,1,0,1,0
1,1,0,2,8,2,6,3,1,0,1,2,6,1,5,2,1,0,1,2,5,1,4,2
2,1,4,2,29,14,15,7,1,4,2,2,15,7,8,4,1,4,2,2,8,3,5,2
4,3,0,0,6,5,1,0,3,0,4,0,1,0,1,0,3,0,4,0,1,0,1,0
4,1,1,4,14,12,2,1,1,1,4,4,2,1,1,0,1,1,4,4,1,0,1,0
4,4,0,3,7,6,1,0,4,0,4,3,1,0,1,0,4,0,4,3,1,0,1,0
3,1,2,3,26,18,8,5,1,2,3,3,8,5,3,2,1,2,3,3,3,2,1,0
2,3,3,4,8,3,5,4,3,3,2,4,5,2,3,2,3,3,2,4,3,1,2,1
3,2,0,0,13,9,4,0,2,0,3,0,4,2,2,0,2,0,3,0,2,1,1,0
1,3,4,3,22,6,16,11,3,4,1,3,16,4,12,8,3,4,1,3,12,3,9,6
3,3,0,2,7,4,3,1,3,0,3,2,3,2,1,0,3,0,3,2,1,0,1,0
4,3,1,1,10,8,2,0,3,1,4,1,2,1,1,0,3,1,4,1,1,0,1,0
3,0,2,0,17,11,6,0,0,2,3,0,6,4,2,0,0,2,3,0,2,1,1,0
4,4,3,2,1,0,1,0,4,3,4,2,1,0,1,0,4,3,4,2,1,0,1,0
4,0,1,2,12,10,2,0,0,1,4,2,2,1,1,0,0,1,4,2,1,0,1,0
3,4,3,2,7,4,3,1,4,3,3,2,3,2,1,0,4,3,3,2,1,0,1,0
1,3,1,0,4,1,3,0,3,1,1,0,3,0,3,0,3,1,1,0,3,0,3,0
0,3,0,4,4,0,4,3,3,0,0,4,4,0,4,3,3,0,0,4,4,0,4,3
2,1,4,0,26,12,14,1,1,4,2,0,14,6,8,0,1,4,2,0,8,4,4,0
1,4,2,0,3,0,3,0,4,2,1,0,3,0,3,0,4,2,1,0,3,0,3,0
2,4,3,3,2,0,2,1,4,3,2,3,2,0,2,1,4,3,2,3,2,1,1,0
3,4,0,2,3,2,1,0,4,0,3,2,1,0,1,0,4,0,3,2,1,0,1,0
3,2,2,2,0,0,0,0,2,2,3,2,0,0,0,0,2,2,3,2,0,0,0,0
3,0,2,4,21,14,7,6,0,2,3,4,7,4,3,2,0,2,3,4,3,2,1,0
4,0,4,1,24,21,3,0,0,4,4,1,3,2,1,0,0,4,4,1,1,0,1,0
0,4,0,3,5,0,5,3,4,0,0,3,5,0,5,3,4,0,0,3,5,0,5,3
2,1,4,4,24,12,12,10,1,4,2,4,12,5,7,6,1,4,2,4,7,3,4,3
3,2,4,4,19,13,6,5,2,4,3,4,6,4,2,1,2,4,3,4,2,1,1,0
4,1,3,3,21,18,3,2,1,3,4,3,3,2,1,0,1,3,4,3,1,0,1,0
4,3,0,3,0,0,0,0,3,0,4,3,0,0,0,0,3,0,4,3,0,0,0,0
3,0,3,1,26,18,8,2,0,3,3,1,8,5,3,0,0,3,3,1,3,2,1,0
0,0,2,3,20,1,19,13,0,2,0,3,19,1,18,12,0,2,0,3,18,1,17,11
4,4,2,2,9,8,1,0,4,2,4,2,1,0,1,0,4,2,4,2,1,0,1,0
0,2,0,0,6,0,6,0,2,0,0,0,6,0,6,0,2,0,0,0,6,0,6,0
2,3,0,4,6,2,4,3,3,0,2,4,4,1,3,2,3,0,2,4,3,1,2,1
3,3,3,2,16,11,5,2,3,3,3,2,5,3,2,1,3,3,3,2,2,1,1,0
4,0,4,1,29,26,3,0,0,4,4,1,3,2,1,0,0,4,4,1,1,0,1,0
3,3,2,1,20,13,7,2,3,2,3,1,7,4,3,0,3,2,3,1,3,2,1,0
4,1,4,3,29,26,3,2,1,4,4,3,3,2,1,0,1,4,4,3,1,0,1,0
0,1,1,1,6,0,6,1,1,1,0,1,6,0,6,1,1,1,0,1,6,0,6,1
0,1,1,3,12,1,11,7,1,1,0,3,11,1,10,6,1,1,0,3,10,1,9,6
0,4,2,2,12,1,11,5,4,2,0,2,11,1,10,4,4,2,0,2,10,0,10,5
0,4,2,0,14,1,13,1,4,2,0,0,13,1,12,1,4,2,0,0,12,1,11,1
2,2,3,1,13,6,7,2,2,3,2,1,7,3,4,1,2,3,2,1,4,2,2,0
4,1,4,1,27,24,3,0,1,4,4,1,3,2,1,0,1,4,4,1,1,0,1,0
0,2,2,4,14,1,13,11,2,2,0,4,13,1,12,10,2,2,0,4,12,1,11,9
2,2,3,0,15,7,8,0,2,3,2,0,8,4,4,0,2,3,2,0,4,1,3,0
1,4,1,0,6,1,5,0,4,1,1,0,5,1,4,0,4,1,1,0,4,1,3,0
1,4,3,1,11,3,8,2,4,3,1,1,8,2,6,1,4,3,1,1,6,1,5,1
0,3,2,4,9,0,9,8,3,2,0,4,9,0,9,8,3,2,0,4,9,0,9,8
3,2,0,0,6,4,2,0,2,0,3,0,2,1,1,0,2,0,3,0,1,0,1,0
3,3,0,1,6,4,2,0,3,0,3,1,2,1,1,0,3,0,3,1,1,0,1,0
2,4,3,0,17,8,9,0,4,3,2,0,9,4,5,0,4,3,2,0,5,2,3,0
4,4,3,0,0,0,0,0,4,3,4,0,0,0,0,0,4,3,4,0,0,0,0,0
4,0,3,0,17,15,2,0,0,3,4,0,2,1,1,0,0,3,4,0,1,0,1,0
3,4,2,2,3,2,1,0,4,2,3,2,1,0,1,0,4,2,3,2,1,0,1,0
2,1,0,0,5,2,3,0,1,0,2,0,3,1,2,0,1,0,2,0,2,1,1,0
2,2,2,1,15,7,8,2,2,2,2,1,8,3,5,1,2,2,2,1,5,2,3,0
0,1,1,4,15,1,14,12,1,1,0,4,14,1,13,11,1,1,0,4,13,1,12,10
0,1,2,3,18,1,17,11,1,2,0,3,17,1,16,11,1,2,0,3,16,1,15,10
1,4,2,3,6,1,5,3,4,2,1,3,5,1,4,2,4,2,1,3,4,1,3,2
2,2,1,2,17,8,9,4,2,1,2,2,9,4,5,2,2,1,2,2,5,2,3,1
0,3,4,2,21,2,19,9,3,4,0,2,19,1,18,8,3,4,0,2,18,1,17,8
0,3,0,0,7,0,7,0,3,0,0,0,7,0,7,0,3,0,0,0,7,0,7,0
1,3,3,2,14,4,10,5,3,3,1,2,10,3,7,3,3,3,1,2,7,2,5,2
0,1,1,3,9,0,9,6,1,1,0,3,9,0,9,6,1,1,0,3,9,0,9,6
2,1,0,0,10,5,5,0,1,0,2,0,5,2,3,0,1,0,2,0,3,1,2,0
1,4,2,2,9,2,7,3,4,2,1,2,7,2,5,2,4,2,1,2,5,1,4,2
4,1,0,3,13,11,2,1,1,0,4,3,2,1,1,0,1,0,4,3,1,0,1,0
4,3,1,2,9,8,1,0,3,1,4,2,1,0,1,0,3,1,4,2,1,0,1,0
0,3,3,4,19,1,18,16,3,3,0,4,18,1,17,15,3,3,0,4,17,1,16,14
0,0,1,1,15,1,14,4,0,1,0,1,14,1,13,3,0,1,0,1,13,1,12,3
2,2,0,3,1,0,1,0,2,0,2,3,1,0,1,0,2,0,2,3,1,0,1,0
1,4,1,0,9,2,7,0,4,1,1,0,7,2,5,0,4,1,1,0,5,1,4,0
4,2,4,0,18,16,2,0,2,4,4,0,2,1,1,0,2,4,4,0,1,0,1,0
3,1,4,4,20,14,6,5,1,4,3,4,6,4,2,1,1,4,3,4,2,1,1,0
0,4,1,3,9,0,9,6,4,1,0,3,9,0,9,6,4,1,0,3,9,0,9,6
2,4,0,3,3,1,2,1,4,0,2,3,2,0,2,1,4,0,2,3,2,0,2,1
2,0,1,4,11,5,6,5,0,1,2,4,6,2,4,3,0,1,2,4,4,1,3,2
3,1,3,3,20,14,6,4,1,3,3,3,6,4,2,1,1,3,3,3,2,1,1,0
3,0,4,4,27,18,9,8,0,4,3,4,9,6,3,2,0,4,3,4,3,2,1,0
2,4,1,3,0,0,0,0,4,1,2,3,0,0,0,0,4,1,2,3,0,0,0,0
1,1,1,4,13,3,10,9,1,1,1,4,10,3,7,6,1,1,1,4,7,2,5,4
0,1,3,0,17,1,16,1,1,3,0,0,16,1,15,1,1,3,0,0,15,1,14,1
3,4,4,1,2,1,1,0,4,4,3,1,1,0,1,0,4,4,3,1,1,0,1,0
1,2,2,1,10,3,7,2,2,2,1,1,7,2,5,1,2,2,1,1,5,1,4,1
0,0,2,3,24,2,22,15,0,2,0,3,22,2,20,13,0,2,0,3,20,1,19,13
1,3,4,1,6,1,5,1,3,4,1,1,5,1,4,1,3,4,1,1,4,1,3,0
3,1,4,4,29,20,9,8,1,4,3,4,9,6,3,2,1,4,3,4,3,2,1,0
2,4,0,1,0,0,0,0,4,0,2,1,0,0,0,0,4,0,2,1,0,0,0,0
1,2,2,4,13,3,10,8,2,2,1,4,10,3,7,6,2,2,1,4,7,2,5,4
0,4,2,4,4,0,4,3,4,2,0,4,4,0,4,3,4,2,0,4,4,0,4,3
1,0,4,3,29,8,21,14,0,4,1,3,21,6,15,10,0,4,1,3,15,4,11,7
2,3,4,3,20,10,10,6,3,4,2,3,10,4,6,4,3,4,2,3,6,2,4,2
4,3,1,0,5,4,1,0,3,1,4,0,1,0,1,0,3,1,4,0,1,0,1,0
1,2,3,2,22,6,16,7,2,3,1,2,16,4,12,5,2,3,1,2,12,3,9,4
4,3,0,0,1,0,1,0,3,0,4,0,1,0,1,0,3,0,4,0,1,0,1,0
2,2,2,3,14,7,7,4,2,2,2,3,7,3,4,2,2,2,2,3,4,2,2,1
2,0,3,0,23,11,12,1,0,3,2,0,12,5,7,0,0,3,2,0,7,3,4,0
0,0,1,3,17,1,16,11,0,1,0,3,16,1,15,10,0,1,0,3,15,1,14,9
2,0,0,1,9,4,5,1,0,0,2,1,5,2,3,0,0,0,2,1,3,1,2,0
2,0,4,2,29,14,15,7,0,4,2,2,15,7,8,4,0,4,2,2,8,4,4,1
4,0,4,4,29,26,3,2,0,4,4,4,3,2,1,0,0,4,4,4,1,0,1,0
3,2,2,3,10,7,3,2,2,2,3,3,3,2,1,0,2,2,3,3,1,0,1,0
0,0,1,0,17,1,16,1,0,1,0,0,16,1,15,1,0,1,0,0,15,1,14,1
4,4,3,3,10,8,2,1,4,3,4,3,2,1,1,0,4,3,4,3,1,0,1,0
2,2,1,2,6,2,4,1,2,1,2,2,4,1,3,1,2,1,2,2,3,1,2,0
3,3,1,2,4,2,2,0,3,1,3,2,2,1,1,0,3,1,3,2,1,0,1,0
0,0,1,1,15,1,14,4,0,1,0,1,14,1,13,3,0,1,0,1,13,1,12,3
2,2,1,1,0,0,0,0,2,1,2,1,0,0,0,0,2,1,2,1,0,0,0,0
3,4,4,4,11,7,4,3,4,4,3,4,4,2,2,1,4,4,3,4,2,1,1,0
3,4,0,1,4,2,2,0,4,0,3,1,2,1,1,0,4,0,3,1,1,0,1,0
2,3,2,1,8,4,4,1,3,2,2,1,4,1,3,0,3,2,2,1,3,1,2,0
2,1,4,1,24,11,13,3,1,4,2,1,13,6,7,2,1,4,2,1,7,3,4,1
0,3,0,0,4,0,4,0,3,0,0,0,4,0,4,0,3,0,0,0,4,0,4,0
3,0,4,2,27,18,9,4,0,4,3,2,9,6,3,1,0,4,3,2,3,2,1,0
0,1,3,0,25,2,23,2,1,3,0,0,23,2,21,2,1,3,0,0,21,2,19,1
3,4,1,3,0,0,0,0,4,1,3,3,0,0,0,0,4,1,3,3,0,0,0,0
0,4,2,0,12,1,11,1,4,2,0,0,11,1,10,1,4,2,0,0,10,0,10,1
4,3,2,0,11,9,2,0,3,2,4,0,2,1,1,0,3,2,4,0,1,0,1,0
0,2,2,4,13,1,12,10,2,2,0,4,12,1,11,9,2,2,0,4,11,1,10,9
0,3,3,0,22,2,20,2,3,3,0,0,20,2,18,1,3,3,0,0,18,1,17,1
2,4,4,0,1,0,1,0,4,4,2,0,1,0,1,0,4,4,2,0,1,0,1,0
2,0,3,1,29,14,15,4,0,3,2,1,15,7,8,2,0,3,2,1,8,4,4,1
1,1,4,0,29,8,21,2,1,4,1,0,21,6,15,1,1,4,1,0,15,4,11,1
2,2,1,1,5,2,3,0,2,1,2,1,3,1,2,0,2,1,2,1,2,1,1,0
4,3,4,4,15,13,2,1,3,4,4,4,2,1,1,0,3,4,4,4,1,0,1,0
0,0,4,1,26,2,24,7,0,4,0,1,24,2,22,6,0,4,0,1,22,2,20,5
0,4,4,3,3,0,3,2,4,4,0,3,3,0,3,2,4,4,0,3,3,0,3,2
0,4,4,3,1,0,1,0,4,4,0,3,1,0,1,0,4,4,0,3,1,0,1,0
1,2,3,4,23,6,17,15,2,3,1,4,17,5,12,10,2,3,1,4,12,3,9,8
1,0,2,2,17,5,12,5,0,2,1,2,12,3,9,4,0,2,1,2,9,2,7,3
2,3,4,2,11,5,6,3,3,4,2,2,6,2,4,1,3,4,2,2,4,2,2,0
4,0,2,3,18,16,2,1,0,2,4,3,2,1,1,0,0,2,4,3,1,0,1,0
1,0,0,3,7,2,5,3,0,0,1,3,5,1,4,2,0,0,1,3,4,1,3,2
3,0,2,2,23,16,7,3,0,2,3,2,7,4,3,1,0,2,3,2,3,2,1,0
1,4,2,1,0,0,0,0,4,2,1,1,0,0,0,0,4,2,1,1,0,0,0,0
1,1,0,1,6,1,5,1,1,0,1,1,5,1,4,1,1,0,1,1,4,1,3,0
1,2,0,1,4,1,3,0,2,0,1,1,3,0,3,0,2,0,1,1,3,0,3,0
1,4,2,3,9,2,7,4,4,2,1,3,7,2,5,3,4,2,1,3,5,1,4,2
3,1,3,3,23,16,7,4,1,3,3,3,7,4,3,2,1,3,3,3,3,2,1,0
0,0,2,0,26,2,24,2,0,2,0,0,24,2,22,2,0,2,0,0,22,2,20,2
1,1,2,1,18,5,13,3,1,2,1,1,13,3,10,2,1,2,1,1,10,3,7,2
3,2,1,0,6,4,2,0,2,1,3,0,2,1,1,0,2,1,3,0,1,0,1,0
3,2,4,1,25,17,8,2,2,4,3,1,8,5,3,0,2,4,3,1,3,2,1,0
1,3,1,1,11,3,8,2,3,1,1,1,8,2,6,1,3,1,1,1,6,1,5,1
3,4,1,0,6,4,2,0,4,1,3,0,2,1,1,0,4,1,3,0,1,0,1,0
4,0,1,4,17,15,2,1,0,1,4,4,2,1,1,0,0,1,4,4,1,0,1,0
4,4,2,4,3,2,1,0,4,2,4,4,1,0,1,0,4,2,4,4,1,0,1,0
0,4,3,0,4,0,4,0,4,3,0,0,4,0,4,0,4,3,0,0,4,0,4,0
3,1,1,2,7,4,3,1,1,1,3,2,3,2,1,0,1,1,3,2,1,0,1,0
0,3,0,4,2,0,2,1,3,0,0,4,2,0,2,1,3,0,0,4,2,0,2,1
0,2,0,4,11,1,10,9,2,0,0,4,10,0,10,9,2,0,0,4,10,0,10,8
2,2,4,1,21,10,11,3,2,4,2,1,11,5,6,1,2,4,2,1,6,2,4,1
0,4,4,0,3,0,3,0,4,4,0,0,3,0,3,0,4,4,0,0,3,0,3,0
4,2,3,1,25,22,3,0,2,3,4,1,3,2,1,0,2,3,4,1,1,0,1,0
1,3,0,3,9,2,7,4,3,0,1,3,7,2,5,3,3,0,1,3,5,1,4,2
2,2,4,1,22,10,12,3,2,4,2,1,12,6,6,1,2,4,2,1,6,3,3,0
1,1,1,2,22,6,16,7,1,1,1,2,16,4,12,6,1,1,1,2,12,3,9,4
4,3,1,1,16,14,2,0,3,1,4,1,2,1,1,0,3,1,4,1,1,0,1,0
2,2,2,4,11,5,6,5,2,2,2,4,6,3,3,2,2,2,2,4,3,1,2,1
0,2,4,1,19,1,18,5,2,4,0,1,18,1,17,5,2,4,0,1,17,1,16,4
4,2,0,3,11,9,2,1,2,0,4,3,2,1,1,0,2,0,4,3,1,0,1,0
4,3,0,4,6,5,1,0,3,0,4,4,1,0,1,0,3,0,4,4,1,0,1,0
4,4,3,1,6,5,1,0,4,3,4,1,1,0,1,0,4,3,4,1,1,0,1,0
0,4,4,1,9,0,9,2,4,4,0,1,9,0,9,2,4,4,0,1,9,0,9,2
4,1,2,1,16,14,2,0,1,2,4,1,2,1,1,0,1,2,4,1,1,0,1,0
4,4,1,3,6,5,1,0,4,1,4,3,1,0,1,0,4,1,4,3,1,0,1,0
4,2,4,3,21,18,3,2,2,4,4,3,3,2,1,0,2,4,4,3,1,0,1,0
3,3,2,3,12,8,4,2,3,2,3,3,4,2,2,1,3,2,3,3,2,1,1,0
0,4,2,2,0,0,0,0,4,2,0,2,0,0,0,0,4,2,0,2,0,0,0,0
1,0,2,3,22,6,16,11,0,2,1,3,16,4,12,8,0,2,1,3,12,3,9,6
2,1,2,2,10,5,5,2,1,2,2,2,5,2,3,1,1,2,2,2,3,1,2,1
4,0,2,3,20,18,2,1,0,2,4,3,2,1,1,0,0,2,4,3,1,0,1,0
2,1,4,0,24,11,13,1,1,4,2,0,13,6,7,0,1,4,2,0,7,3,4,0
1,0,0,1,8,2,6,1,0,0,1,1,6,1,5,1,0,0,1,1,5,1,4,1
1,3,0,1,2,0,2,0,3,0,1,1,2,0,2,0,3,0,1,1,2,0,2,0
2,1,0,0,1,0,1,0,1,0,2,0,1,0,1,0,1,0,2,0,1,0,1,0
1,0,4,2,26,7,19,9,0,4,1,2,19,5,14,6,0,4,1,2,14,4,10,5
1,1,0,3,9,2,7,4,1,0,1,3,7,2,5,3,1,0,1,3,5,1,4,2
0,3,0,2,2,0,2,0,3,0,0,2,2,0,2,1,3,0,0,2,2,0,2,0
1,0,4,1,29,8,21,6,0,4,1,1,21,6,15,4,0,4,1,1,15,4,11,3
2,2,4,3,14,7,7,4,2,4,2,3,7,3,4,2,2,4,2,3,4,1,3,2
3,1,3,3,27,18,9,6,1,3,3,3,9,6,3,2,1,3,3,3,3,2,1,0
3,4,4,2,6,4,2,0,4,4,3,2,2,1,1,0,4,4,3,2,1,0,1,0
0,0,4,1,29,2,27,8,0,4,0,1,27,2,25,7,0,4,0,1,25,2,23,6
1,0,1,2,16,4,12,6,0,1,1,2,12,3,9,4,0,1,1,2,9,2,7,3
2,3,4,3,12,5,7,4,3,4,2,3,7,3,4,2,3,4,2,3,4,1,3,2
2,0,4,4,28,13,15,13,0,4,2,4,15,7,8,7,0,4,2,4,8,4,4,3
0,1,0,3,9,0,9,6,1,0,0,3,9,0,9,6,1,0,0,3,9,0,9,6
1,4,2,0,5,1,4,0,4,2,1,0,4,1,3,0,4,2,1,0,3,0,3,0
3,3,4,4,16,11,5,4,3,4,3,4,5,3,2,1,3,4,3,4,2,1,1,0
3,0,4,4,25,17,8,7,0,4,3,4,8,5,3,2,0,4,3,4,3,2,1,0
2,2,3,4,9,4,5,4,2,3,2,4,5,2,3,2,2,3,2,4,3,1,2,1
1,3,1,0,3,0,3,0,3,1,1,0,3,0,3,0,3,1,1,0,3,0,3,0
1,2,3,1,17,5,12,3,2,3,1,1,12,3,9,2,2,3,1,1,9,2,7,2
4,1,4,0,27,24,3,0,1,4,4,0,3,2,1,0,1,4,4,0,1,0,1,0
3,4,1,2,8,5,3,1,4,1,3,2,3,2,1,0,4,1,3,2,1,0,1,0
2,0,0,3,15,7,8,5,0,0,2,3,8,3,5,3,0,0,2,3,5,2,3,2
0,2,4,0,13,1,12,1,2,4,0,0,12,1,11,1,2,4,0,0,11,1,10,0
1,3,0,0,0,0,0,0,3,0,1,0,0,0,0,0,3,0,1,0,0,0,0,0
1,4,1,4,12,3,9,8,4,1,1,4,9,2,7,6,4,1,1,4,7,2,5,4
2,0,2,4,24,12,12,10,0,2,2,4,12,5,7,6,0,2,2,4,7,3,4,3
1,1,2,0,15,4,11,1,1,2,1,0,11,3,8,0,1,2,1,0,8,2,6,0
4,1,1,4,12,10,2,1,1,1,4,4,2,1,1,0,1,1,4,4,1,0,1,0
1,3,4,4,19,5,14,12,3,4,1,4,14,4,10,9,3,4,1,4,10,3,7,6
4,1,3,1,20,17,3,0,1,3,4,1,3,2,1,0,1,3,4,1,1,0,1,0
3,3,4,1,13,9,4,1,3,4,3,1,4,2,2,0,3,4,3,1,2,1,1,0
3,4,0,4,4,2,2,1,4,0,3,4,2,1,1,0,4,0,3,4,1,0,1,0
0,1,2,1,23,2,21,6,1,2,0,1,21,2,19,5,1,2,0,1,19,1,18,5
1,1,1,0,16,4,12,1,1,1,1,0,12,3,9,0,1,1,1,0,9,2,7,0
1,1,0,2,8,2,6,3,1,0,1,2,6,1,5,2,1,0,1,2,5,1,4,2
3,2,3,2,15,10,5,2,2,3,3,2,5,3,2,1,2,3,3,2,2,1,1,0
1,3,4,0,19,5,14,1,3,4,1,0,14,4,10,0,3,4,1,0,10,2,8,0
2,0,0,3,8,4,4,2,0,0,2,3,4,1,3,2,0,0,2,3,3,1,2,1
1,1,3,0,25,7,18,1,1,3,1,0,18,5,13,1,1,3,1,0,13,3,10,1
0,3,3,0,8,0,8,0,3,3,0,0,8,0,8,0,3,3,0,0,8,0,8,0
4,3,4,2,7,6,1,0,3,4,4,2,1,0,1,0,3,4,4,2,1,0,1,0
0,0,3,0,24,2,22,2,0,3,0,0,22,2,20,2,0,3,0,0,20,1,19,1
1,1,2,0,26,7,19,1,1,2,1,0,19,5,14,1,1,2,1,0,14,4,10,1
1,3,1,3,5,1,4,2,3,1,1,3,4,1,3,2,3,1,1,3,3,0,3,2
0,0,2,0,21,2,19,1,0,2,0,0,19,1,18,1,0,2,0,0,18,1,17,1
1,1,1,4,12,3,9,8,1,1,1,4,9,2,7,6,1,1,1,4,7,2,5,4
3,4,1,2,8,5,3,1,4,1,3,2,3,2,1,0,4,1,3,2,1,0,1,0
0,1,2,0,6,0,6,0,1,2,0,0,6,0,6,0,1,2,0,0,6,0,6,0
4,4,0,4,0,0,0,0,4,0,4,4,0,0,0,0,4,0,4,4,0,0,0,0
4,3,2,2,5,4,1,0,3,2,4,2,1,0,1,0,3,2,4,2,1,0,1,0
1,4,0,4,5,1,4,3,4,0,1,4,4,1,3,2,4,0,1,4,3,0,3,2
0,0,3,4,24,2,22,19,0,3,0,4,22,2,20,18,0,3,0,4,20,2,18,16
3,0,0,3,19,13,6,4,0,0,3,3,6,4,2,1,0,0,3,3,2,1,1,0
0,0,0,4,4,0,4,3,0,0,0,4,4,0,4,3,0,0,0,4,4,0,4,3
3,3,1,1,7,4,3,0,3,1,3,1,3,2,1,0,3,1,3,1,1,0,1,0
2,3,4,0,20,10,10,0,3,4,2,0,10,4,6,0,3,4,2,0,6,3,3,0
1,0,1,1,18,5,13,3,0,1,1,1,13,3,10,2,0,1,1,1,10,3,7,2
0,2,1,1,13,1,12,3,2,1,0,1,12,1,11,3,2,1,0,1,11,1,10,3
4,4,0,3,1,0,1,0,4,0,4,3,1,0,1,0,4,0,4,3,1,0,1,0
4,3,4,4,22,19,3,2,3,4,4,4,3,2,1,0,3,4,4,4,1,0,1,0
1,3,2,1,18,5,13,3,3,2,1,1,13,3,10,2,3,2,1,1,10,2,8,2
4,0,2,0,15,13,2,0,0,2,4,0,2,1,1,0,0,2,4,0,1,0,1,0
3,1,2,4,13,9,4,3,1,2,3,4,4,2,2,1,1,2,3,4,2,1,1,0
0,2,1,1,16,1,15,4,2,1,0,1,15,1,14,4,2,1,0,1,14,1,13,3
2,0,3,1,26,12,14,4,0,3,2,1,14,7,7,2,0,3,2,1,7,3,4,1
4,2,2,2,15,13,2,0,2,2,4,2,2,1,1,0,2,2,4,2,1,0,1,0
4,2,1,3,15,13,2,1,2,1,4,3,2,1,1,0,2,1,4,3,1,0,1,0
4,1,0,2,8,7,1,0,1,0,4,2,1,0,1,0,1,0,4,2,1,0,1,0
2,3,2,1,4,2,2,0,3,2,2,1,2,0,2,0,3,2,2,1,2,1,1,0
2,3,4,2,24,12,12,5,3,4,2,2,12,5,7,3,3,4,2,2,7,3,4,2
0,3,4,1,14,1,13,3,3,4,0,1,13,1,12,3,3,4,0,1,12,1,11,3
2,0,1,3,22,11,11,7,0,1,2,3,11,5,6,4,0,1,2,3,6,3,3,2
0,3,1,1,6,0,6,1,3,1,0,1,6,0,6,1,3,1,0,1,6,0,6,1
1,4,3,0,13,3,10,0,4,3,1,0,10,3,7,0,4,3,1,0,7,2,5,0
2,4,1,0,5,2,3,0,4,1,2,0,3,1,2,0,4,1,2,0,2,0,2,0
2,2,0,1,0,0,0,0,2,0,2,1,0,0,0,0,2,0,2,1,0,0,0,0
4,3,0,4,5,4,1,0,3,0,4,4,1,0,1,0,3,0,4,4,1,0,1,0
4,1,2,0,18,16,2,0,1,2,4,0,2,1,1,0,1,2,4,0,1,0,1,0
4,3,4,0,12,10,2,0,3,4,4,0,2,1,1,0,3,4,4,0,1,0,1,0
2,1,4,4,23,11,12,10,1,4,2,4,12,5,7,6,1,4,2,4,7,3,4,3
0,3,1,4,13,1,12,10,3,1,0,4,12,1,11,9,3,1,0,4,11,1,10,9
3,3,0,1,1,0,1,0,3,0,3,1,1,0,1,0,3,0,3,1,1,0,1,0
3,2,3,3,12,8,4,2,2,3,3,3,4,2,2,1,2,3,3,3,2,1,1,0
0,2,0,1,9,0,9,2,2,0,0,1,9,0,9,2,2,0,0,1,9,0,9,2
4,3,2,3,9,8,1,0,3,2,4,3,1,0,1,0,3,2,4,3,1,0,1,0
0,4,3,3,8,0,8,5,4,3,0,3,8,0,8,5,4,3,0,3,8,0,8,5
3,4,3,4,10,6,4,3,4,3,3,4,4,2,2,1,4,3,3,4,2,1,1,0
2,3,0,4,3,1,2,1,3,0,2,4,2,0,2,1,3,0,2,4,2,0,2,1
3,2,0,3,1,0,1,0,2,0,3,3,1,0,1,0,2,0,3,3,1,0,1,0
0,3,3,2,13,1,12,5,3,3,0,2,12,1,11,5,3,3,0,2,11,1,10,4
4,3,0,3,0,0,0,0,3,0,4,3,0,0,0,0,3,0,4,3,0,0,0,0
0,2,2,4,13,1,12,10,2,2,0,4,12,1,11,9,2,2,0,4,11,1,10,9
4,4,2,4,9,8,1,0,4,2,4,4,1,0,1,0,4,2,4,4,1,0,1,0
4,0,4,1,27,24,3,0,0,4,4,1,3,2,1,0,0,4,4,1,1,0,1,0
0,0,0,3,13,1,12,8,0,0,0,3,12,1,11,7,0,0,0,3,11,1,10,7
0,0,2,0,22,2,20,1,0,2,0,0,20,1,19,1,0,2,0,0,19,1,18,1
3,0,4,1,29,20,9,2,0,4,3,1,9,6,3,0,0,4,3,1,3,2,1,0
0,1,2,0,19,1,18,1,1,2,0,0,18,1,17,1,1,2,0,0,17,1,16,1
4,0,4,0,28,25,3,0,0,4,4,0,3,2,1,0,0,4,4,0,1,0,1,0
4,0,0,3,12,10,2,1,0,0,4,3,2,1,1,0,0,0,4,3,1,0,1,0
2,0,2,0,21,10,11,1,0,2,2,0,11,5,6,0,0,2,2,0,6,3,3,0
1,2,1,0,24,7,17,1,2,1,1,0,17,5,12,1,2,1,1,0,12,3,9,0
2,0,4,1,29,14,15,4,0,4,2,1,15,7,8,2,0,4,2,1,8,4,4,1
2,2,0,0,10,4,6,0,2,0,2,0,6,2,4,0,2,0,2,0,4,1,3,0
4,2,0,2,6,5,1,0,2,0,4,2,1,0,1,0,2,0,4,2,1,0,1,0
3,1,0,4,5,3,2,1,1,0,3,4,2,1,1,0,1,0,3,4,1,0,1,0
2,0,0,1,0,0,0,0,0,0,2,1,0,0,0,0,0,0,2,1,0,0,0,0
0,2,3,2,13,1,12,5,2,3,0,2,12,1,11,5,2,3,0,2,11,1,10,4
1,3,0,1,2,0,2,0,3,0,1,1,2,0,2,0,3,0,1,1,2,0,2,0
3,4,4,4,4,2,2,1,4,4,3,4,2,1,1,0,4,4,3,4,1,0,1,0
4,1,4,2,24,21,3,1,1,4,4,2,3,2,1,0,1,4,4,2,1,0,1,0
0,1,2,2,22,2,20,9,1,2,0,2,20,2,18,9,1,2,0,2,18,1,17,8
1,1,0,1,1,0,1,0,1,0,1,1,1,0,1,0,1,0,1,1,1,0,1,0
2,0,0,4,10,4,6,5,0,0,2,4,6,3,3,2,0,0,2,4,3,1,2,1
1,4,1,1,5,1,4,1,4,1,1,1,4,1,3,0,4,1,1,1,3,0,3,0
0,3,4,1,16,1,15,4,3,4,0,1,15,1,14,4,3,4,0,1,14,1,13,3
2,1,4,0,28,14,14,1,1,4,2,0,14,6,8,0,1,4,2,0,8,3,5,0
0,0,3,2,29,2,27,13,0,3,0,2,27,2,25,12,0,3,0,2,25,2,23,11
3,1,3,3,15,10,5,3,1,3,3,3,5,3,2,1,1,3,3,3,2,1,1,0
0,2,0,0,1,0,1,0,2,0,0,0,1,0,1,0,2,0,0,0,1,0,1,0
0,4,4,1,8,0,8,2,4,4,0,1,8,0,8,2,4,4,0,1,8,0,8,2
0,3,4,0,6,0,6,0,3,4,0,0,6,0,6,0,3,4,0,0,6,0,6,0
4,2,4,0,16,14,2,0,2,4,4,0,2,1,1,0,2,4,4,0,1,0,1,0
1,3,2,2,5,1,4,1,3,2,1,2,4,1,3,1,3,2,1,2,3,0,3,1
0,3,2,2,6,0,6,3,3,2,0,2,6,0,6,3,3,2,0,2,6,0,6,2
3,2,4,2,22,15,7,3,2,4,3,2,7,4,3,1,2,4,3,2,3,2,1,0
0,4,3,1,10,1,9,2,4,3,0,1,9,0,9,2,4,3,0,1,9,0,9,2
0,2,3,3,22,2,20,13,2,3,0,3,20,1,19,13,2,3,0,3,19,1,18,12
0,1,0,1,8,0,8,2,1,0,0,1,8,0,8,2,1,0,0,1,8,0,8,2
4,4,4,1,2,1,1,0,4,4,4,1,1,0,1,0,4,4,4,1,1,0,1,0
4,2,4,3,22,19,3,2,2,4,4,3,3,2,1,0,2,4,4,3,1,0,1,0
0,1,1,4,12,1,11,9,1,1,0,4,11,1,10,8,1,1,0,4,10,1,9,8
3,1,0,1,9,6,3,0,1,0,3,1,3,2,1,0,1,0,3,1,1,0,1,0
3,0,3,3,25,17,8,5,0,3,3,3,8,5,3,2,0,3,3,3,3,2,1,0
3,0,4,4,29,20,9,8,0,4,3,4,9,6,3,2,0,4,3,4,3,2,1,0
2,4,1,3,5,2,3,2,4,1,2,3,3,1,2,1,4,1,2,3,2,1,1,0
2,3,1,2,4,2,2,0,3,1,2,2,2,1,1,0,3,1,2,2,1,0,1,0
1,4,0,0,8,2,6,0,4,0,1,0,6,1,5,0,4,0,1,0,5,1,4,0
0,4,3,4,12,1,11,9,4,3,0,4,11,1,10,8,4,3,0,4,10,1,9,8
1,3,2,1,4,1,3,0,3,2,1,1,3,0,3,0,3,2,1,1,3,0,3,0
3,3,3,1,6,4,2,0,3,3,3,1,2,1,1,0,3,3,3,1,1,0,1,0
3,2,2,4,13,9,4,3,2,2,3,4,4,2,2,1,2,2,3,4,2,1,1,0
2,3,4,1,24,12,12,3,3,4,2,1,12,5,7,2,3,4,2,1,7,3,4,1
3,4,2,4,2,1,1,0,4,2,3,4,1,0,1,0,4,2,3,4,1,0,1,0
4,1,0,2,3,2,1,0,1,0,4,2,1,0,1,0,1,0,4,2,1,0,1,0
0,1,4,0,28,2,26,2,1,4,0,0,26,2,24,2,1,4,0,0,24,2,22,2
3,0,2,0,20,14,6,0,0,2,3,0,6,4,2,0,0,2,3,0,2,1,1,0
0,1,1,2,14,1,13,6,1,1,0,2,13,1,12,6,1,1,0,2,12,1,11,5
0,2,3,2,17,1,16,7,2,3,0,2,16,1,15,7,2,3,0,2,15,1,14,7
1,3,4,0,16,4,12,1,3,4,1,0,12,3,9,0,3,4,1,0,9,2,7,0
1,2,3,4,21,6,15,13,2,3,1,4,15,4,11,9,2,3,1,4,11,3,8,7
2,4,0,2,2,1,1,0,4,0,2,2,1,0,1,0,4,0,2,2,1,0,1,0
1,0,3,1,26,7,19,5,0,3,1,1,19,5,14,4,0,3,1,1,14,4,10,2
1,4,0,1,3,0,3,0,4,0,1,1,3,0,3,0,4,0,1,1,3,0,3,0
3,2,4,1,25,17,8,2,2,4,3,1,8,5,3,0,2,4,3,1,3,2,1,0
3,1,2,1,20,13,7,2,1,2,3,1,7,4,3,0,1,2,3,1,3,2,1,0
1,2,4,1,25,7,18,5,2,4,1,1,18,5,13,3,2,4,1,1,13,3,10,3
0,4,4,0,0,0,0,0,4,4,0,0,0,0,0,0,4,4,0,0,0,0,0,0
3,1,1,3,1,0,1,0,1,1,3,3,1,0,1,0,1,1,3,3,1,0,1,0
0,0,0,1,1,0,1,0,0,0,0,1,1,0,1,0,0,0,0,1,1,0,1,0
1,2,4,1,17,5,12,3,2,4,1,1,12,3,9,2,2,4,1,1,9,2,7,2
2,4,2,4,2,0,2,1,4,2,2,4,2,0,2,1,4,2,2,4,2,1,1,0
1,2,2,0,15,4,11,1,2,2,1,0,11,3,8,0,2,2,1,0,8,2,6,0
4,2,0,2,0,0,0,0,2,0,4,2,0,0,0,0,2,0,4,2,0,0,0,0
2,0,4,2,27,13,14,6,0,4,2,2,14,7,7,3,0,4,2,2,7,3,4,2
4,0,1,3,18,16,2,1,0,1,4,3,2,1,1,0,0,1,4,3,1,0,1,0
2,4,1,3,5,2,3,2,4,1,2,3,3,1,2,1,4,1,2,3,2,1,1,0
3,3,0,4,10,7,3,2,3,0,3,4,3,2,1,0,3,0,3,4,1,0,1,0
2,1,4,3,24,12,12,8,1,4,2,3,12,5,7,4,1,4,2,3,7,3,4,2
3,1,0,3,3,2,1,0,1,0,3,3,1,0,1,0,1,0,3,3,1,0,1,0
2,4,1,1,5,2,3,0,4,1,2,1,3,1,2,0,4,1,2,1,2,0,2,0
0,0,3,1,24,2,22,6,0,3,0,1,22,2,20,5,0,3,0,1,20,2,18,5
1,4,4,0,0,0,0,0,4,4,1,0,0,0,0,0,4,4,1,0,0,0,0,0
4,1,0,4,3,2,1,0,1,0,4,4,1,0,1,0,1,0,4,4,1,0,1,0
3,3,0,1,1,0,1,0,3,0,3,1,1,0,1,0,3,0,3,1,1,0,1,0
3,4,0,2,1,0,1,0,4,0,3,2,1,0,1,0,4,0,3,2,1,0,1,0
4,2,4,3,20,18,2,1,2,4,4,3,2,1,1,0,2,4,4,3,1,0,1,0
1,2,2,2,16,4,12,6,2,2,1,2,12,3,9,4,2,2,1,2,9,2,7,3
1,0,2,2,23,6,17,8,0,2,1,2,17,5,12,6,0,2,1,2,12,3,9,4
3,4,0,4,1,0,1,0,4,0,3,4,1,0,1,0,4,0,3,4,1,0,1,0
4,2,3,1,14,12,2,0,2,3,4,1,2,1,1,0,2,3,4,1,1,0,1,0
1,1,2,4,15,4,11,9,1,2,1,4,11,3,8,7,1,2,1,4,8,2,6,5
1,1,1,1,24,7,17,5,1,1,1,1,17,5,12,3,1,1,1,1,12,3,9,2
2,4,2,2,0,0,0,0,4,2,2,2,0,0,0,0,4,2,2,2,0,0,0,0
0,3,1,0,1,0,1,0,3,1,0,0,1,0,1,0,3,1,0,0,1,0,1,0
3,0,1,2,16,11,5,2,0,1,3,2,5,3,2,0,0,1,3,2,2,1,1,0
0,0,4,3,28,2,26,18,0,4,0,3,26,2,24,16,0,4,0,3,24,2,22,15
4,1,3,1,18,16,2,0,1,3,4,1,2,1,1,0,1,3,4,1,1,0,1,0
0,0,1,0,16,1,15,1,0,1,0,0,15,1,14,1,0,1,0,0,14,1,13,1
2,1,1,1,10,4,6,1,1,1,2,1,6,3,3,0,1,1,2,1,3,1,2,0
1,3,1,0,5,1,4,0,3,1,1,0,4,1,3,0,3,1,1,0,3,0,3,0
2,4,4,2,9,4,5,2,4,4,2,2,5,2,3,1,4,4,2,2,3,1,2,1
4,0,1,2,17,15,2,1,0,1,4,2,2,1,1,0,0,1,4,2,1,0,1,0
4,1,0,4,8,7,1,0,1,0,4,4,1,0,1,0,1,0,4,4,1,0,1,0
4,1,1,3,15,13,2,1,1,1,4,3,2,1,1,0,1,1,4,3,1,0,1,0
1,1,1,0,8,2,6,0,1,1,1,0,6,1,5,0,1,1,1,0,5,1,4,0
1,4,4,1,11,3,8,2,4,4,1,1,8,2,6,1,4,4,1,1,6,1,5,1
1,1,0,3,2,0,2,1,1,0,1,3,2,0,2,1,1,0,1,3,2,0,2,1
3,1,4,0,29,20,9,0,1,4,3,0,9,6,3,0,1,4,3,0,3,2,1,0
4,1,1,4,7,6,1,0,1,1,4,4,1,0,1,0,1,1,4,4,1,0,1,0
1,4,3,1,4,1,3,0,4,3,1,1,3,0,3,0,4,3,1,1,3,0,3,0
3,2,4,2,20,14,6,2,2,4,3,2,6,4,2,1,2,4,3,2,2,1,1,0
0,1,2,0,25,2,23,2,1,2,0,0,23,2,21,2,1,2,0,0,21,2,19,1
3,1,4,1,22,15,7,2,1,4,3,1,7,4,3,0,1,4,3,1,3,2,1,0
0,0,1,4,12,1,11,9,0,1,0,4,11,1,10,8,0,1,0,4,10,1,9,8
0,3,2,3,12,1,11,7,3,2,0,3,11,1,10,7,3,2,0,3,10,1,9,6
1,3,1,2,3,0,3,1,3,1,1,2,3,0,3,1,3,1,1,2,3,0,3,1
3,0,1,0,20,14,6,0,0,1,3,0,6,4,2,0,0,1,3,0,2,1,1,0
2,1,3,1,21,10,11,3,1,3,2,1,11,5,6,1,1,3,2,1,6,2,4,1
3,4,2,3,5,3,2,1,4,2,3,3,2,1,1,0,4,2,3,3,1,0,1,0
3,2,4,2,28,19,9,4,2,4,3,2,9,6,3,1,2,4,3,2,3,2,1,0
0,3,4,1,19,1,18,5,3,4,0,1,18,1,17,5,3,4,0,1,17,1,16,4
3,4,0,3,2,1,1,0,4,0,3,3,1,0,1,0,4,0,3,3,1,0,1,0
0,2,1,0,7,0,7,0,2,1,0,0,7,0,7,0,2,1,0,0,7,0,7,0
1,4,0,3,7,2,5,3,4,0,1,3,5,1,4,2,4,0,1,3,4,1,3,2
0,0,1,4,18,1,17,15,0,1,0,4,17,1,16,14,0,1,0,4,16,1,15,13
3,3,0,2,15,10,5,2,3,0,3,2,5,3,2,1,3,0,3,2,2,1,1,0
4,0,4,0,29,26,3,0,0,4,4,0,3,2,1,0,0,4,4,0,1,0,1,0
4,0,4,4,28,25,3,2,0,4,4,4,3,2,1,0,0,4,4,4,1,0,1,0
0,1,0,2,6,0,6,3,1,0,0,2,6,0,6,2,1,0,0,2,6,0,6,2
2,4,2,0,2,1,1,0,4,2,2,0,1,0,1,0,4,2,2,0,1,0,1,0
4,2,4,3,27,24,3,2,2,4,4,3,3,2,1,0,2,4,4,3,1,0,1,0
3,1,0,1,7,4,3,0,1,0,3,1,3,2,1,0,1,0,3,1,1,0,1,0
2,1,1,2,0,0,0,0,1,1,2,2,0,0,0,0,1,1,2,2,0,0,0,0
2,1,0,1,17,8,9,2,1,0,2,1,9,4,5,1,1,0,2,1,5,2,3,0
3,2,4,0,20,14,6,0,2,4,3,0,6,4,2,0,2,4,3,0,2,1,1,0
4,2,4,0,24,21,3,0,2,4,4,0,3,2,1,0,2,4,4,0,1,0,1,0
1,2,0,1,5,1,4,1,2,0,1,1,4,1,3,0,2,0,1,1,3,0,3,0
2,4,4,1,0,0,0,0,4,4,2,1,0,0,0,0,4,4,2,1,0,0,0,0
0,3,2,4,12,1,11,9,3,2,0,4,11,1,10,9,3,2,0,4,10,0,10,8
3,4,2,4,4,2,2,1,4,2,3,4,2,1,1,0,4,2,3,4,1,0,1,0
4,3,1,0,5,4,1,0,3,1,4,0,1,0,1,0,3,1,4,0,1,0,1,0
1,4,0,3,3,0,3,2,4,0,1,3,3,0,3,2,4,0,1,3,3,0,3,2
4,0,3,2,29,26,3,1,0,3,4,2,3,2,1,0,0,3,4,2,1,0,1,0
3,2,2,2,13,9,4,2,2,2,3,2,4,2,2,1,2,2,3,2,2,1,1,0
1,1,3,2,26,7,19,9,1,3,1,2,19,5,14,7,1,3,1,2,14,4,10,5
4,0,0,0,8,7,1,0,0,0,4,0,1,0,1,0,0,0,4,0,1,0,1,0
3,3,1,0,3,2,1,0,3,1,3,0,1,0,1,0,3,1,3,0,1,0,1,0
4,1,3,0,25,22,3,0,1,3,4,0,3,2,1,0,1,3,4,0,1,0,1,0
0,1,4,4,28,2,26,23,1,4,0,4,26,2,24,21,1,4,0,4,24,2,22,19
2,2,2,1,22,10,12,3,2,2,2,1,12,6,6,1,2,2,2,1,6,2,4,1
0,3,3,4,15,1,14,12,3,3,0,4,14,1,13,11,3,3,0,4,13,1,12,10
3,2,3,0,10,6,4,0,2,3,3,0,4,2,2,0,2,3,3,0,2,1,1,0
4,4,2,3,13,11,2,1,4,2,4,3,2,1,1,0,4,2,4,3,1,0,1,0
0,2,3,3,11,1,10,6,2,3,0,3,10,1,9,6,2,3,0,3,9,0,9,6
3,2,3,3,15,10,5,3,2,3,3,3,5,3,2,1,2,3,3,3,2,1,1,0
1,2,3,1,17,5,12,3,2,3,1,1,12,3,9,2,2,3,1,1,9,2,7,2
3,1,3,0,25,17,8,0,1,3,3,0,8,5,3,0,1,3,3,0,3,2,1,0
3,3,1,1,7,4,3,0,3,1,3,1,3,2,1,0,3,1,3,1,1,0,1,0
2,4,3,3,2,1,1,0,4,3,2,3,1,0,1,0,4,3,2,3,1,0,1,0
3,4,4,0,10,7,3,0,4,4,3,0,3,2,1,0,4,4,3,0,1,0,1,0
4,1,0,1,4,3,1,0,1,0,4,1,1,0,1,0,1,0,4,1,1,0,1,0
3,3,3,3,18,12,6,4,3,3,3,3,6,4,2,1,3,3,3,3,2,1,1,0
3,3,3,2,9,6,3,1,3,3,3,2,3,2,1,0,3,3,3,2,1,0,1,0
1,1,4,3,25,7,18,12,1,4,1,3,18,5,13,9,1,4,1,3,13,3,10,6
3,2,0,2,8,5,3,1,2,0,3,2,3,2,1,0,2,0,3,2,1,0,1,0
2,1,2,0,10,5,5,0,1,2,2,0,5,2,3,0,1,2,2,0,3,1,2,0
3,1,4,0,28,19,9,0,1,4,3,0,9,6,3,0,1,4,3,0,3,2,1,0
1,4,4,4,0,0,0,0,4,4,1,4,0,0,0,0,4,4,1,4,0,0,0,0
2,1,4,0,28,14,14,1,1,4,2,0,14,7,7,0,1,4,2,0,7,3,4,0
2,4,4,0,2,0,2,0,4,4,2,0,2,1,1,0,4,4,2,0,1,0,1,0
3,0,4,3,27,18,9,6,0,4,3,3,9,6,3,2,0,4,3,3,3,2,1,0
4,1,1,0,19,17,2,0,1,1,4,0,2,1,1,0,1,1,4,0,1,0,1,0
2,2,2,3,13,6,7,4,2,2,2,3,7,3,4,2,2,2,2,3,4,2,2,1
0,2,4,2,18,1,17,8,2,4,0,2,17,1,16,8,2,4,0,2,16,1,15,7
4,0,3,2,27,24,3,1,0,3,4,2,3,2,1,0,0,3,4,2,1,0,1,0
4,1,4,3,26,23,3,2,1,4,4,3,3,2,1,0,1,4,4,3,1,0,1,0
4,3,0,4,10,8,2,1,3,0,4,4,2,1,1,0,3,0,4,4,1,0,1,0
0,4,3,1,6,0,6,1,4,3,0,1,6,0,6,1,4,3,0,1,6,0,6,1
4,3,4,2,14,12,2,0,3,4,4,2,2,1,1,0,3,4,4,2,1,0,1,0
1,2,3,2,18,5,13,6,2,3,1,2,13,3,10,5,2,3,1,2,10,2,8,4
1,1,4,4,27,8,19,17,1,4,1,4,19,5,14,12,1,4,1,4,14,4,10,8
2,2,3,1,16,7,9,2,2,3,2,1,9,4,5,1,2,3,2,1,5,2,3,0
4,3,2,4,14,12,2,1,3,2,4,4,2,1,1,0,3,2,4,4,1,0,1,0
4,4,2,4,4,3,1,0,4,2,4,4,1,0,1,0,4,2,4,4,1,0,1,0
2,1,2,0,20,9,11,1,1,2,2,0,11,5,6,0,1,2,2,0,6,3,3,0
3,1,0,4,8,5,3,2,1,0,3,4,3,2,1,0,1,0,3,4,1,0,1,0
2,0,2,1,25,12,13,3,0,2,2,1,13,6,7,2,0,2,2,1,7,3,4,1
4,0,0,2,11,9,2,1,0,0,4,2,2,1,1,0,0,0,4,2,1,0,1,0
1,4,1,0,5,1,4,0,4,1,1,0,4,1,3,0,4,1,1,0,3,0,3,0
2,4,0,4,1,0,1,0,4,0,2,4,1,0,1,0,4,0,2,4,1,0,1,0
1,1,1,3,8,2,6,4,1,1,1,3,6,1,5,3,1,1,1,3,5,1,4,2
3,0,4,3,27,18,9,6,0,4,3,3,9,6,3,2,0,4,3,3,3,2,1,0
0,0,2,0,23,2,21,2,0,2,0,0,21,2,19,1,0,2,0,0,19,1,18,1
3,2,3,0,20,14,6,0,2,3,3,0,6,4,2,0,2,3,3,0,2,1,1,0
3,1,1,0,10,7,3,0,1,1,3,0,3,2,1,0,1,1,3,0,1,0,1,0
4,4,1,0,6,5,1,0,4,1,4,0,1,0,1,0,4,1,4,0,1,0,1,0
2,0,2,4,27,13,14,12,0,2,2,4,14,6,8,7,0,2,2,4,8,3,5,4
3,1,1,4,8,5,3,2,1,1,3,4,3,2,1,0,1,1,3,4,1,0,1,0
3,1,4,3,29,20,9,6,1,4,3,3,9,6,3,2,1,4,3,3,3,2,1,0
2,2,4,4,15,7,8,7,2,4,2,4,8,3,5,4,2,4,2,4,5,2,3,2
1,1,4,0,28,8,20,1,1,4,1,0,20,5,15,1,1,4,1,0,15,4,11,1
2,1,0,3,6,2,4,2,1,0,2,3,4,1,3,2,1,0,2,3,3,1,2,1
2,0,3,1,23,11,12,3,0,3,2,1,12,5,7,2,0,3,2,1,7,3,4,1
3,1,4,2,26,18,8,4,1,4,3,2,8,5,3,1,1,4,3,2,3,2,1,0
0,3,0,3,8,0,8,5,3,0,0,3,8,0,8,5,3,0,0,3,8,0,8,5
2,1,3,1,22,11,11,3,1,3,2,1,11,5,6,1,1,3,2,1,6,2,4,1
4,2,4,1,19,17,2,0,2,4,4,1,2,1,1,0,2,4,4,1,1,0,1,0
2,1,0,1,6,3,3,0,1,0,2,1,3,1,2,0,1,0,2,1,2,1,1,0
3,4,2,4,6,4,2,1,4,2,3,4,2,1,1,0,4,2,3,4,1,0,1,0
1,3,1,0,1,0,1,0,3,1,1,0,1,0,1,0,3,1,1,0,1,0,1,0
2,0,1,3,11,5,6,4,0,1,2,3,6,2,4,2,0,1,2,3,4,2,2,1
0,4,1,0,5,0,5,0,4,1,0,0,5,0,5,0,4,1,0,0,5,0,5,0
0,2,3,4,8,0,8,7,2,3,0,4,8,0,8,7,2,3,0,4,8,0,8,7
4,2,4,0,26,23,3,0,2,4,4,0,3,2,1,0,2,4,4,0,1,0,1,0
3,3,0,2,5,3,2,0,3,0,3,2,2,1,1,0,3,0,3,2,1,0,1,0
1,1,3,0,29,8,21,2,1,3,1,0,21,6,15,1,1,3,1,0,15,4,11,1
3,3,3,2,17,11,6,2,3,3,3,2,6,4,2,1,3,3,3,2,2,1,1,0
2,2,3,0,24,11,13,1,2,3,2,0,13,6,7,0,2,3,2,0,7,3,4,0
3,1,3,2,23,16,7,3,1,3,3,2,7,4,3,1,1,3,3,2,3,2,1,0
1,1,4,1,22,6,16,4,1,4,1,1,16,4,12,3,1,4,1,1,12,3,9,2
1,3,4,3,18,5,13,9,3,4,1,3,13,3,10,7,3,4,1,3,10,2,8,5
4,2,0,4,9,8,1,0,2,0,4,4,1,0,1,0,2,0,4,4,1,0,1,0
3,2,1,1,6,4,2,0,2,1,3,1,2,1,1,0,2,1,3,1,1,0,1,0
4,0,0,4,8,7,1,0,0,0,4,4,1,0,1,0,0,0,4,4,1,0,1,0
0,0,0,1,13,1,12,3,0,0,0,1,12,1,11,3,0,0,0,1,11,1,10,2
2,2,0,3,5,2,3,2,2,0,2,3,3,1,2,1,2,0,2,3,2,0,2,1
2,0,2,2,22,10,12,5,0,2,2,2,12,5,7,3,0,2,2,2,7,3,4,1
1,3,1,3,4,1,3,2,3,1,1,3,3,0,3,2,3,1,1,3,3,0,3,2
2,3,4,3,11,5,6,4,3,4,2,3,6,2,4,2,3,4,2,3,4,2,2,1
1,1,3,1,24,7,17,5,1,3,1,1,17,5,12,3,1,3,1,1,12,3,9,2
3,1,2,4,22,15,7,6,1,2,3,4,7,4,3,2,1,2,3,4,3,2,1,0
1,0,2,0,23,6,17,1,0,2,1,0,17,5,12,1,0,2,1,0,12,3,9,0
2,2,0,0,6,2,4,0,2,0,2,0,4,2,2,0,2,0,2,0,2,1,1,0
0,2,4,1,13,1,12,3,2,4,0,1,12,1,11,3,2,4,0,1,11,1,10,3
4,1,2,0,21,18,3,0,1,2,4,0,3,2,1,0,1,2,4,0,1,0,1,0
3,1,1,4,5,3,2,1,1,1,3,4,2,1,1,0,1,1,3,4,1,0,1,0
3,4,0,4,7,4,3,2,4,0,3,4,3,2,1,0,4,0,3,4,1,0,1,0
1,1,2,3,25,7,18,12,1,2,1,3,18,5,13,9,1,2,1,3,13,3,10,7
2,1,0,0,14,6,8,0,1,0,2,0,8,3,5,0,1,0,2,0,5,2,3,0
4,2,4,4,17,15,2,1,2,4,4,4,2,1,1,0,2,4,4,4,1,0,1,0
2,1,0,2,1,0,1,0,1,0,2,2,1,0,1,0,1,0,2,2,1,0,1,0
3,4,4,4,11,7,4,3,4,4,3,4,4,2,2,1,4,4,3,4,2,1,1,0
0,3,4,1,18,1,17,5,3,4,0,1,17,1,16,4,3,4,0,1,16,1,15,4
1,0,2,3,19,5,14,9,0,2,1,3,14,4,10,7,0,2,1,3,10,3,7,4
3,3,3,2,12,8,4,2,3,3,3,2,4,2,2,0,3,3,3,2,2,1,1,0
1,1,2,3,19,5,14,9,1,2,1,3,14,4,10,6,1,2,1,3,10,2,8,5
2,2,4,1,23,11,12,3,2,4,2,1,12,5,7,2,2,4,2,1,7,3,4,1
0,1,0,0,8,0,8,0,1,0,0,0,8,0,8,0,1,0,0,0,8,0,8,0
0,2,4,0,23,2,21,2,2,4,0,0,21,2,19,1,2,4,0,0,19,1,18,1
2,4,3,4,6,3,3,2,4,3,2,4,3,1,2,1,4,3,2,4,2,1,1,0
2,4,4,2,9,4,5,2,4,4,2,2,5,2,3,1,4,4,2,2,3,1,2,1
4,2,4,4,23,20,3,2,2,4,4,4,3,2,1,0,2,4,4,4,1,0,1,0
3,0,1,1,14,9,5,1,0,1,3,1,5,3,2,0,0,1,3,1,2,1,1,0
4,1,2,2,21,18,3,1,1,2,4,2,3,2,1,0,1,2,4,2,1,0,1,0
3,3,0,4,2,1,1,0,3,0,3,4,1,0,1,0,3,0,3,4,1,0,1,0
1,2,3,2,25,7,18,9,2,3,1,2,18,5,13,6,2,3,1,2,13,3,10,4
2,4,1,1,6,2,4,1,4,1,2,1,4,2,2,0,4,1,2,1,2,1,1,0
4,0,1,3,16,14,2,1,0,1,4,3,2,1,1,0,0,1,4,3,1,0,1,0
4,4,1,0,9,8,1,0,4,1,4,0,1,0,1,0,4,1,4,0,1,0,1,0
0,4,0,4,12,1,11,9,4,0,0,4,11,1,10,9,4,0,0,4,10,1,9,8
3,4,4,3,2,1,1,0,4,4,3,3,1,0,1,0,4,4,3,3,1,0,1,0
0,4,1,0,3,0,3,0,4,1,0,0,3,0,3,0,4,1,0,0,3,0,3,0
4,2,2,3,12,10,2,1,2,2,4,3,2,1,1,0,2,2,4,3,1,0,1,0
4,4,0,3,2,1,1,0,4,0,4,3,1,0,1,0,4,0,4,3,1,0,1,0
4,3,1,3,2,1,1,0,3,1,4,3,1,0,1,0,3,1,4,3,1,0,1,0
2,4,0,1,1,0,1,0,4,0,2,1,1,0,1,0,4,0,2,1,1,0,1,0
3,0,4,2,28,19,9,4,0,4,3,2,9,6,3,1,0,4,3,2,3,2,1,0
1,1,2,2,14,4,10,4,1,2,1,2,10,2,8,4,1,2,1,2,8,2,6,2
4,3,3,4,17,15,2,1,3,3,4,4,2,1,1,0,3,3,4,4,1,0,1,0
3,4,1,3,3,2,1,0,4,1,3,3,1,0,1,0,4,1,3,3,1,0,1,0
4,0,3,0,25,22,3,0,0,3,4,0,3,2,1,0,0,3,4,0,1,0,1,0
4,1,4,2,24,21,3,1,1,4,4,2,3,2,1,0,1,4,4,2,1,0,1,0
2,2,2,1,14,7,7,2,2,2,2,1,7,3,4,1,2,2,2,1,4,1,3,0
1,0,1,4,20,6,14,12,0,1,1,4,14,4,10,9,0,1,1,4,10,3,7,6
3,2,1,3,7,4,3,2,2,1,3,3,3,2,1,0,2,1,3,3,1,0,1,0
1,2,4,2,15,4,11,5,2,4,1,2,11,3,8,3,2,4,1,2,8,2,6,3
1,1,0,2,4,1,3,1,1,0,1,2,3,0,3,1,1,0,1,2,3,0,3,1
3,1,1,4,8,5,3,2,1,1,3,4,3,2,1,0,1,1,3,4,1,0,1,0
4,1,4,2,25,22,3,1,1,4,4,2,3,2,1,0,1,4,4,2,1,0,1,0
2,0,4,1,28,13,15,4,0,4,2,1,15,7,8,2,0,4,2,1,8,4,4,1
2,3,2,2,12,6,6,2,3,2,2,2,6,2,4,2,3,2,2,2,4,2,2,0
4,0,1,1,15,13,2,0,0,1,4,1,2,1,1,0,0,1,4,1,1,0,1,0
3,0,3,3,27,18,9,6,0,3,3,3,9,6,3,2,0,3,3,3,3,2,1,0
0,0,4,1,26,2,24,7,0,4,0,1,24,2,22,6,0,4,0,1,22,2,20,6
0,4,4,4,19,1,18,16,4,4,0,4,18,1,17,15,4,4,0,4,17,1,16,14
2,0,1,1,12,6,6,1,0,1,2,1,6,2,4,1,0,1,2,1,4,2,2,0
4,4,3,1,5,4,1,0,4,3,4,1,1,0,1,0,4,3,4,1,1,0,1,0
1,1,4,4,25,7,18,16,1,4,1,4,18,5,13,11,1,4,1,4,13,3,10,8
2,3,0,4,3,1,2,1,3,0,2,4,2,1,1,0,3,0,2,4,1,0,1,0
4,3,3,0,11,9,2,0,3,3,4,0,2,1,1,0,3,3,4,0,1,0,1,0
4,1,1,3,14,12,2,1,1,1,4,3,2,1,1,0,1,1,4,3,1,0,1,0
1,4,1,2,12,3,9,4,4,1,1,2,9,2,7,3,4,1,1,2,7,2,5,2
4,0,1,4,8,7,1,0,0,1,4,4,1,0,1,0,0,1,4,4,1,0,1,0
4,4,2,4,1,0,1,0,4,2,4,4,1,0,1,0,4,2,4,4,1,0,1,0
4,2,0,3,5,4,1,0,2,0,4,3,1,0,1,0,2,0,4,3,1,0,1,0
3,0,0,1,4,2,2,0,0,0,3,1,2,1,1,0,0,0,3,1,1,0,1,0
3,0,2,1,18,12,6,1,0,2,3,1,6,4,2,0,0,2,3,1,2,1,1,0
3,0,3,2,19,13,6,2,0,3,3,2,6,4,2,1,0,3,3,2,2,1,1,0
3,4,3,3,0,0,0,0,4,3,3,3,0,0,0,0,4,3,3,3,0,0,0,0
3,1,0,1,13,9,4,1,1,0,3,1,4,2,2,0,1,0,3,1,2,1,1,0
1,2,2,2,18,5,13,6,2,2,1,2,13,3,10,5,2,2,1,2,10,3,7,3
3,1,3,0,23,16,7,0,1,3,3,0,7,4,3,0,1,3,3,0,3,2,1,0
4,3,3,0,20,17,3,0,3,3,4,0,3,2,1,0,3,3,4,0,1,0,1,0
3,1,3,4,19,13,6,5,1,3,3,4,6,4,2,1,1,3,3,4,2,1,1,0
2,0,3,3,22,10,12,8,0,3,2,3,12,6,6,4,0,3,2,3,6,2,4,2
0,3,0,4,0,0,0,0,3,0,0,4,0,0,0,0,3,0,0,4,0,0,0,0
3,4,3,2,9,6,3,1,4,3,3,2,3,2,1,0,4,3,3,2,1,0,1,0
2,3,2,1,5,2,3,0,3,2,2,1,3,1,2,0,3,2,2,1,2,1,1,0
0,0,0,4,2,0,2,1,0,0,0,4,2,0,2,1,0,0,0,4,2,0,2,1
3,3,3,3,14,9,5,3,3,3,3,3,5,3,2,1,3,3,3,3,2,1,1,0
2,1,3,2,28,14,14,6,1,3,2,2,14,7,7,3,1,3,2,2,7,3,4,2
3,3,1,4,4,2,2,1,3,1,3,4,2,1,1,0,3,1,3,4,1,0,1,0
1,2,1,4,4,1,3,2,2,1,1,4,3,0,3,2,2,1,1,4,3,0,3,2
2,2,3,1,19,9,10,3,2,3,2,1,10,5,5,1,2,3,2,1,5,2,3,0
4,2,0,2,9,8,1,0,2,0,4,2,1,0,1,0,2,0,4,2,1,0,1,0
2,4,2,0,13,6,7,0,4,2,2,0,7,3,4,0,4,2,2,0,4,1,3,0
2,4,0,1,2,1,1,0,4,0,2,1,1,0,1,0,4,0,2,1,1,0,1,0
2,2,2,1,14,6,8,2,2,2,2,1,8,3,5,1,2,2,2,1,5,2,3,0
2,1,2,4,12,5,7,6,1,2,2,4,7,3,4,3,1,2,2,4,4,2,2,1
2,3,3,0,9,4,5,0,3,3,2,0,5,2,3,0,3,3,2,0,3,1,2,0
2,1,3,3,24,12,12,8,1,3,2,3,12,6,6,4,1,3,2,3,6,3,3,2
3,0,2,2,19,13,6,3,0,2,3,2,6,4,2,1,0,2,3,2,2,1,1,0
0,1,1,1,15,1,14,4,1,1,0,1,14,1,13,3,1,1,0,1,13,1,12,3
3,4,4,3,2,1,1,0,4,4,3,3,1,0,1,0,4,4,3,3,1,0,1,0
0,1,0,3,6,0,6,4,1,0,0,3,6,0,6,4,1,0,0,3,6,0,6,4
2,4,2,2,0,0,0,0,4,2,2,2,0,0,0,0,4,2,2,2,0,0,0,0
1,3,1,4,3,0,3,2,3,1,1,4,3,0,3,2,3,1,1,4,3,0,3,2
1,4,2,0,8,2,6,0,4,2,1,0,6,1,5,0,4,2,1,0,5,1,4,0
1,2,0,2,2,0,2,1,2,0,1,2,2,0,2,1,2,0,1,2,2,0,2,1
3,4,2,4,4,2,2,1,4,2,3,4,2,1,1,0,4,2,3,4,1,0,1,0
0,2,1,2,10,1,9,4,2,1,0,2,9,0,9,4,2,1,0,2,9,0,9,4
4,2,1,4,9,8,1,0,2,1,4,4,1,0,1,0,2,1,4,4,1,0,1,0
0,0,3,0,28,2,26,2,0,3,0,0,26,2,24,2,0,3,0,0,24,2,22,2
1,4,3,3,12,3,9,6,4,3,1,3,9,2,7,4,4,3,1,3,7,2,5,3
0,3,3,3,17,1,16,11,3,3,0,3,16,1,15,10,3,3,0,3,15,1,14,9
0,3,1,1,7,0,7,2,3,1,0,1,7,0,7,2,3,1,0,1,7,0,7,2
1,4,2,0,1,0,1,0,4,2,1,0,1,0,1,0,4,2,1,0,1,0,1,0
0,0,4,4,24,2,22,19,0,4,0,4,22,2,20,18,0,4,0,4,20,2,18,16
2,0,0,3,8,3,5,3,0,0,2,3,5,2,3,2,0,0,2,3,3,1,2,1
1,1,4,0,25,7,18,1,1,4,1,0,18,5,13,1,1,4,1,0,13,3,10,0
3,3,0,0,4,2,2,0,3,0,3,0,2,1,1,0,3,0,3,0,1,0,1,0
2,2,2,0,7,3,4,0,2,2,2,0,4,2,2,0,2,2,2,0,2,0,2,0
4,0,2,1,16,14,2,0,0,2,4,1,2,1,1,0,0,2,4,1,1,0,1,0
4,3,2,2,16,14,2,0,3,2,4,2,2,1,1,0,3,2,4,2,1,0,1,0
2,3,4,1,21,10,11,3,3,4,2,1,11,5,6,1,3,4,2,1,6,3,3,0
1,1,0,0,11,3,8,0,1,0,1,0,8,2,6,0,1,0,1,0,6,1,5,0
3,3,2,3,10,6,4,2,3,2,3,3,4,2,2,1,3,2,3,3,2,1,1,0
2,2,3,4,16,7,9,8,2,3,2,4,9,4,5,4,2,3,2,4,5,2,3,2
1,2,1,3,4,1,3,2,2,1,1,3,3,0,3,2,2,1,1,3,3,0,3,2
0,3,0,0,5,0,5,0,3,0,0,0,5,0,5,0,3,0,0,0,5,0,5,0
0,0,1,2,13,1,12,6,0,1,0,2,12,1,11,5,0,1,0,2,11,1,10,5
1,1,0,3,0,0,0,0,1,0,1,3,0,0,0,0,1,0,1,3,0,0,0,0
3,3,0,0,0,0,0,0,3,0,3,0,0,0,0,0,3,0,3,0,0,0,0,0
3,2,0,1,0,0,0,0,2,0,3,1,0,0,0,0,2,0,3,1,0,0,0,0
2,0,0,3,10,5,5,3,0,0,2,3,5,2,3,2,0,0,2,3,3,1,2,1
3,0,0,0,11,7,4,0,0,0,3,0,4,2,2,0,0,0,3,0,2,1,1,0
1,4,1,1,4,1,3,0,4,1,1,1,3,0,3,0,4,1,1,1,3,0,3,0
1,3,1,2,1,0,1,0,3,1,1,2,1,0,1,0,3,1,1,2,1,0,1,0
2,4,1,1,2,0,2,0,4,1,2,1,2,0,2,0,4,1,2,1,2,1,1,0
0,2,0,3,5,0,5,3,2,0,0,3,5,0,5,3,2,0,0,3,5,0,5,3
2,2,2,1,13,6,7,2,2,2,2,1,7,3,4,1,2,2,2,1,4,2,2,0
1,1,4,3,26,7,19,13,1,4,1,3,19,5,14,9,1,4,1,3,14,4,10,7
4,0,3,0,17,15,2,0,0,3,4,0,2,1,1,0,0,3,4,0,1,0,1,0
3,2,1,3,8,5,3,2,2,1,3,3,3,2,1,0,2,1,3,3,1,0,1,0
0,4,4,4,12,1,11,9,4,4,0,4,11,1,10,9,4,4,0,4,10,1,9,8
3,2,0,2,1,0,1,0,2,0,3,2,1,0,1,0,2,0,3,2,1,0,1,0
3,0,1,2,25,17,8,3,0,1,3,2,8,5,3,1,0,1,3,2,3,2,1,0
0,2,3,1,14,1,13,3,2,3,0,1,13,1,12,3,2,3,0,1,12,1,11,3
1,0,4,0,25,7,18,1,0,4,1,0,18,5,13,1,0,4,1,0,13,3,10,1
0,0,3,2,23,2,21,10,0,3,0,2,21,2,19,9,0,3,0,2,19,1,18,8
3,3,3,0,11,7,4,0,3,3,3,0,4,2,2,0,3,3,3,0,2,1,1,0
0,0,2,4,16,1,15,13,0,2,0,4,15,1,14,12,0,2,0,4,14,1,13,11
0,0,4,0,29,2,27,2,0,4,0,0,27,2,25,2,0,4,0,0,25,2,23,2
3,4,0,0,2,1,1,0,4,0,3,0,1,0,1,0,4,0,3,0,1,0,1,0
1,1,4,0,24,7,17,1,1,4,1,0,17,5,12,1,1,4,1,0,12,3,9,0
4,4,2,4,5,4,1,0,4,2,4,4,1,0,1,0,4,2,4,4,1,0,1,0
4,3,3,1,10,8,2,0,3,3,4,1,2,1,1,0,3,3,4,1,1,0,1,0
0,1,1,0,11,1,10,1,1,1,0,0,10,0,10,1,1,1,0,0,10,0,10,1
0,4,4,4,6,0,6,5,4,4,0,4,6,0,6,5,4,4,0,4,6,0,6,5
4,0,2,3,22,19,3,2,0,2,4,3,3,2,1,0,0,2,4,3,1,0,1,0
2,1,4,0,29,14,15,1,1,4,2,0,15,7,8,0,1,4,2,0,8,4,4,0
4,0,0,4,2,1,1,0,0,0,4,4,1,0,1,0,0,0,4,4,1,0,1,0
0,0,0,3,6,0,6,4,0,0,0,3,6,0,6,4,0,0,0,3,6,0,6,4
1,3,1,3,9,2,7,4,3,1,1,3,7,2,5,3,3,1,1,3,5,1,4,2
1,1,3,1,26,7,19,5,1,3,1,1,19,5,14,4,1,3,1,1,14,4,10,3
2,4,4,3,5,2,3,2,4,4,2,3,3,1,2,1,4,4,2,3,2,0,2,1
3,4,3,4,6,4,2,1,4,3,3,4,2,1,1,0,4,3,3,4,1,0,1,0
3,1,2,3,17,11,6,4,1,2,3,3,6,4,2,1,1,2,3,3,2,1,1,0
3,0,4,1,27,18,9,2,0,4,3,1,9,6,3,0,0,4,3,1,3,2,1,0
2,4,1,4,4,1,3,2,4,1,2,4,3,1,2,1,4,1,2,4,2,1,1,0
3,0,1,1,12,8,4,1,0,1,3,1,4,2,2,0,0,1,3,1,2,1,1,0
3,2,0,4,5,3,2,1,2,0,3,4,2,1,1,0,2,0,3,4,1,0,1,0
0,4,3,3,12,1,11,7,4,3,0,3,11,1,10,7,4,3,0,3,10,1,9,6
4,2,2,3,12,10,2,1,2,2,4,3,2,1,1,0,2,2,4,3,1,0,1,0
1,4,0,4,0,0,0,0,4,0,1,4,0,0,0,0,4,0,1,4,0,0,0,0
3,1,0,2,10,6,4,2,1,0,3,2,4,2,2,1,1,0,3,2,2,1,1,0
1,2,1,4,3,0,3,2,2,1,1,4,3,0,3,2,2,1,1,4,3,0,3,2
0,4,3,0,10,1,9,0,4,3,0,0,9,0,9,0,4,3,0,0,9,0,9,0
3,4,3,3,6,4,2,1,4,3,3,3,2,1,1,0,4,3,3,3,1,0,1,0
2,3,3,4,15,7,8,7,3,3,2,4,8,4,4,3,3,3,2,4,4,1,3,2
1,4,4,4,14,4,10,8,4,4,1,4,10,3,7,6,4,4,1,4,7,2,5,4
0,0,4,3,29,2,27,18,0,4,0,3,27,2,25,17,0,4,0,3,25,2,23,16
3,1,0,0,13,9,4,0,1,0,3,0,4,2,2,0,1,0,3,0,2,1,1,0
4,0,3,3,29,26,3,2,0,3,4,3,3,2,1,0,0,3,4,3,1,0,1,0
0,4,0,0,0,0,0,0,4,0,0,0,0,0,0,0,4,0,0,0,0,0,0,0
3,0,4,1,23,16,7,2,0,4,3,1,7,4,3,0,0,4,3,1,3,2,1,0
2,4,2,3,0,0,0,0,4,2,2,3,0,0,0,0,4,2,2,3,0,0,0,0
3,0,1,0,15,10,5,0,0,1,3,0,5,3,2,0,0,1,3,0,2,1,1,0
1,2,4,0,19,5,14,1,2,4,1,0,14,4,10,1,2,4,1,0,10,3,7,0
3,3,0,1,2,1,1,0,3,0,3,1,1,0,1,0,3,0,3,1,1,0,1,0
0,2,2,0,7,0,7,0,2,2,0,0,7,0,7,0,2,2,0,0,7,0,7,0
3,3,2,0,11,7,4,0,3,2,3,0,4,2,2,0,3,2,3,0,2,1,1,0
3,0,0,4,8,5,3,2,0,0,3,4,3,2,1,0,0,0,3,4,1,0,1,0
4,4,3,1,8,7,1,0,4,3,4,1,1,0,1,0,4,3,4,1,1,0,1,0
1,1,3,3,28,8,20,14,1,3,1,3,20,6,14,9,1,3,1,3,14,4,10,6
4,0,4,4,29,26,3,2,0,4,4,4,3,2,1,0,0,4,4,4,1,0,1,0
4,3,3,4,17,15,2,1,3,3,4,4,2,1,1,0,3,3,4,4,1,0,1,0
3,1,1,3,15,10,5,3,1,1,3,3,5,3,2,1,1,1,3,3,2,1,1,0
3,1,1,2,4,2,2,0,1,1,3,2,2,1,1,0,1,1,3,2,1,0,1,0
2,2,4,2,16,7,9,4,2,4,2,2,9,4,5,2,2,4,2,2,5,2,3,1
3,1,3,4,21,14,7,6,1,3,3,4,7,4,3,2,1,3,3,4,3,2,1,0
4,0,1,3,7,6,1,0,0,1,4,3,1,0,1,0,0,1,4,3,1,0,1,0
4,2,0,4,3,2,1,0,2,0,4,4,1,0,1,0,2,0,4,4,1,0,1,0
3,4,2,0,3,2,1,0,4,2,3,0,1,0,1,0,4,2,3,0,1,0,1,0
1,0,1,0,16,4,12,1,0,1,1,0,12,3,9,0,0,1,1,0,9,2,7,0
1,2,4,2,20,6,14,7,2,4,1,2,14,4,10,5,2,4,1,2,10,3,7,3
1,4,2,0,13,3,10,0,4,2,1,0,10,3,7,0,4,2,1,0,7,2,5,0
1,3,2,1,9,2,7,2,3,2,1,1,7,2,5,1,3,2,1,1,5,1,4,1
3,2,1,2,7,4,3,1,2,1,3,2,3,2,1,0,2,1,3,2,1,0,1,0
4,1,3,0,23,20,3,0,1,3,4,0,3,2,1,0,1,3,4,0,1,0,1,0
0,0,2,3,22,2,20,14,0,2,0,3,20,1,19,13,0,2,0,3,19,1,18,12
1,1,3,1,28,8,20,5,1,3,1,1,20,5,15,4,1,3,1,1,15,4,11,3
1,4,1,1,3,0,3,0,4,1,1,1,3,0,3,0,4,1,1,1,3,0,3,0
1,3,0,0,3,0,3,0,3,0,1,0,3,0,3,0,3,0,1,0,3,0,3,0
1,4,4,1,6,1,5,1,4,4,1,1,5,1,4,1,4,4,1,1,4,1,3,0
2,0,4,1,29,14,15,4,0,4,2,1,15,7,8,2,0,4,2,1,8,3,5,1
2,2,2,1,17,8,9,2,2,2,2,1,9,4,5,1,2,2,2,1,5,2,3,0
0,3,1,3,3,0,3,2,3,1,0,3,3,0,3,2,3,1,0,3,3,0,3,2
2,1,0,1,3,1,2,0,1,0,2,1,2,0,2,0,1,0,2,1,2,0,2,0
2,2,1,0,3,1,2,0,2,1,2,0,2,1,1,0,2,1,2,0,1,0,1,0
0,3,4,2,19,1,18,8,3,4,0,2,18,1,17,8,3,4,0,2,17,1,16,7
4,4,0,1,2,1,1,0,4,0,4,1,1,0,1,0,4,0,4,1,1,0,1,0
4,2,2,1,15,13,2,0,2,2,4,1,2,1,1,0,2,2,4,1,1,0,1,0
3,1,1,3,11,7,4,2,1,1,3,3,4,2,2,1,1,1,3,3,2,1,1,0
2,2,0,1,11,5,6,1,2,0,2,1,6,3,3,0,2,0,2,1,3,1,2,0
0,3,1,2,20,1,19,9,3,1,0,2,19,1,18,8,3,1,0,2,18,1,17,8
0,0,4,1,27,2,25,7,0,4,0,1,25,2,23,6,0,4,0,1,23,2,21,6
3,4,3,4,7,4,3,2,4,3,3,4,3,2,1,0,4,3,3,4,1,0,1,0
3,0,3,0,27,18,9,0,0,3,3,0,9,6,3,0,0,3,3,0,3,2,1,0
0,3,1,1,7,0,7,2,3,1,0,1,7,0,7,2,3,1,0,1,7,0,7,2
0,3,2,1,7,0,7,2,3,2,0,1,7,0,7,2,3,2,0,1,7,0,7,2
3,2,4,1,16,11,5,1,2,4,3,1,5,3,2,0,2,4,3,1,2,1,1,0
3,4,3,2,7,4,3,1,4,3,3,2,3,2,1,0,4,3,3,2,1,0,1,0
0,1,0,3,5,0,5,3,1,0,0,3,5,0,5,3,1,0,0,3,5,0,5,3
0,3,4,2,15,1,14,6,3,4,0,2,14,1,13,6,3,4,0,2,13,1,12,6
1,2,2,2,3,0,3,1,2,2,1,2,3,0,3,1,2,2,1,2,3,0,3,1
3,0,2,4,23,16,7,6,0,2,3,4,7,4,3,2,0,2,3,4,3,2,1,0
2,1,4,2,27,13,14,7,1,4,2,2,14,7,7,3,1,4,2,2,7,3,4,1
3,2,1,0,10,7,3,0,2,1,3,0,3,2,1,0,2,1,3,0,1,0,1,0
0,4,3,3,2,0,2,1,4,3,0,3,2,0,2,1,4,3,0,3,2,0,2,1
2,3,0,0,1,0,1,0,3,0,2,0,1,0,1,0,3,0,2,0,1,0,1,0
0,4,2,4,12,1,11,9,4,2,0,4,11,1,10,9,4,2,0,4,10,0,10,8
3,4,3,1,8,5,3,0,4,3,3,1,3,2,1,0,4,3,3,1,1,0,1,0
2,2,0,2,5,2,3,1,2,0,2,2,3,1,2,0,2,0,2,2,2,1,1,0
0,1,4,2,28,2,26,13,1,4,0,2,26,2,24,12,1,4,0,2,24,2,22,11
4,4,4,3,10,9,1,0,4,4,4,3,1,0,1,0,4,4,4,3,1,0,1,0
1,2,2,1,16,4,12,3,2,2,1,1,12,3,9,2,2,2,1,1,9,2,7,2
2,2,1,1,5,2,3,0,2,1,2,1,3,1,2,0,2,1,2,1,2,0,2,0
0,2,2,3,19,1,18,12,2,2,0,3,18,1,17,11,2,2,0,3,17,1,16,11
3,2,0,4,0,0,0,0,2,0,3,4,0,0,0,0,2,0,3,4,0,0,0,0
2,2,2,0,8,4,4,0,2,2,2,0,4,2,2,0,2,2,2,0,2,1,1,0
1,2,0,2,5,1,4,1,2,0,1,2,4,1,3,1,2,0,1,2,3,0,3,1
2,3,1,1,10,4,6,1,3,1,2,1,6,2,4,1,3,1,2,1,4,2,2,0
2,4,2,1,7,3,4,1,4,2,2,1,4,2,2,0,4,2,2,1,2,1,1,0
4,2,0,2,13,11,2,0,2,0,4,2,2,1,1,0,2,0,4,2,1,0,1,0
0,4,0,4,2,0,2,1,4,0,0,4,2,0,2,1,4,0,0,4,2,0,2,1
0,0,3,0,28,2,26,2,0,3,0,0,26,2,24,2,0,3,0,0,24,2,22,2
1,3,3,1,17,5,12,3,3,3,1,1,12,3,9,2,3,3,1,1,9,2,7,2
3,0,1,3,20,14,6,4,0,1,3,3,6,4,2,1,0,1,3,3,2,1,1,0
3,0,1,0,15,10,5,0,0,1,3,0,5,3,2,0,0,1,3,0,2,1,1,0
0,2,1,1,3,0,3,0,2,1,0,1,3,0,3,0,2,1,0,1,3,0,3,0
2,2,4,1,22,11,11,3,2,4,2,1,11,5,6,1,2,4,2,1,6,3,3,0
1,2,3,0,11,3,8,0,2,3,1,0,8,2,6,0,2,3,1,0,6,1,5,0
3,0,1,2,13,9,4,2,0,1,3,2,4,2,2,1,0,1,3,2,2,1,1,0
2,3,0,4,6,3,3,2,3,0,2,4,3,1,2,1,3,0,2,4,2,1,1,0
1,2,2,4,1,0,1,0,2,2,1,4,1,0,1,0,2,2,1,4,1,0,1,0
4,0,1,3,7,6,1,0,0,1,4,3,1,0,1,0,0,1,4,3,1,0,1,0
0,0,1,0,7,0,7,0,0,1,0,0,7,0,7,0,0,1,0,0,7,0,7,0
3,1,3,0,18,12,6,0,1,3,3,0,6,4,2,0,1,3,3,0,2,1,1,0
1,3,3,4,9,2,7,6,3,3,1,4,7,2,5,4,3,3,1,4,5,1,4,3
0,0,3,2,25,2,23,11,0,3,0,2,23,2,21,10,0,3,0,2,21,2,19,9
1,3,2,0,1,0,1,0,3,2,1,0,1,0,1,0,3,2,1,0,1,0,1,0
0,3,1,0,2,0,2,0,3,1,0,0,2,0,2,0,3,1,0,0,2,0,2,0
3,1,4,1,25,17,8,2,1,4,3,1,8,5,3,0,1,4,3,1,3,2,1,0
2,2,3,4,20,9,11,9,2,3,2,4,11,5,6,5,2,3,2,4,6,2,4,3
1,4,3,1,1,0,1,0,4,3,1,1,1,0,1,0,4,3,1,1,1,0,1,0
1,4,2,3,8,2,6,4,4,2,1,3,6,1,5,3,4,2,1,3,5,1,4,2
2,3,1,3,9,4,5,3,3,1,2,3,5,2,3,2,3,1,2,3,3,1,2,1
2,3,3,3,7,3,4,2,3,3,2,3,4,2,2,1,3,3,2,3,2,1,1,0
2,3,4,4,10,4,6,5,3,4,2,4,6,2,4,3,3,4,2,4,4,2,2,1
4,3,2,3,13,11,2,1,3,2,4,3,2,1,1,0,3,2,4,3,1,0,1,0
4,1,2,2,25,22,3,1,1,2,4,2,3,2,1,0,1,2,4,2,1,0,1,0
3,3,3,1,0,0,0,0,3,3,3,1,0,0,0,0,3,3,3,1,0,0,0,0
4,3,2,3,12,10,2,1,3,2,4,3,2,1,1,0,3,2,4,3,1,0,1,0
4,3,1,0,12,10,2,0,3,1,4,0,2,1,1,0,3,1,4,0,1,0,1,0
2,2,4,0,27,13,14,1,2,4,2,0,14,7,7,0,2,4,2,0,7,3,4,0
3,0,3,0,27,18,9,0,0,3,3,0,9,6,3,0,0,3,3,0,3,2,1,0
3,0,0,3,18,12,6,4,0,0,3,3,6,4,2,1,0,0,3,3,2,1,1,0
0,3,1,0,8,0,8,0,3,1,0,0,8,0,8,0,3,1,0,0,8,0,8,0
3,4,2,4,3,2,1,0,4,2,3,4,1,0,1,0,4,2,3,4,1,0,1,0
3,1,3,2,24,16,8,4,1,3,3,2,8,5,3,1,1,3,3,2,3,2,1,0
0,4,2,2,6,0,6,2,4,2,0,2,6,0,6,2,4,2,0,2,6,0,6,2
4,2,4,1,28,25,3,0,2,4,4,1,3,2,1,0,2,4,4,1,1,0,1,0
1,3,0,0,2,0,2,0,3,0,1,0,2,0,2,0,3,0,1,0,2,0,2,0
2,1,3,0,19,9,10,1,1,3,2,0,10,4,6,0,1,3,2,0,6,2,4,0
2,3,3,0,12,6,6,0,3,3,2,0,6,2,4,0,3,3,2,0,4,2,2,0
4,2,0,4,13,11,2,1,2,0,4,4,2,1,1,0,2,0,4,4,1,0,1,0
1,0,1,1,16,4,12,3,0,1,1,1,12,3,9,2,0,1,1,1,9,2,7,2
2,1,2,2,12,5,7,3,1,2,2,2,7,3,4,2,1,2,2,2,4,1,3,1
1,4,3,2,7,2,5,2,4,3,1,2,5,1,4,1,4,3,1,2,4,1,3,1
0,4,4,3,3,0,3,2,4,4,0,3,3,0,3,2,4,4,0,3,3,0,3,2
1,3,1,1,7,2,5,1,3,1,1,1,5,1,4,1,3,1,1,1,4,1,3,0
0,3,2,3,7,0,7,4,3,2,0,3,7,0,7,4,3,2,0,3,7,0,7,4
0,4,0,4,0,0,0,0,4,0,0,4,0,0,0,0,4,0,0,4,0,0,0,0
3,0,4,4,29,20,9,8,0,4,3,4,9,6,3,2,0,4,3,4,3,2,1,0
2,3,4,4,22,10,12,10,3,4,2,4,12,6,6,5,3,4,2,4,6,3,3,2
1,1,1,4,19,5,14,12,1,1,1,4,14,4,10,9,1,1,1,4,10,2,8,7
2,2,3,1,15,7,8,2,2,3,2,1,8,3,5,1,2,3,2,1,5,2,3,0
0,0,2,1,27,2,25,7,0,2,0,1,25,2,23,6,0,2,0,1,23,2,21,6
0,0,4,1,29,2,27,8,0,4,0,1,27,2,25,7,0,4,0,1,25,2,23,6
1,4,4,4,1,0,1,0,4,4,1,4,1,0,1,0,4,4,1,4,1,0,1,0
0,2,2,1,16,1,15,4,2,2,0,1,15,1,14,4,2,2,0,1,14,1,13,3
3,3,0,3,0,0,0,0,3,0,3,3,0,0,0,0,3,0,3,3,0,0,0,0
0,2,0,0,9,0,9,0,2,0,0,0,9,0,9,0,2,0,0,0,9,0,9,0
4,3,0,2,7,6,1,0,3,0,4,2,1,0,1,0,3,0,4,2,1,0,1,0
2,2,2,3,9,4,5,3,2,2,2,3,5,2,3,2,2,2,2,3,3,1,2,1
0,1,2,2,19,1,18,8,1,2,0,2,18,1,17,8,1,2,0,2,17,1,16,8
0,2,2,1,15,1,14,4,2,2,0,1,14,1,13,3,2,2,0,1,13,1,12,3
3,4,0,3,0,0,0,0,4,0,3,3,0,0,0,0,4,0,3,3,0,0,0,0
0,3,0,0,1,0,1,0,3,0,0,0,1,0,1,0,3,0,0,0,1,0,1,0
0,2,2,3,18,1,17,11,2,2,0,3,17,1,16,11,2,2,0,3,16,1,15,10
2,0,1,0,9,4,5,0,0,1,2,0,5,2,3,0,0,1,2,0,3,1,2,0
1,1,0,3,11,3,8,5,1,0,1,3,8,2,6,4,1,0,1,3,6,1,5,3
1,0,2,0,21,6,15,1,0,2,1,0,15,4,11,1,0,2,1,0,11,3,8,0
3,0,4,3,27,18,9,6,0,4,3,3,9,6,3,2,0,4,3,3,3,2,1,0
2,0,0,3,5,2,3,2,0,0,2,3,3,1,2,1,0,0,2,3,2,1,1,0
3,1,4,0,27,18,9,0,1,4,3,0,9,6,3,0,1,4,3,0,3,2,1,0
1,3,2,3,3,0,3,2,3,2,1,3,3,0,3,2,3,2,1,3,3,0,3,2
0,0,4,4,27,2,25,22,0,4,0,4,25,2,23,20,0,4,0,4,23,2,21,18
1,0,1,4,17,5,12,10,0,1,1,4,12,3,9,8,0,1,1,4,9,2,7,6
3,1,1,4,11,7,4,3,1,1,3,4,4,2,2,1,1,1,3,4,2,1,1,0
3,3,4,2,13,9,4,2,3,4,3,2,4,2,2,0,3,4,3,2,2,1,1,0
2,2,2,1,14,6,8,2,2,2,2,1,8,4,4,1,2,2,2,1,4,2,2,0
4,4,4,4,13,11,2,1,4,4,4,4,2,1,1,0,4,4,4,4,1,0,1,0
2,1,3,1,21,10,11,3,1,3,2,1,11,5,6,1,1,3,2,1,6,2,4,1
0,4,2,4,5,0,5,4,4,2,0,4,5,0,5,4,4,2,0,4,5,0,5,4
0,1,3,3,21,2,19,13,1,3,0,3,19,1,18,12,1,3,0,3,18,1,17,11
0,3,3,1,3,0,3,0,3,3,0,1,3,0,3,0,3,3,0,1,3,0,3,0
1,4,0,4,3,0,3,2,4,0,1,4,3,0,3,2,4,0,1,4,3,0,3,2
2,3,1,4,12,6,6,5,3,1,2,4,6,2,4,3,3,1,2,4,4,1,3,2
4,0,0,2,7,6,1,0,0,0,4,2,1,0,1,0,0,0,4,2,1,0,1,0
2,3,3,0,11,5,6,0,3,3,2,0,6,2,4,0,3,3,2,0,4,1,3,0
0,1,0,4,6,0,6,5,1,0,0,4,6,0,6,5,1,0,0,4,6,0,6,5
3,0,4,0,23,16,7,0,0,4,3,0,7,4,3,0,0,4,3,0,3,2,1,0
4,0,0,0,4,3,1,0,0,0,4,0,1,0,1,0,0,0,4,0,1,0,1,0
0,1,4,0,21,2,19,1,1,4,0,0,19,1,18,1,1,4,0,0,18,1,17,1
1,2,4,2,28,8,20,9,2,4,1,2,20,5,15,7,2,4,1,2,15,4,11,5
3,1,2,0,22,15,7,0,1,2,3,0,7,4,3,0,1,2,3,0,3,2,1,0
2,3,4,3,10,5,5,3,3,4,2,3,5,2,3,2,3,4,2,3,3,1,2,1
2,3,1,0,5,2,3,0,3,1,2,0,3,1,2,0,3,1,2,0,2,1,1,0
2,1,4,2,28,14,14,6,1,4,2,2,14,7,7,3,1,4,2,2,7,3,4,2
3,0,2,3,23,16,7,4,0,2,3,3,7,4,3,2,0,2,3,3,3,2,1,0
1,2,3,3,23,6,17,11,2,3,1,3,17,5,12,8,2,3,1,3,12,3,9,6
0,3,1,2,8,0,8,3,3,1,0,2,8,0,8,3,3,1,0,2,8,0,8,3
1,3,4,0,19,5,14,1,3,4,1,0,14,4,10,1,3,4,1,0,10,3,7,0
3,0,4,4,27,18,9,8,0,4,3,4,9,6,3,2,0,4,3,4,3,2,1,0
2,1,4,1,29,14,15,4,1,4,2,1,15,7,8,2,1,4,2,1,8,3,5,1
0,0,4,0,29,2,27,2,0,4,0,0,27,2,25,2,0,4,0,0,25,2,23,2
4,3,0,2,8,7,1,0,3,0,4,2,1,0,1,0,3,0,4,2,1,0,1,0
4,2,3,1,26,23,3,0,2,3,4,1,3,2,1,0,2,3,4,1,1,0,1,0
0,4,1,0,5,0,5,0,4,1,0,0,5,0,5,0,4,1,0,0,5,0,5,0
1,2,1,2,8,2,6,3,2,1,1,2,6,1,5,2,2,1,1,2,5,1,4,1
4,3,3,2,5,4,1,0,3,3,4,2,1,0,1,0,3,3,4,2,1,0,1,0
1,1,4,1,29,8,21,6,1,4,1,1,21,6,15,4,1,4,1,1,15,4,11,3
4,1,2,2,24,21,3,1,1,2,4,2,3,2,1,0,1,2,4,2,1,0,1,0
1,1,0,0,8,2,6,0,1,0,1,0,6,1,5,0,1,0,1,0,5,1,4,0
4,1,3,3,23,20,3,2,1,3,4,3,3,2,1,0,1,3,4,3,1,0,1,0
3,4,2,3,7,4,3,2,4,2,3,3,3,2,1,0,4,2,3,3,1,0,1,0
3,1,1,0,13,9,4,0,1,1,3,0,4,2,2,0,1,1,3,0,2,1,1,0
3,2,1,1,7,4,3,0,2,1,3,1,3,2,1,0,2,1,3,1,1,0,1,0
3,1,3,2,26,18,8,3,1,3,3,2,8,5,3,1,1,3,3,2,3,2,1,0
3,4,0,0,8,5,3,0,4,0,3,0,3,2,1,0,4,0,3,0,1,0,1,0
3,4,3,3,10,6,4,2,4,3,3,3,4,2,2,1,4,3,3,3,2,1,1,0
2,4,1,3,8,4,4,2,4,1,2,3,4,2,2,1,4,1,2,3,2,1,1,0
1,1,3,3,24,7,17,11,1,3,1,3,17,5,12,8,1,3,1,3,12,3,9,6
2,0,3,0,29,14,15,1,0,3,2,0,15,7,8,0,0,3,2,0,8,3,5,0
1,4,4,1,2,0,2,0,4,4,1,1,2,0,2,0,4,4,1,1,2,0,2,0
0,2,3,4,24,2,22,19,2,3,0,4,22,2,20,18,2,3,0,4,20,1,19,17
1,0,1,1,9,2,7,2,0,1,1,1,7,2,5,1,0,1,1,1,5,1,4,1
2,1,2,4,19,9,10,8,1,2,2,4,10,4,6,5,1,2,2,4,6,3,3,2
1,4,4,0,7,2,5,0,4,4,1,0,5,1,4,0,4,4,1,0,4,1,3,0
0,0,4,1,28,2,26,7,0,4,0,1,26,2,24,7,0,4,0,1,24,2,22,6
2,1,1,0,4,1,3,0,1,1,2,0,3,1,2,0,1,1,2,0,2,0,2,0
3,3,3,3,6,4,2,1,3,3,3,3,2,1,1,0,3,3,3,3,1,0,1,0
3,1,0,1,2,1,1,0,1,0,3,1,1,0,1,0,1,0,3,1,1,0,1,0
2,0,1,0,21,10,11,1,0,1,2,0,11,5,6,0,0,1,2,0,6,3,3,0
2,3,1,2,4,2,2,1,3,1,2,2,2,1,1,0,3,1,2,2,1,0,1,0
3,1,0,2,7,4,3,1,1,0,3,2,3,2,1,0,1,0,3,2,1,0,1,0
4,3,3,1,8,7,1,0,3,3,4,1,1,0,1,0,3,3,4,1,1,0,1,0
3,2,3,3,12,8,4,2,2,3,3,3,4,2,2,1,2,3,3,3,2,1,1,0
3,4,4,0,0,0,0,0,4,4,3,0,0,0,0,0,4,4,3,0,0,0,0,0
0,0,2,2,18,1,17,8,0,2,0,2,17,1,16,8,0,2,0,2,16,1,15,7
3,4,3,0,2,1,1,0,4,3,3,0,1,0,1,0,4,3,3,0,1,0,1,0
4,1,0,0,1,0,1,0,1,0,4,0,1,0,1,0,1,0,4,0,1,0,1,0
4,2,2,3,20,17,3,2,2,2,4,3,3,2,1,0,2,2,4,3,1,0,1,0
4,0,4,1,29,26,3,0,0,4,4,1,3,2,1,0,0,4,4,1,1,0,1,0
2,4,2,4,6,2,4,3,4,2,2,4,4,1,3,2,4,2,2,4,3,1,2,1
0,1,4,4,26,2,24,21,1,4,0,4,24,2,22,19,1,4,0,4,22,2,20,18
3,2,0,1,8,5,3,0,2,0,3,1,3,2,1,0,2,0,3,1,1,0,1,0
4,4,3,1,1,0,1,0,4,3,4,1,1,0,1,0,4,3,4,1,1,0,1,0
3,2,3,2,18,12,6,3,2,3,3,2,6,4,2,1,2,3,3,2,2,1,1,0
4,1,1,0,5,4,1,0,1,1,4,0,1,0,1,0,1,1,4,0,1,0,1,0
2,3,4,1,5,2,3,0,3,4,2,1,3,1,2,0,3,4,2,1,2,1,1,0
4,3,2,3,11,9,2,1,3,2,4,3,2,1,1,0,3,2,4,3,1,0,1,0
1,2,3,2,17,5,12,5,2,3,1,2,12,3,9,4,2,3,1,2,9,2,7,3
0,3,4,1,15,1,14,4,3,4,0,1,14,1,13,3,3,4,0,1,13,1,12,3
2,0,3,4,28,14,14,12,0,3,2,4,14,7,7,6,0,3,2,4,7,3,4,3
3,3,2,3,4,2,2,1,3,2,3,3,2,1,1,0,3,2,3,3,1,0,1,0
4,0,4,3,26,23,3,2,0,4,4,3,3,2,1,0,0,4,4,3,1,0,1,0
0,0,0,1,14,1,13,3,0,0,0,1,13,1,12,3,0,0,0,1,12,1,11,3
1,4,3,0,4,1,3,0,4,3,1,0,3,0,3,0,4,3,1,0,3,0,3,0
3,0,1,4,6,4,2,1,0,1,3,4,2,1,1,0,0,1,3,4,1,0,1,0
0,1,0,1,13,1,12,3,1,0,0,1,12,1,11,3,1,0,0,1,11,1,10,2
4,4,1,1,4,3,1,0,4,1,4,1,1,0,1,0,4,1,4,1,1,0,1,0
0,2,3,3,25,2,23,16,2,3,0,3,23,2,21,14,2,3,0,3,21,2,19,13
0,0,0,3,15,1,14,9,0,0,0,3,14,1,13,9,0,0,0,3,13,1,12,8
4,0,0,0,5,4,1,0,0,0,4,0,1,0,1,0,0,0,4,0,1,0,1,0
3,2,4,0,25,17,8,0,2,4,3,0,8,5,3,0,2,4,3,0,3,2,1,0
0,3,1,4,7,0,7,6,3,1,0,4,7,0,7,6,3,1,0,4,7,0,7,6
2,1,1,0,14,6,8,0,1,1,2,0,8,3,5,0,1,1,2,0,5,2,3,0
1,0,4,4,28,8,20,17,0,4,1,4,20,5,15,13,0,4,1,4,15,4,11,9
1,1,2,0,15,4,11,1,1,2,1,0,11,3,8,0,1,2,1,0,8,2,6,0
0,1,4,1,27,2,25,7,1,4,0,1,25,2,23,6,1,4,0,1,23,2,21,6
0,1,4,3,25,2,23,16,1,4,0,3,23,2,21,14,1,4,0,3,21,2,19,13
2,2,1,2,17,8,9,4,2,1,2,2,9,4,5,2,2,1,2,2,5,2,3,1
3,3,1,0,12,8,4,0,3,1,3,0,4,2,2,0,3,1,3,0,2,1,1,0
4,4,0,0,6,5,1,0,4,0,4,0,1,0,1,0,4,0,4,0,1,0,1,0
0,1,2,1,15,1,14,4,1,2,0,1,14,1,13,3,1,2,0,1,13,1,12,3
4,3,4,3,15,13,2,1,3,4,4,3,2,1,1,0,3,4,4,3,1,0,1,0
4,3,4,3,12,10,2,1,3,4,4,3,2,1,1,0,3,4,4,3,1,0,1,0
3,4,4,0,7,4,3,0,4,4,3,0,3,2,1,0,4,4,3,0,1,0,1,0
2,0,3,1,25,12,13,3,0,3,2,1,13,6,7,2,0,3,2,1,7,3,4,1
2,4,1,1,6,2,4,1,4,1,2,1,4,2,2,0,4,1,2,1,2,1,1,0
0,0,1,2,13,1,12,5,0,1,0,2,12,1,11,5,0,1,0,2,11,1,10,5
1,0,3,4,22,6,16,14,0,3,1,4,16,4,12,10,0,3,1,4,12,3,9,8
4,2,4,4,27,24,3,2,2,4,4,4,3,2,1,0,2,4,4,4,1,0,1,0
0,1,3,3,15,1,14,9,1,3,0,3,14,1,13,9,1,3,0,3,13,1,12,8
0,4,0,2,2,0,2,0,4,0,0,2,2,0,2,1,4,0,0,2,2,0,2,1
0,3,3,0,15,1,14,1,3,3,0,0,14,1,13,1,3,3,0,0,13,1,12,1
2,2,1,3,7,3,4,2,2,1,2,3,4,2,2,1,2,1,2,3,2,0,2,1
2,0,1,0,15,7,8,0,0,1,2,0,8,3,5,0,0,1,2,0,5,2,3,0
2,2,2,4,6,2,4,3,2,2,2,4,4,1,3,2,2,2,2,4,3,1,2,1
0,2,2,0,18,1,17,1,2,2,0,0,17,1,16,1,2,2,0,0,16,1,15,1
0,0,2,2,25,2,23,11,0,2,0,2,23,2,21,10,0,2,0,2,21,2,19,9
3,0,3,1,21,14,7,2,0,3,3,1,7,4,3,0,0,3,3,1,3,2,1,0
2,1,1,1,10,4,6,1,1,1,2,1,6,3,3,0,1,1,2,1,3,1,2,0
3,0,3,3,26,18,8,5,0,3,3,3,8,5,3,2,0,3,3,3,3,2,1,0
2,2,0,2,7,3,4,1,2,0,2,2,4,1,3,1,2,0,2,2,3,1,2,0
3,4,1,3,2,1,1,0,4,1,3,3,1,0,1,0,4,1,3,3,1,0,1,0
0,3,1,2,2,0,2,1,3,1,0,2,2,0,2,0,3,1,0,2,2,0,2,1
1,4,4,1,7,2,5,1,4,4,1,1,5,1,4,1,4,4,1,1,4,1,3,0
1,1,1,0,11,3,8,0,1,1,1,0,8,2,6,0,1,1,1,0,6,1,5,0
4,0,4,0,29,26,3,0,0,4,4,0,3,2,1,0,0,4,4,0,1,0,1,0
1,4,0,1,9,2,7,2,4,0,1,1,7,2,5,1,4,0,1,1,5,1,4,1
4,3,1,0,6,5,1,0,3,1,4,0,1,0,1,0,3,1,4,0,1,0,1,0
2,0,2,0,18,9,9,0,0,2,2,0,9,4,5,0,0,2,2,0,5,2,3,0
3,0,3,2,27,18,9,4,0,3,3,2,9,6,3,1,0,3,3,2,3,2,1,0
4,3,3,2,14,12,2,0,3,3,4,2,2,1,1,0,3,3,4,2,1,0,1,0
3,3,3,3,11,7,4,2,3,3,3,3,4,2,2,1,3,3,3,3,2,1,1,0
3,4,2,1,5,3,2,0,4,2,3,1,2,1,1,0,4,2,3,1,1,0,1,0
2,3,0,2,7,3,4,2,3,0,2,2,4,2,2,0,3,0,2,2,2,1,1,0
0,0,3,4,24,2,22,19,0,3,0,4,22,2,20,17,0,3,0,4,20,2,18,16
1,3,4,0,6,1,5,0,3,4,1,0,5,1,4,0,3,4,1,0,4,1,3,0
3,0,2,2,25,17,8,4,0,2,3,2,8,5,3,1,0,2,3,2,3,2,1,0
4,4,3,4,17,15,2,1,4,3,4,4,2,1,1,0,4,3,4,4,1,0,1,0
2,4,3,1,4,1,3,0,4,3,2,1,3,1,2,0,4,3,2,1,2,0,2,0
1,4,1,3,11,3,8,5,4,1,1,3,8,2,6,4,4,1,1,3,6,1,5,3
4,3,0,1,1,0,1,0,3,0,4,1,1,0,1,0,3,0,4,1,1,0,1,0
3,4,1,0,2,1,1,0,4,1,3,0,1,0,1,0,4,1,3,0,1,0,1,0
1,4,2,3,6,1,5,3,4,2,1,3,5,1,4,2,4,2,1,3,4,1,3,2
2,1,0,0,4,1,3,0,1,0,2,0,3,1,2,0,1,0,2,0,2,0,2,0
4,2,1,4,12,10,2,1,2,1,4,4,2,1,1,0,2,1,4,4,1,0,1,0
2,0,1,2,12,5,7,3,0,1,2,2,7,3,4,1,0,1,2,2,4,1,3,1
3,2,3,3,21,14,7,4,2,3,3,3,7,4,3,2,2,3,3,3,3,2,1,0
0,3,4,4,11,1,10,9,3,4,0,4,10,1,9,8,3,4,0,4,9,0,9,8
2,2,4,2,23,11,12,6,2,4,2,2,12,5,7,3,2,4,2,2,7,3,4,2
0,4,2,0,8,0,8,0,4,2,0,0,8,0,8,0,4,2,0,0,8,0,8,0
0,4,0,3,10,1,9,6,4,0,0,3,9,0,9,6,4,0,0,3,9,0,9,6
0,4,2,2,3,0,3,1,4,2,0,2,3,0,3,1,4,2,0,2,3,0,3,1
1,0,2,3,17,5,12,8,0,2,1,3,12,3,9,6,0,2,1,3,9,2,7,4
2,1,2,1,20,9,11,3,1,2,2,1,11,5,6,1,1,2,2,1,6,2,4,1
3,4,2,0,12,8,4,0,4,2,3,0,4,2,2,0,4,2,3,0,2,1,1,0
1,3,1,4,13,3,10,8,3,1,1,4,10,2,8,7,3,1,1,4,8,2,6,5
4,3,3,3,26,23,3,2,3,3,4,3,3,2,1,0,3,3,4,3,1,0,1,0
4,4,3,1,12,10,2,0,4,3,4,1,2,1,1,0,4,3,4,1,1,0,1,0
3,2,4,4,28,19,9,8,2,4,3,4,9,6,3,2,2,4,3,4,3,2,1,0
4,1,3,2,21,18,3,1,1,3,4,2,3,2,1,0,1,3,4,2,1,0,1,0
1,3,3,4,11,3,8,7,3,3,1,4,8,2,6,5,3,3,1,4,6,1,5,4
0,0,1,2,9,0,9,4,0,1,0,2,9,0,9,4,0,1,0,2,9,0,9,4
0,1,1,2,19,1,18,8,1,1,0,2,18,1,17,8,1,1,0,2,17,1,16,7
2,4,1,2,2,0,2,1,4,1,2,2,2,0,2,1,4,1,2,2,2,0,2,0
4,0,2,2,19,17,2,0,0,2,4,2,2,1,1,0,0,2,4,2,1,0,1,0
4,1,2,1,16,14,2,0,1,2,4,1,2,1,1,0,1,2,4,1,1,0,1,0
4,4,0,3,3,2,1,0,4,0,4,3,1,0,1,0,4,0,4,3,1,0,1,0
2,3,4,4,12,6,6,5,3,4,2,4,6,3,3,2,3,4,2,4,3,1,2,1
4,1,0,0,10,9,1,0,1,0,4,0,1,0,1,0,1,0,4,0,1,0,1,0
0,0,1,1,16,1,15,4,0,1,0,1,15,1,14,4,0,1,0,1,14,1,13,3
1,2,2,4,14,4,10,8,2,2,1,4,10,3,7,6,2,2,1,4,7,2,5,4
1,0,3,3,27,8,19,13,0,3,1,3,19,5,14,9,0,3,1,3,14,4,10,7
4,2,1,2,2,1,1,0,2,1,4,2,1,0,1,0,2,1,4,2,1,0,1,0
4,3,3,0,15,13,2,0,3,3,4,0,2,1,1,0,3,3,4,0,1,0,1,0
1,2,2,1,12,3,9,2,2,2,1,1,9,2,7,2,2,2,1,1,7,2,5,1
2,2,2,1,9,4,5,1,2,2,2,1,5,2,3,0,2,2,2,1,3,1,2,0
4,2,2,3,13,11,2,1,2,2,4,3,2,1,1,0,2,2,4,3,1,0,1,0
1,1,2,0,18,5,13,1,1,2,1,0,13,3,10,0,1,2,1,0,10,2,8,0
1,1,3,2,26,7,19,9,1,3,1,2,19,5,14,6,1,3,1,2,14,4,10,5
4,4,1,2,5,4,1,0,4,1,4,2,1,0,1,0,4,1,4,2,1,0,1,0
2,0,1,4,18,9,9,8,0,1,2,4,9,4,5,4,0,1,2,4,5,2,3,2
3,4,1,3,5,3,2,1,4,1,3,3,2,1,1,0,4,1,3,3,1,0,1,0
1,2,3,0,15,4,11,1,2,3,1,0,11,3,8,0,2,3,1,0,8,2,6,0
3,3,1,4,4,2,2,1,3,1,3,4,2,1,1,0,3,1,3,4,1,0,1,0
0,3,1,1,13,1,12,3,3,1,0,1,12,1,11,3,3,1,0,1,11,1,10,2
1,2,4,0,16,4,12,1,2,4,1,0,12,3,9,0,2,4,1,0,9,2,7,0
1,4,3,2,7,2,5,2,4,3,1,2,5,1,4,2,4,3,1,2,4,1,3,1
4,3,0,4,1,0,1,0,3,0,4,4,1,0,1,0,3,0,4,4,1,0,1,0
2,1,0,4,6,3,3,2,1,0,2,4,3,1,2,1,1,0,2,4,2,0,2,1
2,4,4,2,10,4,6,2,4,4,2,2,6,3,3,1,4,4,2,2,3,1,2,0
2,3,4,2,21,10,11,5,3,4,2,2,11,5,6,2,3,4,2,2,6,3,3,1
0,1,0,3,13,1,12,8,1,0,0,3,12,1,11,7,1,0,0,3,11,1,10,6
3,4,4,3,6,4,2,1,4,4,3,3,2,1,1,0,4,4,3,3,1,0,1,0
4,4,3,0,7,6,1,0,4,3,4,0,1,0,1,0,4,3,4,0,1,0,1,0
3,0,0,1,9,6,3,0,0,0,3,1,3,2,1,0,0,0,3,1,1,0,1,0
3,1,4,1,21,14,7,2,1,4,3,1,7,4,3,0,1,4,3,1,3,2,1,0
0,0,2,1,20,2,18,5,0,2,0,1,18,1,17,5,0,2,0,1,17,1,16,4
3,1,4,2,24,16,8,4,1,4,3,2,8,5,3,1,1,4,3,2,3,2,1,0
3,4,4,0,1,0,1,0,4,4,3,0,1,0,1,0,4,4,3,0,1,0,1,0
0,2,1,3,7,0,7,4,2,1,0,3,7,0,7,4,2,1,0,3,7,0,7,4
1,2,4,4,21,6,15,13,2,4,1,4,15,4,11,9,2,4,1,4,11,3,8,7
3,2,2,4,13,9,4,3,2,2,3,4,4,2,2,1,2,2,3,4,2,1,1,0
3,2,0,4,4,2,2,1,2,0,3,4,2,1,1,0,2,0,3,4,1,0,1,0
2,1,2,4,17,8,9,8,1,2,2,4,9,4,5,4,1,2,2,4,5,2,3,2
3,2,0,1,4,2,2,0,2,0,3,1,2,1,1,0,2,0,3,1,1,0,1,0
1,4,3,2,13,3,10,5,4,3,1,2,10,2,8,3,4,3,1,2,8,2,6,2
3,1,3,4,21,14,7,6,1,3,3,4,7,4,3,2,1,3,3,4,3,2,1,0
1,0,0,4,4,1,3,2,0,0,1,4,3,0,3,2,0,0,1,4,3,0,3,2
2,0,3,1,27,13,14,4,0,3,2,1,14,7,7,2,0,3,2,1,7,3,4,1
2,0,3,0,26,13,13,1,0,3,2,0,13,6,7,0,0,3,2,0,7,3,4,0
2,4,0,0,14,6,8,0,4,0,2,0,8,3,5,0,4,0,2,0,5,2,3,0
1,3,0,3,1,0,1,0,3,0,1,3,1,0,1,0,3,0,1,3,1,0,1,0
3,3,3,3,5,3,2,1,3,3,3,3,2,1,1,0,3,3,3,3,1,0,1,0
0,3,1,3,6,0,6,4,3,1,0,3,6,0,6,4,3,1,0,3,6,0,6,4
2,1,1,4,14,7,7,6,1,1,2,4,7,3,4,3,1,1,2,4,4,1,3,2
4,3,1,0,14,12,2,0,3,1,4,0,2,1,1,0,3,1,4,0,1,0,1,0
3,3,4,4,17,11,6,5,3,4,3,4,6,4,2,1,3,4,3,4,2,1,1,0
4,1,4,2,27,24,3,1,1,4,4,2,3,2,1,0,1,4,4,2,1,0,1,0
4,3,2,4,7,6,1,0,3,2,4,4,1,0,1,0,3,2,4,4,1,0,1,0
4,1,2,4,16,14,2,1,1,2,4,4,2,1,1,0,1,2,4,4,1,0,1,0
2,3,2,4,2,1,1,0,3,2,2,4,1,0,1,0,3,2,2,4,1,0,1,0
0,3,2,0,10,1,9,0,3,2,0,0,9,0,9,0,3,2,0,0,9,0,9,0
2,2,0,3,3,1,2,1,2,0,2,3,2,1,1,0,2,0,2,3,1,0,1,0
2,4,4,1,11,5,6,1,4,4,2,1,6,2,4,1,4,4,2,1,4,1,3,0
2,1,3,0,17,8,9,0,1,3,2,0,9,4,5,0,1,3,2,0,5,2,3,0
1,3,0,4,6,1,5,4,3,0,1,4,5,1,4,3,3,0,1,4,4,1,3,2
1,1,3,4,14,4,10,8,1,3,1,4,10,3,7,6,1,3,1,4,7,2,5,4
1,2,4,2,12,3,9,4,2,4,1,2,9,2,7,3,2,4,1,2,7,2,5,2
2,2,4,1,17,8,9,2,2,4,2,1,9,4,5,1,2,4,2,1,5,2,3,0
3,4,2,1,1,0,1,0,4,2,3,1,1,0,1,0,4,2,3,1,1,0,1,0
4,3,0,0,7,6,1,0,3,0,4,0,1,0,1,0,3,0,4,0,1,0,1,0
3,0,0,0,14,9,5,0,0,0,3,0,5,3,2,0,0,0,3,0,2,1,1,0
0,4,3,3,7,0,7,4,4,3,0,3,7,0,7,4,4,3,0,3,7,0,7,4
3,3,4,1,17,11,6,1,3,4,3,1,6,4,2,0,3,4,3,1,2,1,1,0
1,1,1,3,22,6,16,11,1,1,1,3,16,4,12,8,1,1,1,3,12,3,9,6
2,3,3,1,11,5,6,1,3,3,2,1,6,2,4,1,3,3,2,1,4,2,2,0
2,2,4,3,19,9,10,7,2,4,2,3,10,4,6,4,2,4,2,3,6,2,4,2
2,4,0,4,5,2,3,2,4,0,2,4,3,1,2,1,4,0,2,4,2,1,1,0
4,4,2,1,7,6,1,0,4,2,4,1,1,0,1,0,4,2,4,1,1,0,1,0
2,4,4,0,19,9,10,1,4,4,2,0,10,5,5,0,4,4,2,0,5,2,3,0
3,0,2,1,19,13,6,1,0,2,3,1,6,4,2,0,0,2,3,1,2,1,1,0
0,2,4,4,14,1,13,11,2,4,0,4,13,1,12,10,2,4,0,4,12,1,11,9
3,2,3,3,13,9,4,2,2,3,3,3,4,2,2,1,2,3,3,3,2,1,1,0
4,0,2,1,29,26,3,0,0,2,4,1,3,2,1,0,0,2,4,1,1,0,1,0
0,2,4,4,21,2,19,17,2,4,0,4,19,1,18,16,2,4,0,4,18,1,17,15
1,2,1,4,8,2,6,5,2,1,1,4,6,1,5,4,2,1,1,4,5,1,4,3
3,0,3,0,22,15,7,0,0,3,3,0,7,4,3,0,0,3,3,0,3,2,1,0
4,3,1,1,12,10,2,0,3,1,4,1,2,1,1,0,3,1,4,1,1,0,1,0
2,1,1,2,19,9,10,5,1,1,2,2,10,4,6,3,1,1,2,2,6,2,4,2
1,2,0,3,3,0,3,2,2,0,1,3,3,0,3,2,2,0,1,3,3,0,3,2
3,4,3,1,8,5,3,0,4,3,3,1,3,2,1,0,4,3,3,1,1,0,1,0
2,1,0,0,7,3,4,0,1,0,2,0,4,2,2,0,1,0,2,0,2,1,1,0
4,2,0,0,2,1,1,0,2,0,4,0,1,0,1,0,2,0,4,0,1,0,1,0
3,3,4,1,16,11,5,1,3,4,3,1,5,3,2,0,3,4,3,1,2,1,1,0
0,4,1,4,6,0,6,5,4,1,0,4,6,0,6,5,4,1,0,4,6,0,6,5
2,2,2,4,9,4,5,4,2,2,2,4,5,2,3,2,2,2,2,4,3,1,2,1
0,1,2,4,14,1,13,11,1,2,0,4,13,1,12,10,1,2,0,4,12,1,11,9
2,4,2,2,2,0,2,0,4,2,2,2,2,1,1,0,4,2,2,2,1,0,1,0
0,4,3,3,8,0,8,5,4,3,0,3,8,0,8,5,4,3,0,3,8,0,8,5
2,2,3,3,16,8,8,5,2,3,2,3,8,3,5,3,2,3,2,3,5,2,3,2
3,1,1,0,16,11,5,0,1,1,3,0,5,3,2,0,1,1,3,0,2,1,1,0
1,3,0,0,8,2,6,0,3,0,1,0,6,1,5,0,3,0,1,0,5,1,4,0
2,3,3,0,15,7,8,0,3,3,2,0,8,3,5,0,3,3,2,0,5,2,3,0
0,4,1,3,11,1,10,6,4,1,0,3,10,0,10,6,4,1,0,3,10,1,9,6
1,3,0,4,2,0,2,1,3,0,1,4,2,0,2,1,3,0,1,4,2,0,2,1
4,1,0,0,10,8,2,0,1,0,4,0,2,1,1,0,1,0,4,0,1,0,1,0
3,3,4,0,14,9,5,0,3,4,3,0,5,3,2,0,3,4,3,0,2,1,1,0
2,0,0,3,11,5,6,4,0,0,2,3,6,2,4,2,0,0,2,3,4,2,2,1
0,2,3,0,15,1,14,1,2,3,0,0,14,1,13,1,2,3,0,0,13,1,12,1
4,2,4,3,25,22,3,2,2,4,4,3,3,2,1,0,2,4,4,3,1,0,1,0
2,3,1,2,11,5,6,2,3,1,2,2,6,2,4,2,3,1,2,2,4,1,3,1
0,4,3,1,2,0,2,0,4,3,0,1,2,0,2,0,4,3,0,1,2,0,2,0
1,4,0,4,2,0,2,1,4,0,1,4,2,0,2,1,4,0,1,4,2,0,2,1
4,1,1,3,7,6,1,0,1,1,4,3,1,0,1,0,1,1,4,3,1,0,1,0
2,4,3,2,6,3,3,1,4,3,2,2,3,1,2,0,4,3,2,2,2,1,1,0
4,0,3,3,22,19,3,2,0,3,4,3,3,2,1,0,0,3,4,3,1,0,1,0
1,4,2,0,9,2,7,0,4,2,1,0,7,2,5,0,4,2,1,0,5,1,4,0
4,1,0,1,7,6,1,0,1,0,4,1,1,0,1,0,1,0,4,1,1,0,1,0
0,2,3,1,18,1,17,5,2,3,0,1,17,1,16,4,2,3,0,1,16,1,15,4
3,0,2,4,15,10,5,4,0,2,3,4,5,3,2,1,0,2,3,4,2,1,1,0
1,4,0,0,6,1,5,0,4,0,1,0,5,1,4,0,4,0,1,0,4,1,3,0
1,3,2,3,6,1,5,3,3,2,1,3,5,1,4,2,3,2,1,3,4,1,3,2
0,3,0,2,1,0,1,0,3,0,0,2,1,0,1,0,3,0,0,2,1,0,1,0
3,2,0,0,1,0,1,0,2,0,3,0,1,0,1,0,2,0,3,0,1,0,1,0
2,3,3,0,11,5,6,0,3,3,2,0,6,2,4,0,3,3,2,0,4,2,2,0
0,3,2,1,18,1,17,5,3,2,0,1,17,1,16,4,3,2,0,1,16,1,15,4
1,0,1,1,11,3,8,2,0,1,1,1,8,2,6,1,0,1,1,1,6,1,5,1
0,0,0,0,0,0,0,0,0,0,0,0,0,0,0,0,0,0,0,0,0,0,0,0
3,1,1,1,11,7,4,1,1,1,3,1,4,2,2,0,1,1,3,1,2,1,1,0
1,2,2,2,7,2,5,2,2,2,1,2,5,1,4,2,2,2,1,2,4,1,3,1
3,4,3,2,11,7,4,1,4,3,3,2,4,2,2,0,4,3,3,2,2,1,1,0
0,3,2,2,3,0,3,1,3,2,0,2,3,0,3,1,3,2,0,2,3,0,3,1
1,2,3,3,11,3,8,5,2,3,1,3,8,2,6,4,2,3,1,3,6,1,5,3
2,1,4,4,23,11,12,10,1,4,2,4,12,5,7,6,1,4,2,4,7,3,4,3
4,4,4,1,7,6,1,0,4,4,4,1,1,0,1,0,4,4,4,1,1,0,1,0
0,1,4,2,29,2,27,13,1,4,0,2,27,2,25,12,1,4,0,2,25,2,23,11
2,2,4,1,24,12,12,3,2,4,2,1,12,5,7,2,2,4,2,1,7,3,4,1
1,0,3,1,29,8,21,6,0,3,1,1,21,6,15,4,0,3,1,1,15,4,11,3
4,4,1,2,4,3,1,0,4,1,4,2,1,0,1,0,4,1,4,2,1,0,1,0
4,1,2,3,28,25,3,2,1,2,4,3,3,2,1,0,1,2,4,3,1,0,1,0
3,3,1,2,5,3,2,0,3,1,3,2,2,1,1,0,3,1,3,2,1,0,1,0
0,1,4,4,28,2,26,23,1,4,0,4,26,2,24,21,1,4,0,4,24,2,22,19
4,0,3,1,28,25,3,0,0,3,4,1,3,2,1,0,0,3,4,1,1,0,1,0
4,3,4,0,9,8,1,0,3,4,4,0,1,0,1,0,3,4,4,0,1,0,1,0
2,2,2,3,18,9,9,6,2,2,2,3,9,4,5,3,2,2,2,3,5,2,3,2
2,4,0,4,9,4,5,4,4,0,2,4,5,2,3,2,4,0,2,4,3,1,2,1
2,1,4,1,26,12,14,4,1,4,2,1,14,7,7,2,1,4,2,1,7,3,4,1
4,2,4,1,29,26,3,0,2,4,4,1,3,2,1,0,2,4,4,1,1,0,1,0
3,4,4,4,5,3,2,1,4,4,3,4,2,1,1,0,4,4,3,4,1,0,1,0
0,1,0,1,2,0,2,0,1,0,0,1,2,0,2,0,1,0,0,1,2,0,2,0
2,1,2,2,21,10,11,5,1,2,2,2,11,5,6,3,1,2,2,2,6,3,3,1
2,3,1,1,6,2,4,1,3,1,2,1,4,1,3,0,3,1,2,1,3,1,2,0
1,0,3,4,29,8,21,18,0,3,1,4,21,6,15,13,0,3,1,4,15,4,11,9
0,4,3,4,13,1,12,10,4,3,0,4,12,1,11,9,4,3,0,4,11,1,10,8
2,1,4,4,28,13,15,13,1,4,2,4,15,7,8,7,1,4,2,4,8,3,5,4
2,3,2,0,14,7,7,0,3,2,2,0,7,3,4,0,3,2,2,0,4,1,3,0
4,0,4,3,29,26,3,2,0,4,4,3,3,2,1,0,0,4,4,3,1,0,1,0
1,4,2,2,3,0,3,1,4,2,1,2,3,0,3,1,4,2,1,2,3,0,3,1
4,3,0,3,1,0,1,0,3,0,4,3,1,0,1,0,3,0,4,3,1,0,1,0
4,2,0,1,1,0,1,0,2,0,4,1,1,0,1,0,2,0,4,1,1,0,1,0
2,0,4,0,28,14,14,1,0,4,2,0,14,7,7,0,0,4,2,0,7,3,4,0
0,0,2,4,28,2,26,23,0,2,0,4,26,2,24,21,0,2,0,4,24,2,22,19
2,0,1,1,16,7,9,2,0,1,2,1,9,4,5,1,0,1,2,1,5,2,3,0
3,0,1,2,16,11,5,2,0,1,3,2,5,3,2,0,0,1,3,2,2,1,1,0
3,0,3,1,27,18,9,2,0,3,3,1,9,6,3,0,0,3,3,1,3,2,1,0
3,3,1,2,16,11,5,2,3,1,3,2,5,3,2,0,3,1,3,2,2,1,1,0
3,2,1,1,11,7,4,1,2,1,3,1,4,2,2,0,2,1,3,1,2,1,1,0
1,3,0,1,0,0,0,0,3,0,1,1,0,0,0,0,3,0,1,1,0,0,0,0
4,2,2,0,17,15,2,0,2,2,4,0,2,1,1,0,2,2,4,0,1,0,1,0
3,1,3,0,26,18,8,0,1,3,3,0,8,5,3,0,1,3,3,0,3,2,1,0
1,2,1,4,11,3,8,7,2,1,1,4,8,2,6,5,2,1,1,4,6,1,5,4
2,0,2,1,29,14,15,4,0,2,2,1,15,7,8,2,0,2,2,1,8,3,5,1
3,2,4,3,19,13,6,4,2,4,3,3,6,4,2,1,2,4,3,3,2,1,1,0
4,3,1,0,9,8,1,0,3,1,4,0,1,0,1,0,3,1,4,0,1,0,1,0
2,1,0,1,13,6,7,2,1,0,2,1,7,3,4,1,1,0,2,1,4,2,2,0
1,3,2,2,2,0,2,0,3,2,1,2,2,0,2,0,3,2,1,2,2,0,2,0
1,1,0,4,5,1,4,3,1,0,1,4,4,1,3,2,1,0,1,4,3,0,3,2
0,2,4,3,15,1,14,9,2,4,0,3,14,1,13,9,2,4,0,3,13,1,12,8
1,2,4,4,22,6,16,14,2,4,1,4,16,4,12,10,2,4,1,4,12,3,9,8
3,1,3,4,8,5,3,2,1,3,3,4,3,2,1,0,1,3,3,4,1,0,1,0
1,3,3,3,14,4,10,6,3,3,1,3,10,2,8,5,3,3,1,3,8,2,6,4
2,1,2,4,26,12,14,12,1,2,2,4,14,6,8,7,1,2,2,4,8,4,4,3
4,1,0,2,0,0,0,0,1,0,4,2,0,0,0,0,1,0,4,2,0,0,0,0
2,2,4,4,20,10,10,8,2,4,2,4,10,4,6,5,2,4,2,4,6,3,3,2
2,2,1,1,10,5,5,1,2,1,2,1,5,2,3,0,2,1,2,1,3,1,2,0
1,1,4,4,26,7,19,17,1,4,1,4,19,5,14,12,1,4,1,4,14,4,10,8
1,2,4,2,21,6,15,7,2,4,1,2,15,4,11,5,2,4,1,2,11,3,8,4
1,2,1,1,4,1,3,0,2,1,1,1,3,0,3,0,2,1,1,1,3,0,3,0
2,2,3,1,25,12,13,3,2,3,2,1,13,6,7,2,2,3,2,1,7,3,4,1
4,2,3,1,23,20,3,0,2,3,4,1,3,2,1,0,2,3,4,1,1,0,1,0
1,0,4,3,27,8,19,13,0,4,1,3,19,5,14,9,0,4,1,3,14,4,10,7
2,4,4,1,4,1,3,0,4,4,2,1,3,1,2,0,4,4,2,1,2,1,1,0
2,3,4,3,11,5,6,4,3,4,2,3,6,3,3,2,3,4,2,3,3,1,2,1
1,2,2,3,16,4,12,8,2,2,1,3,12,3,9,6,2,2,1,3,9,2,7,4
3,4,2,1,6,4,2,0,4,2,3,1,2,1,1,0,4,2,3,1,1,0,1,0
1,0,4,0,29,8,21,2,0,4,1,0,21,6,15,1,0,4,1,0,15,4,11,1
1,2,3,4,23,6,17,15,2,3,1,4,17,5,12,10,2,3,1,4,12,3,9,8
4,0,2,2,20,18,2,1,0,2,4,2,2,1,1,0,0,2,4,2,1,0,1,0
3,0,1,0,23,16,7,0,0,1,3,0,7,4,3,0,0,1,3,0,3,2,1,0
1,1,1,4,11,3,8,7,1,1,1,4,8,2,6,5,1,1,1,4,6,1,5,4
4,1,3,4,18,16,2,1,1,3,4,4,2,1,1,0,1,3,4,4,1,0,1,0
2,3,4,2,18,8,10,4,3,4,2,2,10,4,6,2,3,4,2,2,6,3,3,1
2,4,1,0,2,0,2,0,4,1,2,0,2,1,1,0,4,1,2,0,1,0,1,0
4,3,4,4,20,18,2,1,3,4,4,4,2,1,1,0,3,4,4,4,1,0,1,0
3,3,1,2,5,3,2,0,3,1,3,2,2,1,1,0,3,1,3,2,1,0,1,0
0,2,2,1,14,1,13,3,2,2,0,1,13,1,12,3,2,2,0,1,12,1,11,3
3,4,1,1,0,0,0,0,4,1,3,1,0,0,0,0,4,1,3,1,0,0,0,0
2,3,2,1,9,4,5,1,3,2,2,1,5,2,3,0,3,2,2,1,3,1,2,0
3,2,1,3,5,3,2,1,2,1,3,3,2,1,1,0,2,1,3,3,1,0,1,0
0,4,4,0,5,0,5,0,4,4,0,0,5,0,5,0,4,4,0,0,5,0,5,0
1,1,0,4,3,0,3,2,1,0,1,4,3,0,3,2,1,0,1,4,3,0,3,2
4,1,3,3,23,20,3,2,1,3,4,3,3,2,1,0,1,3,4,3,1,0,1,0
3,3,3,0,11,7,4,0,3,3,3,0,4,2,2,0,3,3,3,0,2,1,1,0
0,2,2,2,11,1,10,4,2,2,0,2,10,1,9,4,2,2,0,2,9,0,9,4
3,1,0,3,3,2,1,0,1,0,3,3,1,0,1,0,1,0,3,3,1,0,1,0
1,0,1,0,15,4,11,1,0,1,1,0,11,3,8,0,0,1,1,0,8,2,6,0
3,4,1,2,1,0,1,0,4,1,3,2,1,0,1,0,4,1,3,2,1,0,1,0
0,2,1,1,17,1,16,4,2,1,0,1,16,1,15,4,2,1,0,1,15,1,14,4
1,2,1,2,10,2,8,4,2,1,1,2,8,2,6,3,2,1,1,2,6,1,5,2
2,0,0,0,10,4,6,0,0,0,2,0,6,2,4,0,0,0,2,0,4,2,2,0
0,3,4,0,22,2,20,2,3,4,0,0,20,2,18,1,3,4,0,0,18,1,17,1
1,4,1,0,10,3,7,0,4,1,1,0,7,2,5,0,4,1,1,0,5,1,4,0
4,1,1,2,10,9,1,0,1,1,4,2,1,0,1,0,1,1,4,2,1,0,1,0
1,3,0,2,3,0,3,1,3,0,1,2,3,0,3,1,3,0,1,2,3,0,3,1
1,3,0,2,8,2,6,3,3,0,1,2,6,1,5,2,3,0,1,2,5,1,4,1
2,0,3,0,22,10,12,1,0,3,2,0,12,5,7,0,0,3,2,0,7,3,4,0
1,4,3,4,1,0,1,0,4,3,1,4,1,0,1,0,4,3,1,4,1,0,1,0
1,2,0,1,8,2,6,1,2,0,1,1,6,1,5,1,2,0,1,1,5,1,4,1
3,3,3,2,13,9,4,2,3,3,3,2,4,2,2,1,3,3,3,2,2,1,1,0
3,0,1,0,3,2,1,0,0,1,3,0,1,0,1,0,0,1,3,0,1,0,1,0
2,4,2,1,12,5,7,2,4,2,2,1,7,3,4,1,4,2,2,1,4,2,2,0
2,0,1,2,20,9,11,5,0,1,2,2,11,5,6,2,0,1,2,2,6,2,4,2
1,0,2,3,13,3,10,7,0,2,1,3,10,2,8,5,0,2,1,3,8,2,6,4
4,0,4,0,29,26,3,0,0,4,4,0,3,2,1,0,0,4,4,0,1,0,1,0
1,0,2,3,25,7,18,12,0,2,1,3,18,5,13,9,0,2,1,3,13,3,10,7
2,1,0,2,10,5,5,2,1,0,2,2,5,2,3,1,1,0,2,2,3,1,2,1
3,3,1,1,2,1,1,0,3,1,3,1,1,0,1,0,3,1,3,1,1,0,1,0
2,1,1,2,13,6,7,3,1,1,2,2,7,3,4,1,1,1,2,2,4,1,3,1
1,3,1,3,10,3,7,4,3,1,1,3,7,2,5,3,3,1,1,3,5,1,4,2
3,2,1,1,8,5,3,0,2,1,3,1,3,2,1,0,2,1,3,1,1,0,1,0
2,0,3,2,27,13,14,6,0,3,2,2,14,6,8,4,0,3,2,2,8,3,5,2
1,3,0,0,7,2,5,0,3,0,1,0,5,1,4,0,3,0,1,0,4,1,3,0
4,2,2,1,3,2,1,0,2,2,4,1,1,0,1,0,2,2,4,1,1,0,1,0
3,1,4,4,29,20,9,8,1,4,3,4,9,6,3,2,1,4,3,4,3,2,1,0
3,1,2,0,18,12,6,0,1,2,3,0,6,4,2,0,1,2,3,0,2,1,1,0
3,4,3,1,6,4,2,0,4,3,3,1,2,1,1,0,4,3,3,1,1,0,1,0
0,3,1,3,4,0,4,2,3,1,0,3,4,0,4,2,3,1,0,3,4,0,4,2
4,1,4,3,26,23,3,2,1,4,4,3,3,2,1,0,1,4,4,3,1,0,1,0
3,4,3,4,6,4,2,1,4,3,3,4,2,1,1,0,4,3,3,4,1,0,1,0
3,0,3,3,19,13,6,4,0,3,3,3,6,4,2,1,0,3,3,3,2,1,1,0
3,0,3,2,29,20,9,4,0,3,3,2,9,6,3,1,0,3,3,2,3,2,1,0
3,2,4,0,23,16,7,0,2,4,3,0,7,4,3,0,2,4,3,0,3,2,1,0
4,3,3,3,10,8,2,1,3,3,4,3,2,1,1,0,3,3,4,3,1,0,1,0
3,1,1,1,18,12,6,1,1,1,3,1,6,4,2,0,1,1,3,1,2,1,1,0
0,4,0,3,8,0,8,5,4,0,0,3,8,0,8,5,4,0,0,3,8,0,8,5
0,1,3,3,29,2,27,18,1,3,0,3,27,2,25,17,1,3,0,3,25,2,23,16
2,1,3,0,28,14,14,1,1,3,2,0,14,7,7,0,1,3,2,0,7,3,4,0
1,4,2,1,3,0,3,0,4,2,1,1,3,0,3,0,4,2,1,1,3,0,3,0
3,4,2,3,3,2,1,0,4,2,3,3,1,0,1,0,4,2,3,3,1,0,1,0
3,2,3,4,19,13,6,5,2,3,3,4,6,4,2,1,2,3,3,4,2,1,1,0
2,0,2,3,17,8,9,6,0,2,2,3,9,4,5,3,0,2,2,3,5,2,3,2
1,1,2,0,8,2,6,0,1,2,1,0,6,1,5,0,1,2,1,0,5,1,4,0
4,1,0,1,6,5,1,0,1,0,4,1,1,0,1,0,1,0,4,1,1,0,1,0
2,4,3,3,15,7,8,5,4,3,2,3,8,3,5,3,4,3,2,3,5,2,3,2
3,2,2,2,9,6,3,1,2,2,3,2,3,2,1,0,2,2,3,2,1,0,1,0
1,4,1,1,5,1,4,1,4,1,1,1,4,1,3,0,4,1,1,1,3,0,3,0
2,1,2,2,21,10,11,5,1,2,2,2,11,5,6,3,1,2,2,2,6,3,3,1
0,3,3,3,14,1,13,9,3,3,0,3,13,1,12,8,3,3,0,3,12,1,11,7
1,0,4,3,28,8,20,14,0,4,1,3,20,6,14,9,0,4,1,3,14,4,10,7
1,1,1,3,16,4,12,8,1,1,1,3,12,3,9,6,1,1,1,3,9,2,7,4
4,1,1,4,8,7,1,0,1,1,4,4,1,0,1,0,1,1,4,4,1,0,1,0
3,3,1,3,2,1,1,0,3,1,3,3,1,0,1,0,3,1,3,3,1,0,1,0
3,1,2,0,15,10,5,0,1,2,3,0,5,3,2,0,1,2,3,0,2,1,1,0
0,4,0,2,4,0,4,2,4,0,0,2,4,0,4,2,4,0,0,2,4,0,4,2
1,1,1,2,12,3,9,4,1,1,1,2,9,2,7,3,1,1,1,2,7,2,5,2
3,4,3,4,6,4,2,1,4,3,3,4,2,1,1,0,4,3,3,4,1,0,1,0
1,0,0,0,6,1,5,0,0,0,1,0,5,1,4,0,0,0,1,0,4,1,3,0
4,4,4,2,15,13,2,1,4,4,4,2,2,1,1,0,4,4,4,2,1,0,1,0
4,0,1,2,17,15,2,0,0,1,4,2,2,1,1,0,0,1,4,2,1,0,1,0
1,4,2,0,9,2,7,0,4,2,1,0,7,2,5,0,4,2,1,0,5,1,4,0
0,3,0,2,9,0,9,4,3,0,0,2,9,0,9,4,3,0,0,2,9,0,9,4
4,0,1,4,15,13,2,1,0,1,4,4,2,1,1,0,0,1,4,4,1,0,1,0
0,1,3,0,18,1,17,1,1,3,0,0,17,1,16,1,1,3,0,0,16,1,15,1
0,4,0,3,4,0,4,2,4,0,0,3,4,0,4,2,4,0,0,3,4,0,4,2
4,0,3,0,18,16,2,0,0,3,4,0,2,1,1,0,0,3,4,0,1,0,1,0
4,1,0,1,6,5,1,0,1,0,4,1,1,0,1,0,1,0,4,1,1,0,1,0
4,0,1,2,17,15,2,0,0,1,4,2,2,1,1,0,0,1,4,2,1,0,1,0
1,4,2,1,10,2,8,2,4,2,1,1,8,2,6,1,4,2,1,1,6,1,5,1
3,1,4,1,28,19,9,2,1,4,3,1,9,6,3,0,1,4,3,1,3,2,1,0
3,3,1,0,2,1,1,0,3,1,3,0,1,0,1,0,3,1,3,0,1,0,1,0
4,3,1,2,7,6,1,0,3,1,4,2,1,0,1,0,3,1,4,2,1,0,1,0
1,0,4,4,22,6,16,14,0,4,1,4,16,4,12,10,0,4,1,4,12,3,9,8
0,4,3,0,8,0,8,0,4,3,0,0,8,0,8,0,4,3,0,0,8,0,8,0
1,1,2,0,8,2,6,0,1,2,1,0,6,1,5,0,1,2,1,0,5,1,4,0
3,1,4,4,28,19,9,8,1,4,3,4,9,6,3,2,1,4,3,4,3,2,1,0
2,0,4,3,25,12,13,9,0,4,2,3,13,6,7,4,0,4,2,3,7,3,4,2
0,0,3,2,27,2,25,12,0,3,0,2,25,2,23,11,0,3,0,2,23,2,21,10
2,1,3,1,22,11,11,3,1,3,2,1,11,5,6,1,1,3,2,1,6,3,3,0
4,0,4,1,27,24,3,0,0,4,4,1,3,2,1,0,0,4,4,1,1,0,1,0
2,0,4,4,29,14,15,13,0,4,2,4,15,7,8,7,0,4,2,4,8,4,4,3
4,1,0,3,2,1,1,0,1,0,4,3,1,0,1,0,1,0,4,3,1,0,1,0
2,1,4,3,26,12,14,9,1,4,2,3,14,7,7,4,1,4,2,3,7,3,4,2
0,3,0,2,2,0,2,1,3,0,0,2,2,0,2,0,3,0,0,2,2,0,2,1
3,2,4,3,19,13,6,4,2,4,3,3,6,4,2,1,2,4,3,3,2,1,1,0
2,2,0,0,10,4,6,0,2,0,2,0,6,3,3,0,2,0,2,0,3,1,2,0
3,2,2,4,13,9,4,3,2,2,3,4,4,2,2,1,2,2,3,4,2,1,1,0
2,2,2,0,24,11,13,1,2,2,2,0,13,6,7,0,2,2,2,0,7,3,4,0
1,4,1,4,5,1,4,3,4,1,1,4,4,1,3,2,4,1,1,4,3,0,3,2
3,0,0,0,5,3,2,0,0,0,3,0,2,1,1,0,0,0,3,0,1,0,1,0
2,4,4,4,10,5,5,4,4,4,2,4,5,2,3,2,4,4,2,4,3,1,2,1
2,2,4,4,26,13,13,11,2,4,2,4,13,6,7,6,2,4,2,4,7,3,4,3
2,3,4,1,17,8,9,2,3,4,2,1,9,4,5,1,3,4,2,1,5,2,3,0
3,2,4,2,11,7,4,2,2,4,3,2,4,2,2,0,2,4,3,2,2,1,1,0
1,2,2,1,16,4,12,3,2,2,1,1,12,3,9,2,2,2,1,1,9,2,7,2
2,0,2,0,29,14,15,1,0,2,2,0,15,7,8,0,0,2,2,0,8,3,5,0
1,4,4,2,6,1,5,2,4,4,1,2,5,1,4,1,4,4,1,2,4,1,3,1
4,0,2,4,21,18,3,2,0,2,4,4,3,2,1,0,0,2,4,4,1,0,1,0
1,2,3,2,15,4,11,5,2,3,1,2,11,3,8,3,2,3,1,2,8,2,6,3
2,1,3,3,23,11,12,8,1,3,2,3,12,5,7,4,1,3,2,3,7,3,4,2
0,0,2,4,17,1,16,14,0,2,0,4,16,1,15,13,0,2,0,4,15,1,14,12
1,2,3,0,9,2,7,0,2,3,1,0,7,2,5,0,2,3,1,0,5,1,4,0
0,1,3,0,29,2,27,2,1,3,0,0,27,2,25,2,1,3,0,0,25,2,23,2
3,0,2,0,25,17,8,0,0,2,3,0,8,5,3,0,0,2,3,0,3,2,1,0
4,2,3,3,12,10,2,1,2,3,4,3,2,1,1,0,2,3,4,3,1,0,1,0
0,3,1,0,10,1,9,0,3,1,0,0,9,0,9,0,3,1,0,0,9,0,9,0
0,1,1,3,16,1,15,10,1,1,0,3,15,1,14,9,1,1,0,3,14,1,13,9
3,2,3,1,29,20,9,2,2,3,3,1,9,6,3,0,2,3,3,1,3,2,1,0
1,3,1,2,10,3,7,3,3,1,1,2,7,2,5,2,3,1,1,2,5,1,4,1
0,2,1,0,9,0,9,0,2,1,0,0,9,0,9,0,2,1,0,0,9,0,9,0
1,1,0,4,16,4,12,10,1,0,1,4,12,3,9,8,1,0,1,4,9,2,7,6
0,0,1,0,12,1,11,1,0,1,0,0,11,1,10,0,0,1,0,0,10,0,10,1
0,0,0,0,13,1,12,1,0,0,0,0,12,1,11,1,0,0,0,0,11,1,10,0
1,0,1,2,19,5,14,6,0,1,1,2,14,4,10,5,0,1,1,2,10,3,7,3
3,4,2,4,0,0,0,0,4,2,3,4,0,0,0,0,4,2,3,4,0,0,0,0
1,1,1,4,13,3,10,9,1,1,1,4,10,2,8,7,1,1,1,4,8,2,6,5
0,2,3,4,19,1,18,16,2,3,0,4,18,1,17,15,2,3,0,4,17,1,16,14
4,1,4,2,24,21,3,1,1,4,4,2,3,2,1,0,1,4,4,2,1,0,1,0
2,1,0,4,18,9,9,8,1,0,2,4,9,4,5,4,1,0,2,4,5,2,3,2
1,1,1,3,6,1,5,3,1,1,1,3,5,1,4,2,1,1,1,3,4,1,3,2
2,3,4,2,11,5,6,2,3,4,2,2,6,2,4,2,3,4,2,2,4,2,2,1
0,3,0,0,0,0,0,0,3,0,0,0,0,0,0,0,3,0,0,0,0,0,0,0
4,3,2,2,8,7,1,0,3,2,4,2,1,0,1,0,3,2,4,2,1,0,1,0
4,3,2,4,0,0,0,0,3,2,4,4,0,0,0,0,3,2,4,4,0,0,0,0
3,0,4,4,24,16,8,7,0,4,3,4,8,5,3,2,0,4,3,4,3,2,1,0
2,4,1,1,7,3,4,1,4,1,2,1,4,2,2,0,4,1,2,1,2,0,2,0
4,2,1,2,14,12,2,1,2,1,4,2,2,1,1,0,2,1,4,2,1,0,1,0
4,1,3,4,21,18,3,2,1,3,4,4,3,2,1,0,1,3,4,4,1,0,1,0
2,3,3,1,15,7,8,2,3,3,2,1,8,4,4,1,3,3,2,1,4,2,2,0
0,1,1,4,18,1,17,15,1,1,0,4,17,1,16,14,1,1,0,4,16,1,15,13
2,4,0,0,1,0,1,0,4,0,2,0,1,0,1,0,4,0,2,0,1,0,1,0
4,1,1,4,8,7,1,0,1,1,4,4,1,0,1,0,1,1,4,4,1,0,1,0
3,1,0,3,16,11,5,3,1,0,3,3,5,3,2,1,1,0,3,3,2,1,1,0
4,2,1,3,5,4,1,0,2,1,4,3,1,0,1,0,2,1,4,3,1,0,1,0
4,3,2,2,15,13,2,0,3,2,4,2,2,1,1,0,3,2,4,2,1,0,1,0
4,4,4,2,8,7,1,0,4,4,4,2,1,0,1,0,4,4,4,2,1,0,1,0
1,2,1,1,9,2,7,2,2,1,1,1,7,2,5,1,2,1,1,1,5,1,4,1
0,3,4,3,17,1,16,11,3,4,0,3,16,1,15,10,3,4,0,3,15,1,14,9
3,3,2,2,13,9,4,1,3,2,3,2,4,2,2,1,3,2,3,2,2,1,1,0
4,4,2,3,3,2,1,0,4,2,4,3,1,0,1,0,4,2,4,3,1,0,1,0
1,0,1,3,12,3,9,6,0,1,1,3,9,2,7,4,0,1,1,3,7,2,5,3
3,2,2,4,11,7,4,3,2,2,3,4,4,2,2,1,2,2,3,4,2,1,1,0
3,3,0,3,0,0,0,0,3,0,3,3,0,0,0,0,3,0,3,3,0,0,0,0
1,4,2,0,7,2,5,0,4,2,1,0,5,1,4,0,4,2,1,0,4,1,3,0
2,1,2,1,27,13,14,4,1,2,2,1,14,6,8,2,1,2,2,1,8,4,4,1
2,0,2,4,28,13,15,13,0,2,2,4,15,7,8,7,0,2,2,4,8,3,5,4
3,4,2,0,13,9,4,0,4,2,3,0,4,2,2,0,4,2,3,0,2,1,1,0
4,1,3,1,24,21,3,0,1,3,4,1,3,2,1,0,1,3,4,1,1,0,1,0
3,3,0,4,3,2,1,0,3,0,3,4,1,0,1,0,3,0,3,4,1,0,1,0
3,2,1,0,10,6,4,0,2,1,3,0,4,2,2,0,2,1,3,0,2,1,1,0
0,3,0,2,4,0,4,1,3,0,0,2,4,0,4,2,3,0,0,2,4,0,4,2
2,2,2,3,11,5,6,4,2,2,2,3,6,3,3,2,2,2,2,3,3,1,2,1
3,1,4,4,21,14,7,6,1,4,3,4,7,4,3,2,1,4,3,4,3,2,1,0
2,2,4,4,20,10,10,9,2,4,2,4,10,5,5,4,2,4,2,4,5,2,3,2
1,3,1,0,0,0,0,0,3,1,1,0,0,0,0,0,3,1,1,0,0,0,0,0
3,0,3,0,28,19,9,0,0,3,3,0,9,6,3,0,0,3,3,0,3,2,1,0
0,1,1,2,8,0,8,3,1,1,0,2,8,0,8,3,1,1,0,2,8,0,8,3
1,1,4,1,28,8,20,6,1,4,1,1,20,6,14,4,1,4,1,1,14,4,10,3
4,3,1,1,5,4,1,0,3,1,4,1,1,0,1,0,3,1,4,1,1,0,1,0
1,2,2,3,12,3,9,6,2,2,1,3,9,2,7,4,2,2,1,3,7,2,5,3
1,2,3,1,18,5,13,3,2,3,1,1,13,3,10,3,2,3,1,1,10,3,7,2
0,0,2,1,23,2,21,6,0,2,0,1,21,2,19,5,0,2,0,1,19,1,18,5
4,3,2,4,1,0,1,0,3,2,4,4,1,0,1,0,3,2,4,4,1,0,1,0
2,1,2,2,17,8,9,4,1,2,2,2,9,4,5,2,1,2,2,2,5,2,3,1
3,3,3,0,18,12,6,0,3,3,3,0,6,4,2,0,3,3,3,0,2,1,1,0
0,2,4,4,19,1,18,16,2,4,0,4,18,1,17,15,2,4,0,4,17,1,16,14
4,4,1,4,2,1,1,0,4,1,4,4,1,0,1,0,4,1,4,4,1,0,1,0
3,3,0,1,0,0,0,0,3,0,3,1,0,0,0,0,3,0,3,1,0,0,0,0
3,4,0,2,3,2,1,0,4,0,3,2,1,0,1,0,4,0,3,2,1,0,1,0
0,3,0,1,5,0,5,1,3,0,0,1,5,0,5,1,3,0,0,1,5,0,5,1
2,3,3,0,14,7,7,0,3,3,2,0,7,3,4,0,3,3,2,0,4,2,2,0
3,2,3,3,28,19,9,6,2,3,3,3,9,6,3,2,2,3,3,3,3,2,1,0
4,4,2,1,2,1,1,0,4,2,4,1,1,0,1,0,4,2,4,1,1,0,1,0
1,4,4,3,12,3,9,6,4,4,1,3,9,2,7,4,4,4,1,3,7,2,5,3
2,0,2,2,18,8,10,5,0,2,2,2,10,4,6,2,0,2,2,2,6,3,3,1
3,3,1,0,0,0,0,0,3,1,3,0,0,0,0,0,3,1,3,0,0,0,0,0
1,3,2,2,15,4,11,5,3,2,1,2,11,3,8,3,3,2,1,2,8,2,6,2
1,4,3,4,11,3,8,7,4,3,1,4,8,2,6,5,4,3,1,4,6,1,5,4
0,4,4,4,8,0,8,7,4,4,0,4,8,0,8,7,4,4,0,4,8,0,8,7
1,1,3,0,17,5,12,1,1,3,1,0,12,3,9,0,1,3,1,0,9,2,7,0
0,4,4,4,15,1,14,12,4,4,0,4,14,1,13,11,4,4,0,4,13,1,12,10
3,1,3,1,27,18,9,2,1,3,3,1,9,6,3,0,1,3,3,1,3,2,1,0
0,1,3,4,28,2,26,23,1,3,0,4,26,2,24,21,1,3,0,4,24,2,22,19
0,2,3,1,11,1,10,3,2,3,0,1,10,0,10,3,2,3,0,1,10,0,10,3
2,2,3,2,20,9,11,5,2,3,2,2,11,5,6,3,2,3,2,2,6,3,3,1
3,1,3,2,26,18,8,4,1,3,3,2,8,5,3,1,1,3,3,2,3,2,1,0
0,2,0,2,4,0,4,1,2,0,0,2,4,0,4,2,2,0,0,2,4,0,4,2
0,4,2,4,3,0,3,2,4,2,0,4,3,0,3,2,4,2,0,4,3,0,3,2
1,2,2,0,15,4,11,1,2,2,1,0,11,3,8,0,2,2,1,0,8,2,6,0
2,2,0,0,9,4,5,0,2,0,2,0,5,2,3,0,2,0,2,0,3,1,2,0
0,2,3,0,16,1,15,1,2,3,0,0,15,1,14,1,2,3,0,0,14,1,13,1
4,3,4,3,17,15,2,1,3,4,4,3,2,1,1,0,3,4,4,3,1,0,1,0
4,3,3,0,9,8,1,0,3,3,4,0,1,0,1,0,3,3,4,0,1,0,1,0
3,4,4,0,8,5,3,0,4,4,3,0,3,2,1,0,4,4,3,0,1,0,1,0
3,0,3,0,25,17,8,0,0,3,3,0,8,5,3,0,0,3,3,0,3,2,1,0
1,2,3,2,7,2,5,2,2,3,1,2,5,1,4,1,2,3,1,2,4,1,3,1
4,4,0,3,2,1,1,0,4,0,4,3,1,0,1,0,4,0,4,3,1,0,1,0
0,4,3,0,8,0,8,0,4,3,0,0,8,0,8,0,4,3,0,0,8,0,8,0
3,0,2,0,22,15,7,0,0,2,3,0,7,4,3,0,0,2,3,0,3,2,1,0
4,4,4,0,4,3,1,0,4,4,4,0,1,0,1,0,4,4,4,0,1,0,1,0
0,4,0,0,1,0,1,0,4,0,0,0,1,0,1,0,4,0,0,0,1,0,1,0
4,1,4,4,26,23,3,2,1,4,4,4,3,2,1,0,1,4,4,4,1,0,1,0
3,4,1,3,1,0,1,0,4,1,3,3,1,0,1,0,4,1,3,3,1,0,1,0
1,3,3,1,13,3,10,2,3,3,1,1,10,3,7,2,3,3,1,1,7,2,5,1
2,3,0,0,7,3,4,0,3,0,2,0,4,2,2,0,3,0,2,0,2,1,1,0
1,4,1,2,2,0,2,1,4,1,1,2,2,0,2,1,4,1,1,2,2,0,2,0
2,4,1,1,1,0,1,0,4,1,2,1,1,0,1,0,4,1,2,1,1,0,1,0
3,3,2,0,11,7,4,0,3,2,3,0,4,2,2,0,3,2,3,0,2,1,1,0
2,0,2,0,21,10,11,1,0,2,2,0,11,5,6,0,0,2,2,0,6,2,4,0
0,4,4,1,14,1,13,3,4,4,0,1,13,1,12,3,4,4,0,1,12,1,11,3
1,0,3,3,23,6,17,11,0,3,1,3,17,5,12,8,0,3,1,3,12,3,9,6
3,3,2,2,7,4,3,1,3,2,3,2,3,2,1,0,3,2,3,2,1,0,1,0
3,2,3,2,22,15,7,3,2,3,3,2,7,4,3,1,2,3,3,2,3,2,1,0
3,1,1,4,2,1,1,0,1,1,3,4,1,0,1,0,1,1,3,4,1,0,1,0
2,4,1,1,13,6,7,2,4,1,2,1,7,3,4,1,4,1,2,1,4,1,3,0
0,4,3,0,3,0,3,0,4,3,0,0,3,0,3,0,4,3,0,0,3,0,3,0
0,4,0,2,3,0,3,1,4,0,0,2,3,0,3,1,4,0,0,2,3,0,3,1
3,4,1,3,0,0,0,0,4,1,3,3,0,0,0,0,4,1,3,3,0,0,0,0
4,0,4,2,26,23,3,1,0,4,4,2,3,2,1,0,0,4,4,2,1,0,1,0
2,1,3,2,18,9,9,4,1,3,2,2,9,4,5,2,1,3,2,2,5,2,3,1
4,1,1,2,4,3,1,0,1,1,4,2,1,0,1,0,1,1,4,2,1,0,1,0
2,3,2,1,8,4,4,1,3,2,2,1,4,1,3,0,3,2,2,1,3,1,2,0
3,2,0,0,7,4,3,0,2,0,3,0,3,2,1,0,2,0,3,0,1,0,1,0
0,4,1,2,6,0,6,2,4,1,0,2,6,0,6,3,4,1,0,2,6,0,6,3
1,0,0,3,4,1,3,2,0,0,1,3,3,0,3,2,0,0,1,3,3,0,3,2
0,1,0,2,7,0,7,3,1,0,0,2,7,0,7,3,1,0,0,2,7,0,7,3
3,3,2,4,7,4,3,2,3,2,3,4,3,2,1,0,3,2,3,4,1,0,1,0
1,3,2,2,6,1,5,2,3,2,1,2,5,1,4,1,3,2,1,2,4,1,3,1
1,2,0,4,6,1,5,4,2,0,1,4,5,1,4,3,2,0,1,4,4,1,3,2
2,0,0,1,4,2,2,0,0,0,2,1,2,0,2,0,0,0,2,1,2,0,2,0
1,1,4,0,19,5,14,1,1,4,1,0,14,4,10,1,1,4,1,0,10,3,7,0
0,1,4,0,25,2,23,2,1,4,0,0,23,2,21,2,1,4,0,0,21,2,19,1
3,3,3,2,14,9,5,2,3,3,3,2,5,3,2,1,3,3,3,2,2,1,1,0
2,1,0,3,4,2,2,1,1,0,2,3,2,0,2,1,1,0,2,3,2,1,1,0
3,4,4,4,9,6,3,2,4,4,3,4,3,2,1,0,4,4,3,4,1,0,1,0
4,3,3,3,4,3,1,0,3,3,4,3,1,0,1,0,3,3,4,3,1,0,1,0
3,2,4,4,16,11,5,4,2,4,3,4,5,3,2,1,2,4,3,4,2,1,1,0
1,4,4,0,0,0,0,0,4,4,1,0,0,0,0,0,4,4,1,0,0,0,0,0
4,1,3,4,28,25,3,2,1,3,4,4,3,2,1,0,1,3,4,4,1,0,1,0
0,2,0,0,6,0,6,0,2,0,0,0,6,0,6,0,2,0,0,0,6,0,6,0
4,0,2,3,20,18,2,1,0,2,4,3,2,1,1,0,0,2,4,3,1,0,1,0
2,4,0,4,0,0,0,0,4,0,2,4,0,0,0,0,4,0,2,4,0,0,0,0
4,4,1,0,10,9,1,0,4,1,4,0,1,0,1,0,4,1,4,0,1,0,1,0
1,4,1,0,3,0,3,0,4,1,1,0,3,0,3,0,4,1,1,0,3,0,3,0
3,3,1,2,18,12,6,2,3,1,3,2,6,4,2,0,3,1,3,2,2,1,1,0
3,3,2,3,4,2,2,1,3,2,3,3,2,1,1,0,3,2,3,3,1,0,1,0
1,2,0,1,5,1,4,1,2,0,1,1,4,1,3,0,2,0,1,1,3,0,3,0
4,1,4,4,27,24,3,2,1,4,4,4,3,2,1,0,1,4,4,4,1,0,1,0
0,4,0,1,1,0,1,0,4,0,0,1,1,0,1,0,4,0,0,1,1,0,1,0
3,2,3,3,23,16,7,4,2,3,3,3,7,4,3,2,2,3,3,3,3,2,1,0
4,4,3,3,1,0,1,0,4,3,4,3,1,0,1,0,4,3,4,3,1,0,1,0
1,4,4,3,5,1,4,2,4,4,1,3,4,1,3,2,4,4,1,3,3,0,3,2
0,4,0,1,4,0,4,1,4,0,0,1,4,0,4,1,4,0,0,1,4,0,4,1
4,3,4,4,16,14,2,1,3,4,4,4,2,1,1,0,3,4,4,4,1,0,1,0
1,2,0,0,4,1,3,0,2,0,1,0,3,0,3,0,2,0,1,0,3,0,3,0
1,2,2,4,13,3,10,9,2,2,1,4,10,2,8,7,2,2,1,4,8,2,6,5
2,1,2,0,25,12,13,1,1,2,2,0,13,6,7,0,1,2,2,0,7,3,4,0
3,2,4,1,23,16,7,2,2,4,3,1,7,4,3,0,2,4,3,1,3,2,1,0
4,3,3,1,10,8,2,0,3,3,4,1,2,1,1,0,3,3,4,1,1,0,1,0
4,3,0,4,1,0,1,0,3,0,4,4,1,0,1,0,3,0,4,4,1,0,1,0
0,0,4,0,26,2,24,2,0,4,0,0,24,2,22,2,0,4,0,0,22,2,20,1
2,1,4,4,25,12,13,11,1,4,2,4,13,6,7,6,1,4,2,4,7,3,4,3
0,0,4,3,28,2,26,18,0,4,0,3,26,2,24,16,0,4,0,3,24,2,22,15
0,1,3,4,26,2,24,21,1,3,0,4,24,2,22,19,1,3,0,4,22,2,20,18
2,1,4,2,27,13,14,6,1,4,2,2,14,7,7,3,1,4,2,2,7,3,4,2
3,1,2,2,15,10,5,2,1,2,3,2,5,3,2,1,1,2,3,2,2,1,1,0
4,1,0,0,0,0,0,0,1,0,4,0,0,0,0,0,1,0,4,0,0,0,0,0
0,3,3,2,16,1,15,7,3,3,0,2,15,1,14,6,3,3,0,2,14,1,13,6
2,1,4,1,17,8,9,2,1,4,2,1,9,4,5,1,1,4,2,1,5,2,3,0
4,1,0,1,10,8,2,0,1,0,4,1,2,1,1,0,1,0,4,1,1,0,1,0
0,3,3,0,21,2,19,1,3,3,0,0,19,1,18,1,3,3,0,0,18,1,17,1
4,0,3,0,27,24,3,0,0,3,4,0,3,2,1,0,0,3,4,0,1,0,1,0
4,3,0,0,4,3,1,0,3,0,4,0,1,0,1,0,3,0,4,0,1,0,1,0
3,2,0,3,6,4,2,1,2,0,3,3,2,1,1,0,2,0,3,3,1,0,1,0
4,0,4,4,24,21,3,2,0,4,4,4,3,2,1,0,0,4,4,4,1,0,1,0
4,4,2,0,1,0,1,0,4,2,4,0,1,0,1,0,4,2,4,0,1,0,1,0
2,3,0,1,22,11,11,3,3,0,2,1,11,5,6,1,3,0,2,1,6,3,3,0
4,3,1,4,10,9,1,0,3,1,4,4,1,0,1,0,3,1,4,4,1,0,1,0
2,0,0,3,5,2,3,2,0,0,2,3,3,1,2,1,0,0,2,3,2,1,1,0
4,3,1,4,9,8,1,0,3,1,4,4,1,0,1,0,3,1,4,4,1,0,1,0
4,0,3,4,26,23,3,2,0,3,4,4,3,2,1,0,0,3,4,4,1,0,1,0
0,2,2,4,13,1,12,10,2,2,0,4,12,1,11,9,2,2,0,4,11,1,10,8
1,2,0,1,7,2,5,1,2,0,1,1,5,1,4,1,2,0,1,1,4,1,3,0
4,4,4,0,4,3,1,0,4,4,4,0,1,0,1,0,4,4,4,0,1,0,1,0
4,4,3,0,1,0,1,0,4,3,4,0,1,0,1,0,4,3,4,0,1,0,1,0
2,2,1,4,26,12,14,12,2,1,2,4,14,6,8,7,2,1,2,4,8,3,5,4
4,1,2,4,17,15,2,1,1,2,4,4,2,1,1,0,1,2,4,4,1,0,1,0
2,4,1,3,7,3,4,2,4,1,2,3,4,1,3,2,4,1,2,3,3,1,2,1
2,0,0,2,10,4,6,3,0,0,2,2,6,2,4,1,0,0,2,2,4,1,3,1
1,2,3,3,18,5,13,9,2,3,1,3,13,3,10,6,2,3,1,3,10,3,7,4
0,3,4,1,8,0,8,2,3,4,0,1,8,0,8,2,3,4,0,1,8,0,8,2
0,3,2,4,9,0,9,8,3,2,0,4,9,0,9,8,3,2,0,4,9,0,9,8
4,0,1,2,20,18,2,0,0,1,4,2,2,1,1,0,0,1,4,2,1,0,1,0
1,4,2,3,8,2,6,4,4,2,1,3,6,1,5,3,4,2,1,3,5,1,4,2
3,4,4,1,12,8,4,1,4,4,3,1,4,2,2,0,4,4,3,1,2,1,1,0
0,1,4,4,23,2,21,18,1,4,0,4,21,2,19,17,1,4,0,4,19,1,18,16
3,1,4,2,21,14,7,3,1,4,3,2,7,4,3,1,1,4,3,2,3,2,1,0
4,2,4,0,22,19,3,0,2,4,4,0,3,2,1,0,2,4,4,0,1,0,1,0
4,4,3,2,7,6,1,0,4,3,4,2,1,0,1,0,4,3,4,2,1,0,1,0
4,4,3,1,1,0,1,0,4,3,4,1,1,0,1,0,4,3,4,1,1,0,1,0
3,0,0,0,5,3,2,0,0,0,3,0,2,1,1,0,0,0,3,0,1,0,1,0
1,1,3,1,22,6,16,4,1,3,1,1,16,4,12,3,1,3,1,1,12,3,9,2
4,2,0,0,4,3,1,0,2,0,4,0,1,0,1,0,2,0,4,0,1,0,1,0
3,4,2,4,8,5,3,2,4,2,3,4,3,2,1,0,4,2,3,4,1,0,1,0
0,0,1,1,18,1,17,5,0,1,0,1,17,1,16,4,0,1,0,1,16,1,15,4
1,0,3,2,27,8,19,9,0,3,1,2,19,5,14,7,0,3,1,2,14,4,10,5
2,1,3,1,25,12,13,3,1,3,2,1,13,6,7,2,1,3,2,1,7,3,4,1
3,3,2,3,8,5,3,2,3,2,3,3,3,2,1,0,3,2,3,3,1,0,1,0
0,1,1,4,18,1,17,15,1,1,0,4,17,1,16,14,1,1,0,4,16,1,15,13
4,1,2,4,17,15,2,1,1,2,4,4,2,1,1,0,1,2,4,4,1,0,1,0
2,3,2,4,8,4,4,3,3,2,2,4,4,2,2,1,3,2,2,4,2,1,1,0
0,1,0,4,9,0,9,8,1,0,0,4,9,0,9,8,1,0,0,4,9,0,9,8
4,1,4,4,27,24,3,2,1,4,4,4,3,2,1,0,1,4,4,4,1,0,1,0
0,3,2,1,7,0,7,2,3,2,0,1,7,0,7,2,3,2,0,1,7,0,7,2
1,1,1,2,20,6,14,6,1,1,1,2,14,4,10,4,1,1,1,2,10,2,8,3
3,4,2,3,4,2,2,1,4,2,3,3,2,1,1,0,4,2,3,3,1,0,1,0
2,3,1,1,6,2,4,1,3,1,2,1,4,2,2,0,3,1,2,1,2,0,2,0
4,2,2,3,10,9,1,0,2,2,4,3,1,0,1,0,2,2,4,3,1,0,1,0
0,0,2,3,26,2,24,16,0,2,0,3,24,2,22,15,0,2,0,3,22,2,20,13
1,2,1,3,16,4,12,8,2,1,1,3,12,3,9,6,2,1,1,3,9,2,7,4
2,0,4,0,27,13,14,1,0,4,2,0,14,6,8,0,0,4,2,0,8,3,5,0
4,2,2,0,17,15,2,0,2,2,4,0,2,1,1,0,2,2,4,0,1,0,1,0
1,3,0,4,5,1,4,3,3,0,1,4,4,1,3,2,3,0,1,4,3,0,3,2
1,0,3,2,29,8,21,10,0,3,1,2,21,6,15,7,0,3,1,2,15,4,11,5
4,4,3,2,11,9,2,1,4,3,4,2,2,1,1,0,4,3,4,2,1,0,1,0
4,3,4,0,18,16,2,0,3,4,4,0,2,1,1,0,3,4,4,0,1,0,1,0
0,0,4,0,25,2,23,2,0,4,0,0,23,2,21,2,0,4,0,0,21,2,19,1
3,0,2,1,26,18,8,2,0,2,3,1,8,5,3,0,0,2,3,1,3,2,1,0
3,4,4,1,8,5,3,0,4,4,3,1,3,2,1,0,4,4,3,1,1,0,1,0
2,2,3,0,21,10,11,1,2,3,2,0,11,5,6,0,2,3,2,0,6,3,3,0
4,4,0,3,11,9,2,1,4,0,4,3,2,1,1,0,4,0,4,3,1,0,1,0
0,1,3,4,28,2,26,23,1,3,0,4,26,2,24,21,1,3,0,4,24,2,22,19
2,3,4,4,16,7,9,8,3,4,2,4,9,4,5,4,3,4,2,4,5,2,3,2
3,4,3,3,7,4,3,2,4,3,3,3,3,2,1,0,4,3,3,3,1,0,1,0
1,4,1,2,0,0,0,0,4,1,1,2,0,0,0,0,4,1,1,2,0,0,0,0
0,1,4,3,29,2,27,18,1,4,0,3,27,2,25,17,1,4,0,3,25,2,23,16
4,0,2,0,25,22,3,0,0,2,4,0,3,2,1,0,0,2,4,0,1,0,1,0
2,2,3,3,5,2,3,2,2,3,2,3,3,1,2,1,2,3,2,3,2,0,2,1
0,2,1,2,5,0,5,2,2,1,0,2,5,0,5,2,2,1,0,2,5,0,5,2
1,0,0,0,7,2,5,0,0,0,1,0,5,1,4,0,0,0,1,0,4,1,3,0
2,2,4,1,13,6,7,2,2,4,2,1,7,3,4,1,2,4,2,1,4,1,3,0
2,2,3,4,18,8,10,8,2,3,2,4,10,4,6,5,2,3,2,4,6,2,4,3
4,2,4,2,18,16,2,1,2,4,4,2,2,1,1,0,2,4,4,2,1,0,1,0
2,2,4,1,28,13,15,4,2,4,2,1,15,7,8,2,2,4,2,1,8,4,4,1
2,2,0,3,9,4,5,3,2,0,2,3,5,2,3,2,2,0,2,3,3,1,2,1
3,3,0,4,4,2,2,1,3,0,3,4,2,1,1,0,3,0,3,4,1,0,1,0
0,0,3,3,29,2,27,18,0,3,0,3,27,2,25,17,0,3,0,3,25,2,23,16
3,2,2,1,19,13,6,1,2,2,3,1,6,4,2,0,2,2,3,1,2,1,1,0
3,1,3,2,25,17,8,4,1,3,3,2,8,5,3,1,1,3,3,2,3,2,1,0
2,1,0,3,11,5,6,4,1,0,2,3,6,3,3,2,1,0,2,3,3,1,2,1
4,2,0,4,6,5,1,0,2,0,4,4,1,0,1,0,2,0,4,4,1,0,1,0
4,2,1,3,4,3,1,0,2,1,4,3,1,0,1,0,2,1,4,3,1,0,1,0
3,1,3,3,25,17,8,5,1,3,3,3,8,5,3,2,1,3,3,3,3,2,1,0
3,3,1,2,5,3,2,0,3,1,3,2,2,1,1,0,3,1,3,2,1,0,1,0
0,1,1,2,9,0,9,4,1,1,0,2,9,0,9,4,1,1,0,2,9,0,9,4
3,0,2,2,20,13,7,3,0,2,3,2,7,4,3,1,0,2,3,2,3,2,1,0
0,1,3,0,26,2,24,2,1,3,0,0,24,2,22,2,1,3,0,0,22,2,20,2
0,3,2,3,9,0,9,6,3,2,0,3,9,0,9,6,3,2,0,3,9,0,9,6
2,4,2,1,3,1,2,0,4,2,2,1,2,1,1,0,4,2,2,1,1,0,1,0
3,2,1,4,1,0,1,0,2,1,3,4,1,0,1,0,2,1,3,4,1,0,1,0
0,4,4,2,11,1,10,5,4,4,0,2,10,0,10,4,4,4,0,2,10,0,10,4
0,4,4,2,9,0,9,4,4,4,0,2,9,0,9,4,4,4,0,2,9,0,9,4
4,2,0,0,2,1,1,0,2,0,4,0,1,0,1,0,2,0,4,0,1,0,1,0
3,4,2,3,1,0,1,0,4,2,3,3,1,0,1,0,4,2,3,3,1,0,1,0
0,3,1,1,9,0,9,2,3,1,0,1,9,0,9,2,3,1,0,1,9,0,9,2
3,1,2,1,17,11,6,1,1,2,3,1,6,4,2,0,1,2,3,1,2,1,1,0
3,3,3,2,13,9,4,2,3,3,3,2,4,2,2,0,3,3,3,2,2,1,1,0
4,1,4,1,24,21,3,0,1,4,4,1,3,2,1,0,1,4,4,1,1,0,1,0
3,4,3,1,6,4,2,0,4,3,3,1,2,1,1,0,4,3,3,1,1,0,1,0
2,2,2,4,9,4,5,4,2,2,2,4,5,2,3,2,2,2,2,4,3,1,2,1
1,2,1,1,2,0,2,0,2,1,1,1,2,0,2,0,2,1,1,1,2,0,2,0
1,1,0,1,6,1,5,1,1,0,1,1,5,1,4,1,1,0,1,1,4,1,3,0
0,2,2,1,13,1,12,3,2,2,0,1,12,1,11,3,2,2,0,1,11,1,10,2
1,3,4,4,16,4,12,10,3,4,1,4,12,3,9,8,3,4,1,4,9,2,7,6
2,4,0,0,2,0,2,0,4,0,2,0,2,1,1,0,4,0,2,0,1,0,1,0
4,1,3,2,22,19,3,1,1,3,4,2,3,2,1,0,1,3,4,2,1,0,1,0
3,4,1,0,4,2,2,0,4,1,3,0,2,1,1,0,4,1,3,0,1,0,1,0
2,4,4,3,5,2,3,2,4,4,2,3,3,1,2,1,4,4,2,3,2,1,1,0
4,4,0,3,4,3,1,0,4,0,4,3,1,0,1,0,4,0,4,3,1,0,1,0
3,2,4,1,24,16,8,2,2,4,3,1,8,5,3,0,2,4,3,1,3,2,1,0
1,4,4,3,13,3,10,7,4,4,1,3,10,3,7,4,4,4,1,3,7,2,5,3
0,3,0,0,8,0,8,0,3,0,0,0,8,0,8,0,3,0,0,0,8,0,8,0
1,0,3,4,26,7,19,17,0,3,1,4,19,5,14,12,0,3,1,4,14,4,10,8
3,1,2,0,24,16,8,0,1,2,3,0,8,5,3,0,1,2,3,0,3,2,1,0
1,0,0,1,6,1,5,1,0,0,1,1,5,1,4,1,0,0,1,1,4,1,3,0
3,4,2,3,2,1,1,0,4,2,3,3,1,0,1,0,4,2,3,3,1,0,1,0
4,1,4,1,28,25,3,0,1,4,4,1,3,2,1,0,1,4,4,1,1,0,1,0
0,4,1,3,7,0,7,4,4,1,0,3,7,0,7,4,4,1,0,3,7,0,7,4
3,2,0,4,3,2,1,0,2,0,3,4,1,0,1,0,2,0,3,4,1,0,1,0
0,0,0,4,3,0,3,2,0,0,0,4,3,0,3,2,0,0,0,4,3,0,3,2
1,3,3,1,0,0,0,0,3,3,1,1,0,0,0,0,3,3,1,1,0,0,0,0
3,3,2,3,5,3,2,1,3,2,3,3,2,1,1,0,3,2,3,3,1,0,1,0
2,4,3,2,14,6,8,3,4,3,2,2,8,4,4,1,4,3,2,2,4,1,3,1
2,0,3,4,25,12,13,11,0,3,2,4,13,6,7,6,0,3,2,4,7,3,4,3
3,3,4,1,19,13,6,1,3,4,3,1,6,4,2,0,3,4,3,1,2,1,1,0
0,2,3,2,12,1,11,5,2,3,0,2,11,1,10,5,2,3,0,2,10,0,10,5
2,4,0,3,8,3,5,3,4,0,2,3,5,2,3,2,4,0,2,3,3,1,2,1
2,0,4,3,29,14,15,10,0,4,2,3,15,7,8,5,0,4,2,3,8,4,4,2
0,0,4,0,27,2,25,2,0,4,0,0,25,2,23,2,0,4,0,0,23,2,21,2
0,3,2,1,7,0,7,2,3,2,0,1,7,0,7,2,3,2,0,1,7,0,7,2
4,2,4,4,18,16,2,1,2,4,4,4,2,1,1,0,2,4,4,4,1,0,1,0
2,3,0,1,0,0,0,0,3,0,2,1,0,0,0,0,3,0,2,1,0,0,0,0
2,3,2,1,14,6,8,2,3,2,2,1,8,4,4,1,3,2,2,1,4,2,2,0
4,3,3,0,15,13,2,0,3,3,4,0,2,1,1,0,3,3,4,0,1,0,1,0
3,2,4,2,21,14,7,3,2,4,3,2,7,4,3,1,2,4,3,2,3,2,1,0
2,3,0,1,5,2,3,0,3,0,2,1,3,1,2,0,3,0,2,1,2,0,2,0
2,0,2,2,27,13,14,6,0,2,2,2,14,7,7,3,0,2,2,2,7,3,4,1
1,2,2,4,18,5,13,11,2,2,1,4,13,3,10,9,2,2,1,4,10,2,8,7
2,4,0,0,0,0,0,0,4,0,2,0,0,0,0,0,4,0,2,0,0,0,0,0
3,2,1,3,3,2,1,0,2,1,3,3,1,0,1,0,2,1,3,3,1,0,1,0
4,3,1,3,6,5,1,0,3,1,4,3,1,0,1,0,3,1,4,3,1,0,1,0
2,4,0,2,2,1,1,0,4,0,2,2,1,0,1,0,4,0,2,2,1,0,1,0
0,2,1,1,2,0,2,0,2,1,0,1,2,0,2,0,2,1,0,1,2,0,2,0
3,2,0,2,9,6,3,1,2,0,3,2,3,2,1,0,2,0,3,2,1,0,1,0
2,2,0,4,13,6,7,6,2,0,2,4,7,3,4,3,2,0,2,4,4,1,3,2
3,1,1,2,19,13,6,2,1,1,3,2,6,4,2,0,1,1,3,2,2,1,1,0
1,2,2,3,17,5,12,8,2,2,1,3,12,3,9,6,2,2,1,3,9,2,7,4
4,1,4,1,27,24,3,0,1,4,4,1,3,2,1,0,1,4,4,1,1,0,1,0
2,3,3,0,10,4,6,0,3,3,2,0,6,2,4,0,3,3,2,0,4,2,2,0
2,2,1,4,13,6,7,6,2,1,2,4,7,3,4,3,2,1,2,4,4,1,3,2
4,1,2,4,21,18,3,2,1,2,4,4,3,2,1,0,1,2,4,4,1,0,1,0
3,1,3,0,22,15,7,0,1,3,3,0,7,4,3,0,1,3,3,0,3,2,1,0
2,2,0,2,12,5,7,3,2,0,2,2,7,3,4,2,2,0,2,2,4,2,2,1
0,1,1,0,17,1,16,1,1,1,0,0,16,1,15,1,1,1,0,0,15,1,14,1
2,3,4,3,19,9,10,7,3,4,2,3,10,4,6,4,3,4,2,3,6,2,4,2
1,2,3,2,29,8,21,10,2,3,1,2,21,6,15,7,2,3,1,2,15,4,11,5
3,1,3,4,16,11,5,4,1,3,3,4,5,3,2,1,1,3,3,4,2,1,1,0
4,1,1,0,15,13,2,0,1,1,4,0,2,1,1,0,1,1,4,0,1,0,1,0
1,1,3,1,26,7,19,5,1,3,1,1,19,5,14,4,1,3,1,1,14,4,10,2
3,4,0,3,1,0,1,0,4,0,3,3,1,0,1,0,4,0,3,3,1,0,1,0
1,0,4,3,29,8,21,14,0,4,1,3,21,6,15,10,0,4,1,3,15,4,11,7
0,1,4,1,23,2,21,6,1,4,0,1,21,2,19,5,1,4,0,1,19,1,18,5
3,2,4,0,29,20,9,0,2,4,3,0,9,6,3,0,2,4,3,0,3,2,1,0
4,0,1,1,17,15,2,0,0,1,4,1,2,1,1,0,0,1,4,1,1,0,1,0
2,3,0,3,5,2,3,2,3,0,2,3,3,1,2,1,3,0,2,3,2,0,2,1
2,4,3,4,8,4,4,3,4,3,2,4,4,1,3,2,4,3,2,4,3,1,2,1
4,0,4,2,27,24,3,1,0,4,4,2,3,2,1,0,0,4,4,2,1,0,1,0
3,2,2,2,12,8,4,1,2,2,3,2,4,2,2,1,2,2,3,2,2,1,1,0
1,4,4,4,6,1,5,4,4,4,1,4,5,1,4,3,4,4,1,4,4,1,3,2
0,3,4,3,13,1,12,8,3,4,0,3,12,1,11,7,3,4,0,3,11,1,10,7
3,2,0,3,2,1,1,0,2,0,3,3,1,0,1,0,2,0,3,3,1,0,1,0
4,0,1,2,11,9,2,1,0,1,4,2,2,1,1,0,0,1,4,2,1,0,1,0
1,3,2,3,15,4,11,7,3,2,1,3,11,3,8,5,3,2,1,3,8,2,6,4
1,0,0,1,8,2,6,1,0,0,1,1,6,1,5,1,0,0,1,1,5,1,4,1
3,2,0,1,9,6,3,0,2,0,3,1,3,2,1,0,2,0,3,1,1,0,1,0
0,1,0,1,3,0,3,0,1,0,0,1,3,0,3,0,1,0,0,1,3,0,3,0
4,0,3,1,26,23,3,0,0,3,4,1,3,2,1,0,0,3,4,1,1,0,1,0
2,1,0,3,12,6,6,4,1,0,2,3,6,3,3,2,1,0,2,3,3,1,2,1
0,2,3,1,15,1,14,4,2,3,0,1,14,1,13,3,2,3,0,1,13,1,12,3
0,0,2,3,24,2,22,15,0,2,0,3,22,2,20,14,0,2,0,3,20,2,18,12
4,4,3,1,5,4,1,0,4,3,4,1,1,0,1,0,4,3,4,1,1,0,1,0
4,0,4,3,27,24,3,2,0,4,4,3,3,2,1,0,0,4,4,3,1,0,1,0
3,1,3,4,26,18,8,7,1,3,3,4,8,5,3,2,1,3,3,4,3,2,1,0
4,3,1,0,9,8,1,0,3,1,4,0,1,0,1,0,3,1,4,0,1,0,1,0
2,4,2,0,3,1,2,0,4,2,2,0,2,0,2,0,4,2,2,0,2,1,1,0
2,4,0,3,0,0,0,0,4,0,2,3,0,0,0,0,4,0,2,3,0,0,0,0
3,1,2,2,17,11,6,2,1,2,3,2,6,4,2,0,1,2,3,2,2,1,1,0
1,2,0,0,16,4,12,1,2,0,1,0,12,3,9,0,2,0,1,0,9,2,7,0
4,0,3,2,23,20,3,1,0,3,4,2,3,2,1,0,0,3,4,2,1,0,1,0
2,0,4,0,29,14,15,1,0,4,2,0,15,7,8,0,0,4,2,0,8,3,5,0
2,0,4,4,27,13,14,12,0,4,2,4,14,6,8,7,0,4,2,4,8,4,4,3
0,4,3,1,12,1,11,3,4,3,0,1,11,1,10,2,4,3,0,1,10,1,9,2
0,1,3,4,19,1,18,16,1,3,0,4,18,1,17,15,1,3,0,4,17,1,16,14
1,4,4,4,2,0,2,1,4,4,1,4,2,0,2,1,4,4,1,4,2,0,2,1
0,2,3,4,14,1,13,11,2,3,0,4,13,1,12,10,2,3,0,4,12,1,11,9
0,2,0,3,6,0,6,4,2,0,0,3,6,0,6,4,2,0,0,3,6,0,6,4
3,3,1,2,2,1,1,0,3,1,3,2,1,0,1,0,3,1,3,2,1,0,1,0
2,2,1,3,9,4,5,3,2,1,2,3,5,2,3,2,2,1,2,3,3,1,2,1
0,2,0,2,8,0,8,3,2,0,0,2,8,0,8,4,2,0,0,2,8,0,8,4
2,2,4,4,17,8,9,8,2,4,2,4,9,4,5,4,2,4,2,4,5,2,3,2
4,0,1,3,12,10,2,1,0,1,4,3,2,1,1,0,0,1,4,3,1,0,1,0
3,0,3,3,18,12,6,4,0,3,3,3,6,4,2,1,0,3,3,3,2,1,1,0
1,3,3,3,14,4,10,7,3,3,1,3,10,2,8,5,3,3,1,3,8,2,6,4
0,4,4,2,10,1,9,4,4,4,0,2,9,0,9,4,4,4,0,2,9,0,9,4
3,2,4,1,29,20,9,2,2,4,3,1,9,6,3,0,2,4,3,1,3,2,1,0
3,4,1,4,12,8,4,3,4,1,3,4,4,2,2,1,4,1,3,4,2,1,1,0
1,1,2,4,24,7,17,15,1,2,1,4,17,5,12,10,1,2,1,4,12,3,9,8
3,2,3,3,15,10,5,3,2,3,3,3,5,3,2,1,2,3,3,3,2,1,1,0
0,3,1,4,5,0,5,4,3,1,0,4,5,0,5,4,3,1,0,4,5,0,5,4
1,4,1,3,0,0,0,0,4,1,1,3,0,0,0,0,4,1,1,3,0,0,0,0
3,0,2,4,24,16,8,7,0,2,3,4,8,5,3,2,0,2,3,4,3,2,1,0
0,2,0,4,1,0,1,0,2,0,0,4,1,0,1,0,2,0,0,4,1,0,1,0
0,2,4,0,22,2,20,1,2,4,0,0,20,1,19,1,2,4,0,0,19,1,18,1
0,4,2,2,5,0,5,2,4,2,0,2,5,0,5,2,4,2,0,2,5,0,5,2
3,1,4,0,23,16,7,0,1,4,3,0,7,4,3,0,1,4,3,0,3,2,1,0
4,2,4,1,19,17,2,0,2,4,4,1,2,1,1,0,2,4,4,1,1,0,1,0
2,1,4,4,22,11,11,9,1,4,2,4,11,5,6,5,1,4,2,4,6,2,4,3
4,1,1,0,3,2,1,0,1,1,4,0,1,0,1,0,1,1,4,0,1,0,1,0
4,0,0,1,7,6,1,0,0,0,4,1,1,0,1,0,0,0,4,1,1,0,1,0
0,1,3,3,29,2,27,18,1,3,0,3,27,2,25,17,1,3,0,3,25,2,23,16
1,3,2,3,16,4,12,8,3,2,1,3,12,3,9,6,3,2,1,3,9,2,7,4
4,0,3,2,28,25,3,1,0,3,4,2,3,2,1,0,0,3,4,2,1,0,1,0
4,3,1,0,13,11,2,0,3,1,4,0,2,1,1,0,3,1,4,0,1,0,1,0
3,0,2,2,17,11,6,3,0,2,3,2,6,4,2,0,0,2,3,2,2,1,1,0
1,3,1,4,10,3,7,6,3,1,1,4,7,2,5,4,3,1,1,4,5,1,4,3
1,2,0,1,1,0,1,0,2,0,1,1,1,0,1,0,2,0,1,1,1,0,1,0
3,2,2,3,17,11,6,4,2,2,3,3,6,4,2,1,2,2,3,3,2,1,1,0
2,1,0,1,7,3,4,1,1,0,2,1,4,2,2,0,1,0,2,1,2,0,2,0
2,3,0,4,7,3,4,3,3,0,2,4,4,2,2,1,3,0,2,4,2,0,2,1
3,2,3,0,20,14,6,0,2,3,3,0,6,4,2,0,2,3,3,0,2,1,1,0
0,3,4,4,22,2,20,17,3,4,0,4,20,1,19,17,3,4,0,4,19,1,18,16
1,2,0,1,1,0,1,0,2,0,1,1,1,0,1,0,2,0,1,1,1,0,1,0
0,2,4,4,21,2,19,17,2,4,0,4,19,1,18,16,2,4,0,4,18,1,17,15
3,0,1,4,16,11,5,4,0,1,3,4,5,3,2,1,0,1,3,4,2,1,1,0
4,0,4,1,29,26,3,0,0,4,4,1,3,2,1,0,0,4,4,1,1,0,1,0
2,0,2,2,22,11,11,5,0,2,2,2,11,5,6,3,0,2,2,2,6,3,3,1
2,3,4,2,9,4,5,2,3,4,2,2,5,2,3,1,3,4,2,2,3,1,2,0
0,4,2,4,12,1,11,9,4,2,0,4,11,1,10,8,4,2,0,4,10,1,9,8
3,2,2,4,22,15,7,6,2,2,3,4,7,4,3,2,2,2,3,4,3,2,1,0
1,1,4,2,14,4,10,4,1,4,1,2,10,3,7,3,1,4,1,2,7,2,5,2
0,4,3,3,0,0,0,0,4,3,0,3,0,0,0,0,4,3,0,3,0,0,0,0
3,0,4,2,28,19,9,4,0,4,3,2,9,6,3,1,0,4,3,2,3,2,1,0
3,1,4,3,27,18,9,6,1,4,3,3,9,6,3,2,1,4,3,3,3,2,1,0
0,2,2,2,12,1,11,5,2,2,0,2,11,1,10,5,2,2,0,2,10,1,9,4
0,4,4,4,6,0,6,5,4,4,0,4,6,0,6,5,4,4,0,4,6,0,6,5
2,0,4,2,29,14,15,7,0,4,2,2,15,7,8,4,0,4,2,2,8,3,5,2
2,0,0,4,14,7,7,6,0,0,2,4,7,3,4,3,0,0,2,4,4,1,3,2
0,0,3,4,25,2,23,20,0,3,0,4,23,2,21,18,0,3,0,4,21,2,19,17
1,0,1,1,19,5,14,4,0,1,1,1,14,4,10,3,0,1,1,1,10,3,7,2
3,2,0,2,7,4,3,1,2,0,3,2,3,2,1,0,2,0,3,2,1,0,1,0
2,0,0,3,4,1,3,2,0,0,2,3,3,1,2,1,0,0,2,3,2,1,1,0
2,4,4,4,7,3,4,3,4,4,2,4,4,1,3,2,4,4,2,4,3,1,2,1
3,2,3,2,21,14,7,3,2,3,3,2,7,4,3,1,2,3,3,2,3,2,1,0
3,0,2,4,23,16,7,6,0,2,3,4,7,4,3,2,0,2,3,4,3,2,1,0
2,0,1,1,9,4,5,1,0,1,2,1,5,2,3,0,0,1,2,1,3,1,2,0
4,0,0,3,7,6,1,0,0,0,4,3,1,0,1,0,0,0,4,3,1,0,1,0
1,4,0,3,4,1,3,2,4,0,1,3,3,0,3,2,4,0,1,3,3,0,3,2
2,3,0,3,4,2,2,1,3,0,2,3,2,1,1,0,3,0,2,3,1,0,1,0
0,1,0,4,0,0,0,0,1,0,0,4,0,0,0,0,1,0,0,4,0,0,0,0
0,1,2,4,18,1,17,15,1,2,0,4,17,1,16,14,1,2,0,4,16,1,15,13
0,0,4,1,29,2,27,8,0,4,0,1,27,2,25,7,0,4,0,1,25,2,23,6
2,1,1,3,14,6,8,5,1,1,2,3,8,4,4,2,1,1,2,3,4,1,3,2
4,2,1,1,3,2,1,0,2,1,4,1,1,0,1,0,2,1,4,1,1,0,1,0
2,0,1,0,11,5,6,0,0,1,2,0,6,3,3,0,0,1,2,0,3,1,2,0
0,0,1,2,18,1,17,8,0,1,0,2,17,1,16,8,0,1,0,2,16,1,15,7
3,0,2,4,17,11,6,5,0,2,3,4,6,4,2,1,0,2,3,4,2,1,1,0
3,2,2,4,12,8,4,3,2,2,3,4,4,2,2,1,2,2,3,4,2,1,1,0
4,4,2,2,5,4,1,0,4,2,4,2,1,0,1,0,4,2,4,2,1,0,1,0
1,4,4,4,10,3,7,6,4,4,1,4,7,2,5,4,4,4,1,4,5,1,4,3
3,2,0,0,7,4,3,0,2,0,3,0,3,2,1,0,2,0,3,0,1,0,1,0
3,2,4,0,22,15,7,0,2,4,3,0,7,4,3,0,2,4,3,0,3,2,1,0
4,4,0,2,4,3,1,0,4,0,4,2,1,0,1,0,4,0,4,2,1,0,1,0
3,0,0,0,6,4,2,0,0,0,3,0,2,1,1,0,0,0,3,0,1,0,1,0
3,3,1,3,1,0,1,0,3,1,3,3,1,0,1,0,3,1,3,3,1,0,1,0
2,3,1,1,17,8,9,2,3,1,2,1,9,4,5,1,3,1,2,1,5,2,3,0
3,0,3,3,22,15,7,4,0,3,3,3,7,4,3,2,0,3,3,3,3,2,1,0
1,4,1,0,0,0,0,0,4,1,1,0,0,0,0,0,4,1,1,0,0,0,0,0
4,4,3,2,10,8,2,0,4,3,4,2,2,1,1,0,4,3,4,2,1,0,1,0
1,0,0,1,10,3,7,2,0,0,1,1,7,2,5,1,0,0,1,1,5,1,4,1
1,0,4,3,26,7,19,13,0,4,1,3,19,5,14,9,0,4,1,3,14,4,10,7
0,3,4,3,18,1,17,11,3,4,0,3,17,1,16,11,3,4,0,3,16,1,15,10
2,4,2,2,2,1,1,0,4,2,2,2,1,0,1,0,4,2,2,2,1,0,1,0
2,1,2,2,20,10,10,4,1,2,2,2,10,5,5,2,1,2,2,2,5,2,3,1
0,1,3,1,25,2,23,6,1,3,0,1,23,2,21,6,1,3,0,1,21,2,19,5
1,2,0,3,2,0,2,1,2,0,1,3,2,0,2,1,2,0,1,3,2,0,2,1
0,2,3,3,13,1,12,8,2,3,0,3,12,1,11,7,2,3,0,3,11,1,10,7
3,2,3,4,15,10,5,4,2,3,3,4,5,3,2,1,2,3,3,4,2,1,1,0
3,1,0,4,5,3,2,1,1,0,3,4,2,1,1,0,1,0,3,4,1,0,1,0
2,0,1,4,15,7,8,7,0,1,2,4,8,3,5,4,0,1,2,4,5,2,3,2
1,1,3,1,21,6,15,4,1,3,1,1,15,4,11,3,1,3,1,1,11,3,8,2
1,3,2,0,1,0,1,0,3,2,1,0,1,0,1,0,3,2,1,0,1,0,1,0
1,2,4,1,22,6,16,4,2,4,1,1,16,4,12,3,2,4,1,1,12,3,9,2
4,1,2,0,12,10,2,0,1,2,4,0,2,1,1,0,1,2,4,0,1,0,1,0
0,1,2,3,10,1,9,6,1,2,0,3,9,0,9,6,1,2,0,3,9,0,9,6
4,1,1,1,14,12,2,0,1,1,4,1,2,1,1,0,1,1,4,1,1,0,1,0
3,2,3,3,17,11,6,4,2,3,3,3,6,4,2,1,2,3,3,3,2,1,1,0
1,1,4,1,17,5,12,3,1,4,1,1,12,3,9,2,1,4,1,1,9,2,7,2
1,4,2,4,2,0,2,1,4,2,1,4,2,0,2,1,4,2,1,4,2,0,2,1
1,2,2,1,7,2,5,1,2,2,1,1,5,1,4,1,2,2,1,1,4,1,3,0
1,3,4,4,19,5,14,12,3,4,1,4,14,4,10,8,3,4,1,4,10,2,8,7
1,0,0,4,11,3,8,7,0,0,1,4,8,2,6,5,0,0,1,4,6,1,5,4
4,3,2,4,2,1,1,0,3,2,4,4,1,0,1,0,3,2,4,4,1,0,1,0
0,2,2,3,10,0,10,6,2,2,0,3,10,1,9,6,2,2,0,3,9,0,9,6
3,0,2,3,15,10,5,3,0,2,3,3,5,3,2,1,0,2,3,3,2,1,1,0
4,3,0,1,9,8,1,0,3,0,4,1,1,0,1,0,3,0,4,1,1,0,1,0
2,2,0,0,17,8,9,0,2,0,2,0,9,4,5,0,2,0,2,0,5,2,3,0
1,0,2,1,28,8,20,6,0,2,1,1,20,6,14,4,0,2,1,1,14,4,10,3
3,2,2,1,14,9,5,1,2,2,3,1,5,3,2,0,2,2,3,1,2,1,1,0
1,2,3,3,4,1,3,2,2,3,1,3,3,0,3,2,2,3,1,3,3,0,3,2
4,1,0,3,3,2,1,0,1,0,4,3,1,0,1,0,1,0,4,3,1,0,1,0
1,3,2,0,6,1,5,0,3,2,1,0,5,1,4,0,3,2,1,0,4,1,3,0
2,0,2,2,21,10,11,5,0,2,2,2,11,5,6,2,0,2,2,2,6,3,3,1
0,4,0,3,6,0,6,4,4,0,0,3,6,0,6,4,4,0,0,3,6,0,6,4
0,0,3,3,24,2,22,15,0,3,0,3,22,2,20,14,0,3,0,3,20,2,18,12
4,3,0,0,0,0,0,0,3,0,4,0,0,0,0,0,3,0,4,0,0,0,0,0
0,0,3,3,28,2,26,18,0,3,0,3,26,2,24,16,0,3,0,3,24,2,22,15
2,4,0,0,6,3,3,0,4,0,2,0,3,1,2,0,4,0,2,0,2,1,1,0
0,1,0,0,10,1,9,0,1,0,0,0,9,0,9,0,1,0,0,0,9,0,9,0
3,4,1,0,3,2,1,0,4,1,3,0,1,0,1,0,4,1,3,0,1,0,1,0
1,1,0,4,3,0,3,2,1,0,1,4,3,0,3,2,1,0,1,4,3,0,3,2
2,1,4,4,25,12,13,11,1,4,2,4,13,6,7,6,1,4,2,4,7,3,4,3
1,3,0,4,13,3,10,8,3,0,1,4,10,2,8,7,3,0,1,4,8,2,6,5
0,1,3,0,22,2,20,1,1,3,0,0,20,2,18,1,1,3,0,0,18,1,17,1
4,2,0,3,9,8,1,0,2,0,4,3,1,0,1,0,2,0,4,3,1,0,1,0
1,3,2,4,4,1,3,2,3,2,1,4,3,0,3,2,3,2,1,4,3,0,3,2
4,3,4,4,15,13,2,1,3,4,4,4,2,1,1,0,3,4,4,4,1,0,1,0
3,3,4,3,13,9,4,2,3,4,3,3,4,2,2,1,3,4,3,3,2,1,1,0
0,3,1,0,10,0,10,0,3,1,0,0,10,1,9,0,3,1,0,0,9,0,9,0
2,3,3,3,10,4,6,4,3,3,2,3,6,2,4,2,3,3,2,3,4,2,2,1
1,4,2,2,13,3,10,5,4,2,1,2,10,2,8,4,4,2,1,2,8,2,6,3
2,4,1,2,0,0,0,0,4,1,2,2,0,0,0,0,4,1,2,2,0,0,0,0
4,0,4,1,28,25,3,0,0,4,4,1,3,2,1,0,0,4,4,1,1,0,1,0
3,2,2,1,10,7,3,0,2,2,3,1,3,2,1,0,2,2,3,1,1,0,1,0
2,4,2,3,6,3,3,2,4,2,2,3,3,1,2,1,4,2,2,3,2,1,1,0
1,2,2,3,23,6,17,11,2,2,1,3,17,5,12,8,2,2,1,3,12,3,9,6
4,3,4,2,11,9,2,0,3,4,4,2,2,1,1,0,3,4,4,2,1,0,1,0
0,3,4,4,17,1,16,14,3,4,0,4,16,1,15,13,3,4,0,4,15,1,14,12
2,0,1,3,26,12,14,9,0,1,2,3,14,6,8,5,0,1,2,3,8,4,4,2
2,1,0,1,3,1,2,0,1,0,2,1,2,1,1,0,1,0,2,1,1,0,1,0
4,4,3,2,4,3,1,0,4,3,4,2,1,0,1,0,4,3,4,2,1,0,1,0
1,2,1,0,8,2,6,0,2,1,1,0,6,1,5,0,2,1,1,0,5,1,4,0
1,4,1,0,2,0,2,0,4,1,1,0,2,0,2,0,4,1,1,0,2,0,2,0
0,4,2,1,8,0,8,2,4,2,0,1,8,0,8,2,4,2,0,1,8,0,8,2
0,0,1,2,15,1,14,6,0,1,0,2,14,1,13,6,0,1,0,2,13,1,12,6
0,3,1,1,7,0,7,2,3,1,0,1,7,0,7,2,3,1,0,1,7,0,7,2
1,3,3,3,12,3,9,6,3,3,1,3,9,2,7,4,3,3,1,3,7,2,5,3
2,3,2,1,11,5,6,1,3,2,2,1,6,2,4,1,3,2,2,1,4,2,2,0
3,2,2,3,8,5,3,2,2,2,3,3,3,2,1,0,2,2,3,3,1,0,1,0
1,3,2,1,6,1,5,1,3,2,1,1,5,1,4,1,3,2,1,1,4,1,3,0
4,1,4,1,22,19,3,0,1,4,4,1,3,2,1,0,1,4,4,1,1,0,1,0
4,0,3,3,23,20,3,2,0,3,4,3,3,2,1,0,0,3,4,3,1,0,1,0
3,0,0,4,9,6,3,2,0,0,3,4,3,2,1,0,0,0,3,4,1,0,1,0
2,4,3,4,4,1,3,2,4,3,2,4,3,1,2,1,4,3,2,4,2,0,2,1
3,4,4,4,2,1,1,0,4,4,3,4,1,0,1,0,4,4,3,4,1,0,1,0
0,2,2,4,18,1,17,15,2,2,0,4,17,1,16,14,2,2,0,4,16,1,15,13
1,3,4,4,11,3,8,7,3,4,1,4,8,2,6,5,3,4,1,4,6,1,5,4
4,3,0,4,9,8,1,0,3,0,4,4,1,0,1,0,3,0,4,4,1,0,1,0
3,1,2,3,17,11,6,4,1,2,3,3,6,4,2,1,1,2,3,3,2,1,1,0
4,0,1,1,19,17,2,0,0,1,4,1,2,1,1,0,0,1,4,1,1,0,1,0
3,3,4,0,23,16,7,0,3,4,3,0,7,4,3,0,3,4,3,0,3,2,1,0
4,2,4,0,25,22,3,0,2,4,4,0,3,2,1,0,2,4,4,0,1,0,1,0
1,4,3,3,6,1,5,3,4,3,1,3,5,1,4,2,4,3,1,3,4,1,3,2
1,1,0,3,5,1,4,2,1,0,1,3,4,1,3,2,1,0,1,3,3,0,3,2
3,0,4,1,29,20,9,2,0,4,3,1,9,6,3,0,0,4,3,1,3,2,1,0
3,4,3,2,1,0,1,0,4,3,3,2,1,0,1,0,4,3,3,2,1,0,1,0
3,3,3,3,7,4,3,2,3,3,3,3,3,2,1,0,3,3,3,3,1,0,1,0
1,3,2,1,6,1,5,1,3,2,1,1,5,1,4,1,3,2,1,1,4,1,3,0
1,3,2,0,4,1,3,0,3,2,1,0,3,0,3,0,3,2,1,0,3,0,3,0
0,0,4,2,29,2,27,13,0,4,0,2,27,2,25,12,0,4,0,2,25,2,23,11
1,3,0,3,6,1,5,3,3,0,1,3,5,1,4,2,3,0,1,3,4,1,3,2
3,4,0,4,1,0,1,0,4,0,3,4,1,0,1,0,4,0,3,4,1,0,1,0
0,0,1,1,21,2,19,5,0,1,0,1,19,1,18,5,0,1,0,1,18,1,17,5
2,4,0,1,0,0,0,0,4,0,2,1,0,0,0,0,4,0,2,1,0,0,0,0
4,4,3,3,1,0,1,0,4,3,4,3,1,0,1,0,4,3,4,3,1,0,1,0
4,4,2,2,4,3,1,0,4,2,4,2,1,0,1,0,4,2,4,2,1,0,1,0
1,4,3,3,9,2,7,4,4,3,1,3,7,2,5,3,4,3,1,3,5,1,4,2
0,2,1,3,3,0,3,2,2,1,0,3,3,0,3,2,2,1,0,3,3,0,3,2
2,3,0,3,1,0,1,0,3,0,2,3,1,0,1,0,3,0,2,3,1,0,1,0
2,4,0,0,1,0,1,0,4,0,2,0,1,0,1,0,4,0,2,0,1,0,1,0
1,2,4,1,17,5,12,3,2,4,1,1,12,3,9,2,2,4,1,1,9,2,7,2
0,3,0,0,1,0,1,0,3,0,0,0,1,0,1,0,3,0,0,0,1,0,1,0
0,3,0,3,0,0,0,0,3,0,0,3,0,0,0,0,3,0,0,3,0,0,0,0
4,4,4,1,0,0,0,0,4,4,4,1,0,0,0,0,4,4,4,1,0,0,0,0
4,1,2,2,25,22,3,1,1,2,4,2,3,2,1,0,1,2,4,2,1,0,1,0
3,4,3,1,12,8,4,1,4,3,3,1,4,2,2,0,4,3,3,1,2,1,1,0
1,4,2,1,6,1,5,1,4,2,1,1,5,1,4,1,4,2,1,1,4,1,3,0
3,2,2,2,11,7,4,2,2,2,3,2,4,2,2,1,2,2,3,2,2,1,1,0
2,3,3,3,9,4,5,3,3,3,2,3,5,2,3,2,3,3,2,3,3,1,2,1
2,2,3,0,20,9,11,1,2,3,2,0,11,5,6,0,2,3,2,0,6,2,4,0
3,1,1,2,8,5,3,1,1,1,3,2,3,2,1,0,1,1,3,2,1,0,1,0
2,1,0,3,22,11,11,7,1,0,2,3,11,5,6,4,1,0,2,3,6,2,4,2
4,1,1,0,4,3,1,0,1,1,4,0,1,0,1,0,1,1,4,0,1,0,1,0
4,0,4,0,26,23,3,0,0,4,4,0,3,2,1,0,0,4,4,0,1,0,1,0
4,1,2,4,12,10,2,1,1,2,4,4,2,1,1,0,1,2,4,4,1,0,1,0
2,0,2,1,21,10,11,3,0,2,2,1,11,5,6,1,0,2,2,1,6,2,4,1
4,2,4,1,19,17,2,0,2,4,4,1,2,1,1,0,2,4,4,1,1,0,1,0
1,3,4,1,17,5,12,3,3,4,1,1,12,3,9,2,3,4,1,1,9,2,7,2
1,2,0,3,10,3,7,4,2,0,1,3,7,2,5,3,2,0,1,3,5,1,4,2
4,2,4,2,28,25,3,1,2,4,4,2,3,2,1,0,2,4,4,2,1,0,1,0
2,3,1,1,14,6,8,2,3,1,2,1,8,4,4,1,3,1,2,1,4,2,2,0
3,4,2,4,3,2,1,0,4,2,3,4,1,0,1,0,4,2,3,4,1,0,1,0
1,3,0,2,7,2,5,2,3,0,1,2,5,1,4,1,3,0,1,2,4,1,3,1
1,1,3,0,15,4,11,1,1,3,1,0,11,3,8,0,1,3,1,0,8,2,6,0
4,1,3,1,25,22,3,0,1,3,4,1,3,2,1,0,1,3,4,1,1,0,1,0
0,4,0,3,2,0,2,1,4,0,0,3,2,0,2,1,4,0,0,3,2,0,2,1
2,2,0,2,6,3,3,1,2,0,2,2,3,1,2,0,2,0,2,2,2,0,2,1
1,3,0,0,3,0,3,0,3,0,1,0,3,0,3,0,3,0,1,0,3,0,3,0
0,1,2,3,22,2,20,14,1,2,0,3,20,1,19,13,1,2,0,3,19,1,18,12
3,0,3,0,23,16,7,0,0,3,3,0,7,4,3,0,0,3,3,0,3,2,1,0
0,2,4,1,29,2,27,8,2,4,0,1,27,2,25,7,2,4,0,1,25,2,23,6
2,0,0,1,7,3,4,1,0,0,2,1,4,1,3,0,0,0,2,1,3,1,2,0
4,2,1,1,4,3,1,0,2,1,4,1,1,0,1,0,2,1,4,1,1,0,1,0
0,2,4,3,19,1,18,12,2,4,0,3,18,1,17,11,2,4,0,3,17,1,16,11
1,0,2,0,11,3,8,0,0,2,1,0,8,2,6,0,0,2,1,0,6,1,5,0
2,0,1,0,18,8,10,1,0,1,2,0,10,5,5,0,0,1,2,0,5,2,3,0
0,2,3,0,16,1,15,1,2,3,0,0,15,1,14,1,2,3,0,0,14,1,13,1
2,2,0,2,6,2,4,1,2,0,2,2,4,2,2,1,2,0,2,2,2,0,2,1
3,3,2,1,8,5,3,0,3,2,3,1,3,2,1,0,3,2,3,1,1,0,1,0
4,0,3,0,27,24,3,0,0,3,4,0,3,2,1,0,0,3,4,0,1,0,1,0
2,3,4,2,19,9,10,5,3,4,2,2,10,5,5,2,3,4,2,2,5,2,3,1
4,3,0,2,2,1,1,0,3,0,4,2,1,0,1,0,3,0,4,2,1,0,1,0
2,1,4,0,28,13,15,1,1,4,2,0,15,7,8,0,1,4,2,0,8,3,5,0
2,0,0,3,14,6,8,5,0,0,2,3,8,3,5,3,0,0,2,3,5,2,3,2
2,3,1,2,11,5,6,3,3,1,2,2,6,3,3,1,3,1,2,2,3,1,2,1
3,1,2,3,13,9,4,2,1,2,3,3,4,2,2,1,1,2,3,3,2,1,1,0
0,1,2,1,16,1,15,4,1,2,0,1,15,1,14,4,1,2,0,1,14,1,13,3
1,1,4,2,29,8,21,10,1,4,1,2,21,6,15,7,1,4,1,2,15,4,11,5
1,0,2,4,23,6,17,15,0,2,1,4,17,5,12,10,0,2,1,4,12,3,9,8
4,3,2,0,10,9,1,0,3,2,4,0,1,0,1,0,3,2,4,0,1,0,1,0
3,1,1,4,9,6,3,2,1,1,3,4,3,2,1,0,1,1,3,4,1,0,1,0
3,3,1,4,3,2,1,0,3,1,3,4,1,0,1,0,3,1,3,4,1,0,1,0
2,4,3,3,15,7,8,5,4,3,2,3,8,4,4,2,4,3,2,3,4,1,3,2
1,3,3,0,7,2,5,0,3,3,1,0,5,1,4,0,3,3,1,0,4,1,3,0
1,0,2,3,15,4,11,7,0,2,1,3,11,3,8,5,0,2,1,3,8,2,6,4
1,0,2,2,24,7,17,8,0,2,1,2,17,5,12,5,0,2,1,2,12,3,9,4
1,1,0,2,2,0,2,0,1,0,1,2,2,0,2,0,1,0,1,2,2,0,2,0
0,2,2,4,9,0,9,8,2,2,0,4,9,0,9,8,2,2,0,4,9,0,9,8
2,2,0,2,7,3,4,2,2,0,2,2,4,2,2,1,2,0,2,2,2,0,2,1
3,3,3,4,11,7,4,3,3,3,3,4,4,2,2,1,3,3,3,4,2,1,1,0
0,3,2,0,10,1,9,0,3,2,0,0,9,0,9,0,3,2,0,0,9,0,9,0
1,3,1,0,5,1,4,0,3,1,1,0,4,1,3,0,3,1,1,0,3,0,3,0
2,2,1,4,8,3,5,4,2,1,2,4,5,2,3,2,2,1,2,4,3,1,2,1
4,1,2,0,14,12,2,0,1,2,4,0,2,1,1,0,1,2,4,0,1,0,1,0
1,4,1,1,1,0,1,0,4,1,1,1,1,0,1,0,4,1,1,1,1,0,1,0
2,0,4,2,23,11,12,5,0,4,2,2,12,5,7,3,0,4,2,2,7,3,4,2
2,2,1,1,0,0,0,0,2,1,2,1,0,0,0,0,2,1,2,1,0,0,0,0
2,2,1,2,6,3,3,1,2,1,2,2,3,1,2,1,2,1,2,2,2,1,1,0
2,0,1,2,8,3,5,2,0,1,2,2,5,2,3,1,0,1,2,2,3,1,2,1
4,2,1,4,10,9,1,0,2,1,4,4,1,0,1,0,2,1,4,4,1,0,1,0
2,2,4,4,28,13,15,13,2,4,2,4,15,7,8,7,2,4,2,4,8,4,4,3
0,2,3,2,11,1,10,4,2,3,0,2,10,0,10,5,2,3,0,2,10,1,9,4
0,3,0,1,8,0,8,2,3,0,0,1,8,0,8,2,3,0,0,1,8,0,8,2
1,2,3,3,28,8,20,14,2,3,1,3,20,6,14,9,2,3,1,3,14,4,10,6
4,2,2,1,15,13,2,0,2,2,4,1,2,1,1,0,2,2,4,1,1,0,1,0
1,3,4,0,11,3,8,0,3,4,1,0,8,2,6,0,3,4,1,0,6,1,5,0
2,4,4,1,7,3,4,1,4,4,2,1,4,2,2,0,4,4,2,1,2,0,2,0
3,1,1,2,11,7,4,1,1,1,3,2,4,2,2,1,1,1,3,2,2,1,1,0
4,1,0,0,8,7,1,0,1,0,4,0,1,0,1,0,1,0,4,0,1,0,1,0
3,2,2,0,20,14,6,0,2,2,3,0,6,4,2,0,2,2,3,0,2,1,1,0
4,0,2,4,26,23,3,2,0,2,4,4,3,2,1,0,0,2,4,4,1,0,1,0
2,0,2,3,27,13,14,9,0,2,2,3,14,6,8,5,0,2,2,3,8,3,5,3
0,4,2,2,11,1,10,5,4,2,0,2,10,0,10,5,4,2,0,2,10,1,9,4
4,1,4,1,27,24,3,0,1,4,4,1,3,2,1,0,1,4,4,1,1,0,1,0
3,1,1,3,14,9,5,3,1,1,3,3,5,3,2,1,1,1,3,3,2,1,1,0
2,2,2,0,7,3,4,0,2,2,2,0,4,2,2,0,2,2,2,0,2,1,1,0
0,3,0,3,2,0,2,1,3,0,0,3,2,0,2,1,3,0,0,3,2,0,2,1
3,4,0,2,9,6,3,1,4,0,3,2,3,2,1,0,4,0,3,2,1,0,1,0
2,1,1,3,9,4,5,3,1,1,2,3,5,2,3,2,1,1,2,3,3,1,2,1
1,2,4,4,17,5,12,10,2,4,1,4,12,3,9,8,2,4,1,4,9,2,7,6
3,3,2,0,8,5,3,0,3,2,3,0,3,2,1,0,3,2,3,0,1,0,1,0
2,1,3,0,21,10,11,1,1,3,2,0,11,5,6,0,1,3,2,0,6,3,3,0
2,2,0,2,9,4,5,2,2,0,2,2,5,2,3,1,2,0,2,2,3,1,2,1
3,0,0,4,9,6,3,2,0,0,3,4,3,2,1,0,0,0,3,4,1,0,1,0
2,2,1,3,9,4,5,3,2,1,2,3,5,2,3,2,2,1,2,3,3,1,2,1
0,1,1,2,9,0,9,4,1,1,0,2,9,0,9,4,1,1,0,2,9,0,9,4
4,3,4,2,17,15,2,0,3,4,4,2,2,1,1,0,3,4,4,2,1,0,1,0
2,4,3,2,0,0,0,0,4,3,2,2,0,0,0,0,4,3,2,2,0,0,0,0
3,1,4,4,23,16,7,6,1,4,3,4,7,4,3,2,1,4,3,4,3,2,1,0
4,0,2,3,25,22,3,2,0,2,4,3,3,2,1,0,0,2,4,3,1,0,1,0
1,3,0,3,4,1,3,2,3,0,1,3,3,0,3,2,3,0,1,3,3,0,3,2
1,2,1,3,9,2,7,4,2,1,1,3,7,2,5,3,2,1,1,3,5,1,4,2
2,1,0,0,8,3,5,0,1,0,2,0,5,2,3,0,1,0,2,0,3,1,2,0
2,1,1,3,12,6,6,4,1,1,2,3,6,3,3,2,1,1,2,3,3,1,2,1
0,1,4,1,26,2,24,7,1,4,0,1,24,2,22,6,1,4,0,1,22,2,20,6
3,1,1,4,4,2,2,1,1,1,3,4,2,1,1,0,1,1,3,4,1,0,1,0
4,0,4,4,27,24,3,2,0,4,4,4,3,2,1,0,0,4,4,4,1,0,1,0
1,0,2,2,25,7,18,9,0,2,1,2,18,5,13,6,0,2,1,2,13,3,10,5
1,4,3,2,3,0,3,1,4,3,1,2,3,0,3,1,4,3,1,2,3,0,3,1
2,4,4,0,3,1,2,0,4,4,2,0,2,0,2,0,4,4,2,0,2,0,2,0
3,3,3,1,17,11,6,1,3,3,3,1,6,4,2,0,3,3,3,1,2,1,1,0
3,2,3,0,21,14,7,0,2,3,3,0,7,4,3,0,2,3,3,0,3,2,1,0
2,4,4,4,8,4,4,3,4,4,2,4,4,1,3,2,4,4,2,4,3,1,2,1
1,2,3,4,26,7,19,17,2,3,1,4,19,5,14,12,2,3,1,4,14,4,10,9
3,2,0,1,2,1,1,0,2,0,3,1,1,0,1,0,2,0,3,1,1,0,1,0
0,4,2,1,4,0,4,1,4,2,0,1,4,0,4,1,4,2,0,1,4,0,4,1
2,1,1,0,8,3,5,0,1,1,2,0,5,2,3,0,1,1,2,0,3,1,2,0
3,0,2,3,26,18,8,5,0,2,3,3,8,5,3,2,0,2,3,3,3,2,1,0
1,1,0,1,12,3,9,2,1,0,1,1,9,2,7,2,1,0,1,1,7,2,5,1
1,0,0,1,10,3,7,2,0,0,1,1,7,2,5,1,0,0,1,1,5,1,4,1
3,4,2,2,5,3,2,1,4,2,3,2,2,1,1,0,4,2,3,2,1,0,1,0
0,1,4,1,24,2,22,6,1,4,0,1,22,2,20,6,1,4,0,1,20,1,19,5
1,0,0,3,1,0,1,0,0,0,1,3,1,0,1,0,0,0,1,3,1,0,1,0
0,4,0,4,1,0,1,0,4,0,0,4,1,0,1,0,4,0,0,4,1,0,1,0
0,0,1,2,14,1,13,6,0,1,0,2,13,1,12,6,0,1,0,2,12,1,11,5
2,1,2,3,12,6,6,4,1,2,2,3,6,3,3,2,1,2,2,3,3,1,2,1
3,0,0,2,8,5,3,1,0,0,3,2,3,2,1,0,0,0,3,2,1,0,1,0
1,2,3,0,19,5,14,1,2,3,1,0,14,4,10,0,2,3,1,0,10,2,8,0
1,1,2,1,16,4,12,3,1,2,1,1,12,3,9,2,1,2,1,1,9,2,7,2
0,1,0,4,7,0,7,6,1,0,0,4,7,0,7,6,1,0,0,4,7,0,7,6
3,4,4,2,13,9,4,1,4,4,3,2,4,2,2,0,4,4,3,2,2,1,1,0
3,0,4,1,27,18,9,2,0,4,3,1,9,6,3,0,0,4,3,1,3,2,1,0
3,0,2,2,20,14,6,3,0,2,3,2,6,4,2,0,0,2,3,2,2,1,1,0
3,1,2,2,19,13,6,2,1,2,3,2,6,4,2,0,1,2,3,2,2,1,1,0
4,4,2,2,4,3,1,0,4,2,4,2,1,0,1,0,4,2,4,2,1,0,1,0
2,2,3,1,22,10,12,3,2,3,2,1,12,6,6,1,2,3,2,1,6,3,3,0
0,1,3,3,19,1,18,12,1,3,0,3,18,1,17,11,1,3,0,3,17,1,16,11
2,1,2,3,20,9,11,7,1,2,2,3,11,5,6,4,1,2,2,3,6,3,3,2
4,2,3,0,9,8,1,0,2,3,4,0,1,0,1,0,2,3,4,0,1,0,1,0
0,2,3,0,17,1,16,1,2,3,0,0,16,1,15,1,2,3,0,0,15,1,14,1
4,3,4,3,15,13,2,1,3,4,4,3,2,1,1,0,3,4,4,3,1,0,1,0
2,2,2,0,16,7,9,0,2,2,2,0,9,4,5,0,2,2,2,0,5,2,3,0
4,0,0,1,5,4,1,0,0,0,4,1,1,0,1,0,0,0,4,1,1,0,1,0
0,1,3,2,19,1,18,9,1,3,0,2,18,1,17,8,1,3,0,2,17,1,16,8
3,1,3,4,26,18,8,7,1,3,3,4,8,5,3,2,1,3,3,4,3,2,1,0
2,2,0,0,2,1,1,0,2,0,2,0,1,0,1,0,2,0,2,0,1,0,1,0
2,0,3,2,28,13,15,7,0,3,2,2,15,7,8,3,0,3,2,2,8,4,4,1
4,4,0,0,9,8,1,0,4,0,4,0,1,0,1,0,4,0,4,0,1,0,1,0
1,0,2,1,27,8,19,5,0,2,1,1,19,5,14,4,0,2,1,1,14,4,10,3
3,2,4,1,27,18,9,2,2,4,3,1,9,6,3,0,2,4,3,1,3,2,1,0
0,1,1,2,5,0,5,2,1,1,0,2,5,0,5,2,1,1,0,2,5,0,5,2
2,4,0,4,2,0,2,1,4,0,2,4,2,1,1,0,4,0,2,4,1,0,1,0
1,2,3,0,17,5,12,1,2,3,1,0,12,3,9,0,2,3,1,0,9,2,7,0
2,2,2,1,12,6,6,1,2,2,2,1,6,3,3,0,2,2,2,1,3,1,2,0
1,4,2,4,8,2,6,5,4,2,1,4,6,1,5,4,4,2,1,4,5,1,4,3
0,4,4,0,13,1,12,1,4,4,0,0,12,1,11,1,4,4,0,0,11,1,10,1
3,1,2,0,15,10,5,0,1,2,3,0,5,3,2,0,1,2,3,0,2,1,1,0
2,4,3,2,6,2,4,1,4,3,2,2,4,2,2,0,4,3,2,2,2,0,2,1
1,2,2,3,10,3,7,4,2,2,1,3,7,2,5,3,2,2,1,3,5,1,4,2
3,3,2,2,12,8,4,1,3,2,3,2,4,2,2,0,3,2,3,2,2,1,1,0
2,3,2,1,9,4,5,1,3,2,2,1,5,2,3,0,3,2,2,1,3,1,2,0
4,0,3,1,28,25,3,0,0,3,4,1,3,2,1,0,0,3,4,1,1,0,1,0
3,4,4,1,16,11,5,1,4,4,3,1,5,3,2,0,4,4,3,1,2,1,1,0
3,4,0,0,11,7,4,0,4,0,3,0,4,2,2,0,4,0,3,0,2,1,1,0
3,3,1,1,5,3,2,0,3,1,3,1,2,1,1,0,3,1,3,1,1,0,1,0
3,4,1,0,7,4,3,0,4,1,3,0,3,2,1,0,4,1,3,0,1,0,1,0
3,4,0,1,11,7,4,1,4,0,3,1,4,2,2,0,4,0,3,1,2,1,1,0
1,3,3,4,13,3,10,8,3,3,1,4,10,2,8,7,3,3,1,4,8,2,6,5
4,1,4,3,25,22,3,2,1,4,4,3,3,2,1,0,1,4,4,3,1,0,1,0
4,0,0,0,8,7,1,0,0,0,4,0,1,0,1,0,0,0,4,0,1,0,1,0
0,1,4,3,26,2,24,16,1,4,0,3,24,2,22,15,1,4,0,3,22,2,20,14
0,1,2,4,12,1,11,9,1,2,0,4,11,1,10,9,1,2,0,4,10,0,10,8
0,1,4,3,29,2,27,18,1,4,0,3,27,2,25,17,1,4,0,3,25,2,23,16
1,0,2,2,28,8,20,10,0,2,1,2,20,6,14,6,0,2,1,2,14,4,10,5
0,2,1,0,12,1,11,1,2,1,0,0,11,1,10,0,2,1,0,0,10,0,10,1
3,3,0,4,4,2,2,1,3,0,3,4,2,1,1,0,3,0,3,4,1,0,1,0
3,1,0,2,6,4,2,0,1,0,3,2,2,1,1,0,1,0,3,2,1,0,1,0
3,1,1,4,10,7,3,2,1,1,3,4,3,2,1,0,1,1,3,4,1,0,1,0
3,3,2,1,4,2,2,0,3,2,3,1,2,1,1,0,3,2,3,1,1,0,1,0
2,3,0,4,8,4,4,3,3,0,2,4,4,1,3,2,3,0,2,4,3,1,2,1
2,0,0,0,8,4,4,0,0,0,2,0,4,1,3,0,0,0,2,0,3,1,2,0
0,3,3,3,14,1,13,9,3,3,0,3,13,1,12,8,3,3,0,3,12,1,11,7
3,0,2,1,27,18,9,2,0,2,3,1,9,6,3,0,0,2,3,1,3,2,1,0
3,0,2,0,27,18,9,0,0,2,3,0,9,6,3,0,0,2,3,0,3,2,1,0
1,2,4,3,7,2,5,3,2,4,1,3,5,1,4,2,2,4,1,3,4,1,3,2
3,3,3,3,8,5,3,2,3,3,3,3,3,2,1,0,3,3,3,3,1,0,1,0
2,0,2,1,20,9,11,3,0,2,2,1,11,5,6,1,0,2,2,1,6,3,3,0
1,4,1,0,3,0,3,0,4,1,1,0,3,0,3,0,4,1,1,0,3,0,3,0
3,4,2,4,5,3,2,1,4,2,3,4,2,1,1,0,4,2,3,4,1,0,1,0
2,0,1,3,25,12,13,9,0,1,2,3,13,6,7,4,0,1,2,3,7,3,4,2
4,2,4,4,28,25,3,2,2,4,4,4,3,2,1,0,2,4,4,4,1,0,1,0
0,3,1,2,13,1,12,5,3,1,0,2,12,1,11,5,3,1,0,2,11,1,10,4
2,3,1,4,2,0,2,1,3,1,2,4,2,0,2,1,3,1,2,4,2,0,2,1
4,1,1,4,9,8,1,0,1,1,4,4,1,0,1,0,1,1,4,4,1,0,1,0
4,2,4,2,23,20,3,1,2,4,4,2,3,2,1,0,2,4,4,2,1,0,1,0
1,0,1,3,11,3,8,5,0,1,1,3,8,2,6,4,0,1,1,3,6,1,5,3
1,3,2,1,18,5,13,3,3,2,1,1,13,3,10,2,3,2,1,1,10,2,8,2
4,1,2,4,18,16,2,1,1,2,4,4,2,1,1,0,1,2,4,4,1,0,1,0
2,2,4,1,19,9,10,3,2,4,2,1,10,5,5,1,2,4,2,1,5,2,3,0
4,2,3,2,10,8,2,0,2,3,4,2,2,1,1,0,2,3,4,2,1,0,1,0
1,3,4,1,8,2,6,1,3,4,1,1,6,1,5,1,3,4,1,1,5,1,4,1
4,0,0,2,6,5,1,0,0,0,4,2,1,0,1,0,0,0,4,2,1,0,1,0
4,2,2,4,4,3,1,0,2,2,4,4,1,0,1,0,2,2,4,4,1,0,1,0
2,0,3,1,27,13,14,4,0,3,2,1,14,7,7,2,0,3,2,1,7,3,4,1
2,2,0,1,4,2,2,0,2,0,2,1,2,0,2,0,2,0,2,1,2,1,1,0
2,2,1,0,14,7,7,0,2,1,2,0,7,3,4,0,2,1,2,0,4,1,3,0
1,1,0,2,8,2,6,3,1,0,1,2,6,1,5,2,1,0,1,2,5,1,4,1
0,4,1,4,2,0,2,1,4,1,0,4,2,0,2,1,4,1,0,4,2,0,2,1
4,1,0,2,1,0,1,0,1,0,4,2,1,0,1,0,1,0,4,2,1,0,1,0
3,4,3,3,15,10,5,3,4,3,3,3,5,3,2,1,4,3,3,3,2,1,1,0
2,1,0,3,5,2,3,2,1,0,2,3,3,1,2,1,1,0,2,3,2,1,1,0
0,2,3,2,11,1,10,4,2,3,0,2,10,1,9,4,2,3,0,2,9,0,9,4
1,4,3,4,7,2,5,4,4,3,1,4,5,1,4,3,4,3,1,4,4,1,3,2
2,2,3,2,17,8,9,4,2,3,2,2,9,4,5,2,2,3,2,2,5,2,3,1
1,3,3,3,11,3,8,5,3,3,1,3,8,2,6,4,3,3,1,3,6,1,5,3
3,1,2,0,19,13,6,0,1,2,3,0,6,4,2,0,1,2,3,0,2,1,1,0
0,4,2,2,1,0,1,0,4,2,0,2,1,0,1,0,4,2,0,2,1,0,1,0
4,2,3,0,19,17,2,0,2,3,4,0,2,1,1,0,2,3,4,0,1,0,1,0
0,1,1,3,17,1,16,11,1,1,0,3,16,1,15,10,1,1,0,3,15,1,14,9
3,4,0,1,6,4,2,0,4,0,3,1,2,1,1,0,4,0,3,1,1,0,1,0
3,4,4,4,4,2,2,1,4,4,3,4,2,1,1,0,4,4,3,4,1,0,1,0
3,0,2,1,20,14,6,1,0,2,3,1,6,4,2,0,0,2,3,1,2,1,1,0
3,3,2,3,12,8,4,2,3,2,3,3,4,2,2,1,3,2,3,3,2,1,1,0
4,4,1,4,7,6,1,0,4,1,4,4,1,0,1,0,4,1,4,4,1,0,1,0
0,2,0,2,1,0,1,0,2,0,0,2,1,0,1,0,2,0,0,2,1,0,1,0
0,1,1,4,0,0,0,0,1,1,0,4,0,0,0,0,1,1,0,4,0,0,0,0
4,2,0,2,11,9,2,0,2,0,4,2,2,1,1,0,2,0,4,2,1,0,1,0
1,1,3,3,17,5,12,8,1,3,1,3,12,3,9,6,1,3,1,3,9,2,7,4
3,4,2,4,8,5,3,2,4,2,3,4,3,2,1,0,4,2,3,4,1,0,1,0
4,1,1,4,5,4,1,0,1,1,4,4,1,0,1,0,1,1,4,4,1,0,1,0
3,4,2,2,2,1,1,0,4,2,3,2,1,0,1,0,4,2,3,2,1,0,1,0
4,2,0,4,5,4,1,0,2,0,4,4,1,0,1,0,2,0,4,4,1,0,1,0
1,1,2,3,22,6,16,11,1,2,1,3,16,4,12,8,1,2,1,3,12,3,9,6
4,1,0,4,3,2,1,0,1,0,4,4,1,0,1,0,1,0,4,4,1,0,1,0
0,4,2,1,18,1,17,5,4,2,0,1,17,1,16,4,4,2,0,1,16,1,15,4
0,1,0,2,13,1,12,5,1,0,0,2,12,1,11,5,1,0,0,2,11,1,10,5
1,1,2,4,11,3,8,7,1,2,1,4,8,2,6,5,1,2,1,4,6,1,5,4
2,0,0,1,1,0,1,0,0,0,2,1,1,0,1,0,0,0,2,1,1,0,1,0
2,3,2,3,13,6,7,4,3,2,2,3,7,3,4,2,3,2,2,3,4,1,3,2
1,1,2,2,18,5,13,6,1,2,1,2,13,3,10,5,1,2,1,2,10,3,7,3
4,3,1,4,5,4,1,0,3,1,4,4,1,0,1,0,3,1,4,4,1,0,1,0
4,3,3,4,4,3,1,0,3,3,4,4,1,0,1,0,3,3,4,4,1,0,1,0
1,4,1,4,6,1,5,4,4,1,1,4,5,1,4,3,4,1,1,4,4,1,3,2
1,3,3,0,11,3,8,0,3,3,1,0,8,2,6,0,3,3,1,0,6,1,5,0
1,3,3,3,20,5,15,10,3,3,1,3,15,4,11,7,3,3,1,3,11,3,8,5
2,0,4,3,29,14,15,10,0,4,2,3,15,7,8,5,0,4,2,3,8,3,5,3
1,4,2,0,11,3,8,0,4,2,1,0,8,2,6,0,4,2,1,0,6,1,5,0
4,0,2,4,22,19,3,2,0,2,4,4,3,2,1,0,0,2,4,4,1,0,1,0
0,2,2,2,10,0,10,4,2,2,0,2,10,0,10,4,2,2,0,2,10,0,10,5
0,0,0,1,6,0,6,1,0,0,0,1,6,0,6,1,0,0,0,1,6,0,6,1
4,1,3,2,21,18,3,1,1,3,4,2,3,2,1,0,1,3,4,2,1,0,1,0
1,0,0,1,0,0,0,0,0,0,1,1,0,0,0,0,0,0,1,1,0,0,0,0
0,3,0,0,10,0,10,0,3,0,0,0,10,1,9,0,3,0,0,0,9,0,9,0
2,2,1,4,17,8,9,8,2,1,2,4,9,4,5,4,2,1,2,4,5,2,3,2
1,1,4,4,27,8,19,17,1,4,1,4,19,5,14,12,1,4,1,4,14,4,10,8
0,3,1,0,2,0,2,0,3,1,0,0,2,0,2,0,3,1,0,0,2,0,2,0
1,4,3,4,2,0,2,1,4,3,1,4,2,0,2,1,4,3,1,4,2,0,2,1
3,2,2,3,13,9,4,2,2,2,3,3,4,2,2,1,2,2,3,3,2,1,1,0
4,4,2,1,7,6,1,0,4,2,4,1,1,0,1,0,4,2,4,1,1,0,1,0
0,3,0,0,5,0,5,0,3,0,0,0,5,0,5,0,3,0,0,0,5,0,5,0
1,1,2,1,24,7,17,5,1,2,1,1,17,5,12,3,1,2,1,1,12,3,9,2
0,2,1,3,1,0,1,0,2,1,0,3,1,0,1,0,2,1,0,3,1,0,1,0
0,3,2,0,8,0,8,0,3,2,0,0,8,0,8,0,3,2,0,0,8,0,8,0
3,1,4,2,26,18,8,4,1,4,3,2,8,5,3,1,1,4,3,2,3,2,1,0
1,0,4,0,24,7,17,1,0,4,1,0,17,5,12,1,0,4,1,0,12,3,9,0
4,0,1,2,27,24,3,1,0,1,4,2,3,2,1,0,0,1,4,2,1,0,1,0
0,1,0,4,8,0,8,7,1,0,0,4,8,0,8,7,1,0,0,4,8,0,8,7
3,2,4,1,28,19,9,2,2,4,3,1,9,6,3,0,2,4,3,1,3,2,1,0
4,1,4,0,25,22,3,0,1,4,4,0,3,2,1,0,1,4,4,0,1,0,1,0
1,3,4,1,18,5,13,3,3,4,1,1,13,3,10,3,3,4,1,1,10,2,8,2
3,0,4,3,25,17,8,5,0,4,3,3,8,5,3,2,0,4,3,3,3,2,1,0
2,2,1,0,6,3,3,0,2,1,2,0,3,1,2,0,2,1,2,0,2,1,1,0
0,4,4,4,5,0,5,4,4,4,0,4,5,0,5,4,4,4,0,4,5,0,5,4
1,0,1,2,13,3,10,5,0,1,1,2,10,2,8,3,0,1,1,2,8,2,6,3
0,1,0,1,3,0,3,0,1,0,0,1,3,0,3,0,1,0,0,1,3,0,3,0
3,2,4,3,24,16,8,5,2,4,3,3,8,5,3,2,2,4,3,3,3,2,1,0
2,2,2,0,10,4,6,0,2,2,2,0,6,2,4,0,2,2,2,0,4,2,2,0
1,0,4,4,28,8,20,18,0,4,1,4,20,6,14,12,0,4,1,4,14,4,10,8
2,3,0,1,2,0,2,0,3,0,2,1,2,1,1,0,3,0,2,1,1,0,1,0
3,2,0,3,4,2,2,1,2,0,3,3,2,1,1,0,2,0,3,3,1,0,1,0
4,0,3,2,27,24,3,1,0,3,4,2,3,2,1,0,0,3,4,2,1,0,1,0
4,1,4,2,28,25,3,1,1,4,4,2,3,2,1,0,1,4,4,2,1,0,1,0
4,0,2,2,14,12,2,1,0,2,4,2,2,1,1,0,0,2,4,2,1,0,1,0
4,2,3,2,16,14,2,0,2,3,4,2,2,1,1,0,2,3,4,2,1,0,1,0
2,2,3,2,19,9,10,5,2,3,2,2,10,5,5,2,2,3,2,2,5,2,3,1
0,1,2,1,19,1,18,5,1,2,0,1,18,1,17,5,1,2,0,1,17,1,16,4
1,2,1,3,10,2,8,5,2,1,1,3,8,2,6,4,2,1,1,3,6,1,5,3
4,0,2,3,20,18,2,1,0,2,4,3,2,1,1,0,0,2,4,3,1,0,1,0
0,3,3,2,7,0,7,3,3,3,0,2,7,0,7,3,3,3,0,2,7,0,7,3
4,1,0,0,13,11,2,0,1,0,4,0,2,1,1,0,1,0,4,0,1,0,1,0
4,3,1,4,3,2,1,0,3,1,4,4,1,0,1,0,3,1,4,4,1,0,1,0
3,2,0,4,9,6,3,2,2,0,3,4,3,2,1,0,2,0,3,4,1,0,1,0
2,2,0,0,6,3,3,0,2,0,2,0,3,1,2,0,2,0,2,0,2,0,2,0
0,2,0,2,2,0,2,1,2,0,0,2,2,0,2,0,2,0,0,2,2,0,2,1
2,3,2,3,1,0,1,0,3,2,2,3,1,0,1,0,3,2,2,3,1,0,1,0
3,2,0,1,0,0,0,0,2,0,3,1,0,0,0,0,2,0,3,1,0,0,0,0
2,0,3,0,26,12,14,1,0,3,2,0,14,7,7,0,0,3,2,0,7,3,4,0
3,3,4,4,16,11,5,4,3,4,3,4,5,3,2,1,3,4,3,4,2,1,1,0
2,4,3,0,4,2,2,0,4,3,2,0,2,0,2,0,4,3,2,0,2,1,1,0
3,0,0,4,6,4,2,1,0,0,3,4,2,1,1,0,0,0,3,4,1,0,1,0
2,4,4,4,9,4,5,4,4,4,2,4,5,2,3,2,4,4,2,4,3,1,2,1
1,1,3,4,26,7,19,17,1,3,1,4,19,5,14,12,1,3,1,4,14,4,10,8
3,0,4,1,26,18,8,2,0,4,3,1,8,5,3,0,0,4,3,1,3,2,1,0
2,0,0,0,2,1,1,0,0,0,2,0,1,0,1,0,0,0,2,0,1,0,1,0
1,3,3,1,16,4,12,3,3,3,1,1,12,3,9,2,3,3,1,1,9,2,7,2
4,0,0,0,9,8,1,0,0,0,4,0,1,0,1,0,0,0,4,0,1,0,1,0
3,2,1,0,4,2,2,0,2,1,3,0,2,1,1,0,2,1,3,0,1,0,1,0
2,0,3,2,23,11,12,6,0,3,2,2,12,6,6,2,0,3,2,2,6,3,3,1
2,0,3,3,24,11,13,9,0,3,2,3,13,6,7,4,0,3,2,3,7,3,4,2
0,3,1,4,2,0,2,1,3,1,0,4,2,0,2,1,3,1,0,4,2,0,2,1
4,0,3,1,28,25,3,0,0,3,4,1,3,2,1,0,0,3,4,1,1,0,1,0
2,3,0,1,1,0,1,0,3,0,2,1,1,0,1,0,3,0,2,1,1,0,1,0
0,3,0,2,9,0,9,4,3,0,0,2,9,0,9,4,3,0,0,2,9,0,9,4
4,1,2,3,24,21,3,2,1,2,4,3,3,2,1,0,1,2,4,3,1,0,1,0
1,0,4,2,29,8,21,10,0,4,1,2,21,6,15,7,0,4,1,2,15,4,11,5
2,4,0,3,4,2,2,1,4,0,2,3,2,1,1,0,4,0,2,3,1,0,1,0
3,0,2,0,21,14,7,0,0,2,3,0,7,4,3,0,0,2,3,0,3,2,1,0
3,0,4,4,28,19,9,8,0,4,3,4,9,6,3,2,0,4,3,4,3,2,1,0
1,3,3,4,20,5,15,13,3,3,1,4,15,4,11,9,3,3,1,4,11,3,8,7
3,0,3,3,24,16,8,5,0,3,3,3,8,5,3,2,0,3,3,3,3,2,1,0
0,3,2,0,19,1,18,1,3,2,0,0,18,1,17,1,3,2,0,0,17,1,16,1
1,2,1,4,16,4,12,10,2,1,1,4,12,3,9,8,2,1,1,4,9,2,7,6
3,3,3,1,7,4,3,0,3,3,3,1,3,2,1,0,3,3,3,1,1,0,1,0
3,3,3,2,13,9,4,2,3,3,3,2,4,2,2,0,3,3,3,2,2,1,1,0
3,0,2,2,12,8,4,2,0,2,3,2,4,2,2,0,0,2,3,2,2,1,1,0
3,0,3,0,24,16,8,0,0,3,3,0,8,5,3,0,0,3,3,0,3,2,1,0
1,2,0,4,9,2,7,6,2,0,1,4,7,2,5,4,2,0,1,4,5,1,4,3
0,0,4,2,26,2,24,11,0,4,0,2,24,2,22,11,0,4,0,2,22,2,20,9
0,2,4,3,22,2,20,14,2,4,0,3,20,2,18,12,2,4,0,3,18,1,17,11
0,4,1,1,1,0,1,0,4,1,0,1,1,0,1,0,4,1,0,1,1,0,1,0
4,1,3,4,23,20,3,2,1,3,4,4,3,2,1,0,1,3,4,4,1,0,1,0
2,3,1,2,2,1,1,0,3,1,2,2,1,0,1,0,3,1,2,2,1,0,1,0
3,4,3,3,5,3,2,1,4,3,3,3,2,1,1,0,4,3,3,3,1,0,1,0
2,3,2,1,11,5,6,1,3,2,2,1,6,2,4,1,3,2,2,1,4,1,3,0
3,0,3,2,24,16,8,4,0,3,3,2,8,5,3,1,0,3,3,2,3,2,1,0
4,2,3,1,26,23,3,0,2,3,4,1,3,2,1,0,2,3,4,1,1,0,1,0
3,4,4,3,0,0,0,0,4,4,3,3,0,0,0,0,4,4,3,3,0,0,0,0
4,1,2,3,16,14,2,1,1,2,4,3,2,1,1,0,1,2,4,3,1,0,1,0
0,0,4,3,27,2,25,17,0,4,0,3,25,2,23,16,0,4,0,3,23,2,21,14
1,1,2,4,15,4,11,9,1,2,1,4,11,3,8,7,1,2,1,4,8,2,6,5
0,4,4,3,9,0,9,6,4,4,0,3,9,0,9,6,4,4,0,3,9,0,9,6
4,4,3,0,8,7,1,0,4,3,4,0,1,0,1,0,4,3,4,0,1,0,1,0
1,3,3,2,16,4,12,6,3,3,1,2,12,3,9,4,3,3,1,2,9,2,7,3
4,2,0,2,0,0,0,0,2,0,4,2,0,0,0,0,2,0,4,2,0,0,0,0
0,1,0,0,11,1,10,0,1,0,0,0,10,1,9,0,1,0,0,0,9,0,9,0
4,2,0,2,0,0,0,0,2,0,4,2,0,0,0,0,2,0,4,2,0,0,0,0
3,2,4,2,19,13,6,2,2,4,3,2,6,4,2,1,2,4,3,2,2,1,1,0
4,2,3,0,19,17,2,0,2,3,4,0,2,1,1,0,2,3,4,0,1,0,1,0
1,3,2,2,2,0,2,0,3,2,1,2,2,0,2,1,3,2,1,2,2,0,2,0
3,4,0,4,6,4,2,1,4,0,3,4,2,1,1,0,4,0,3,4,1,0,1,0
2,2,2,0,14,6,8,0,2,2,2,0,8,3,5,0,2,2,2,0,5,2,3,0
0,3,4,3,16,1,15,10,3,4,0,3,15,1,14,9,3,4,0,3,14,1,13,9
3,3,4,2,8,5,3,1,3,4,3,2,3,2,1,0,3,4,3,2,1,0,1,0
4,2,3,3,12,10,2,1,2,3,4,3,2,1,1,0,2,3,4,3,1,0,1,0
0,2,3,2,18,1,17,8,2,3,0,2,17,1,16,7,2,3,0,2,16,1,15,7
1,0,3,2,28,8,20,10,0,3,1,2,20,6,14,7,0,3,1,2,14,4,10,5
1,3,4,1,5,1,4,1,3,4,1,1,4,1,3,0,3,4,1,1,3,0,3,0
2,0,3,1,20,9,11,3,0,3,2,1,11,5,6,1,0,3,2,1,6,3,3,0
2,4,1,3,0,0,0,0,4,1,2,3,0,0,0,0,4,1,2,3,0,0,0,0
0,1,4,0,28,2,26,2,1,4,0,0,26,2,24,2,1,4,0,0,24,2,22,2
1,4,0,0,2,0,2,0,4,0,1,0,2,0,2,0,4,0,1,0,2,0,2,0
4,3,2,0,12,10,2,0,3,2,4,0,2,1,1,0,3,2,4,0,1,0,1,0
4,4,2,3,3,2,1,0,4,2,4,3,1,0,1,0,4,2,4,3,1,0,1,0
3,1,1,0,16,11,5,0,1,1,3,0,5,3,2,0,1,1,3,0,2,1,1,0
2,0,4,1,26,12,14,4,0,4,2,1,14,6,8,2,0,4,2,1,8,4,4,1
1,4,1,3,7,2,5,3,4,1,1,3,5,1,4,2,4,1,1,3,4,1,3,2
0,0,3,2,25,2,23,11,0,3,0,2,23,2,21,10,0,3,0,2,21,2,19,9
0,0,0,1,12,1,11,3,0,0,0,1,11,1,10,2,0,0,0,1,10,1,9,2
3,1,3,4,25,17,8,7,1,3,3,4,8,5,3,2,1,3,3,4,3,2,1,0
1,0,1,0,11,3,8,0,0,1,1,0,8,2,6,0,0,1,1,0,6,1,5,0
2,2,3,4,21,10,11,9,2,3,2,4,11,5,6,5,2,3,2,4,6,2,4,3
0,4,1,4,6,0,6,5,4,1,0,4,6,0,6,5,4,1,0,4,6,0,6,5
3,2,0,4,6,4,2,1,2,0,3,4,2,1,1,0,2,0,3,4,1,0,1,0
1,4,1,2,9,2,7,3,4,1,1,2,7,2,5,2,4,1,1,2,5,1,4,2
3,4,1,0,13,9,4,0,4,1,3,0,4,2,2,0,4,1,3,0,2,1,1,0
3,4,1,1,7,4,3,0,4,1,3,1,3,2,1,0,4,1,3,1,1,0,1,0
3,1,0,1,3,2,1,0,1,0,3,1,1,0,1,0,1,0,3,1,1,0,1,0
1,3,3,0,14,4,10,0,3,3,1,0,10,2,8,0,3,3,1,0,8,2,6,0
1,2,2,1,21,6,15,4,2,2,1,1,15,4,11,3,2,2,1,1,11,3,8,2
4,4,0,2,23,20,3,1,4,0,4,2,3,2,1,0,4,0,4,2,1,0,1,0
1,1,3,0,28,8,20,2,1,3,1,0,20,6,14,1,1,3,1,0,14,4,10,1
2,1,4,0,28,13,15,1,1,4,2,0,15,7,8,0,1,4,2,0,8,3,5,0
3,2,2,3,20,13,7,4,2,2,3,3,7,4,3,2,2,2,3,3,3,2,1,0
3,1,4,4,19,13,6,5,1,4,3,4,6,4,2,1,1,4,3,4,2,1,1,0
4,3,3,2,6,5,1,0,3,3,4,2,1,0,1,0,3,3,4,2,1,0,1,0
1,1,3,4,13,3,10,9,1,3,1,4,10,2,8,7,1,3,1,4,8,2,6,5
0,4,0,2,3,0,3,1,4,0,0,2,3,0,3,1,4,0,0,2,3,0,3,1
4,2,2,2,14,12,2,1,2,2,4,2,2,1,1,0,2,2,4,2,1,0,1,0
4,2,3,0,24,21,3,0,2,3,4,0,3,2,1,0,2,3,4,0,1,0,1,0
0,4,2,3,10,0,10,6,4,2,0,3,10,0,10,6,4,2,0,3,10,1,9,6
2,4,4,1,0,0,0,0,4,4,2,1,0,0,0,0,4,4,2,1,0,0,0,0
4,4,4,4,11,9,2,1,4,4,4,4,2,1,1,0,4,4,4,4,1,0,1,0
0,1,3,1,18,1,17,5,1,3,0,1,17,1,16,4,1,3,0,1,16,1,15,4
4,0,3,1,26,23,3,0,0,3,4,1,3,2,1,0,0,3,4,1,1,0,1,0
2,2,1,1,10,5,5,1,2,1,2,1,5,2,3,0,2,1,2,1,3,1,2,0
2,3,0,3,0,0,0,0,3,0,2,3,0,0,0,0,3,0,2,3,0,0,0,0
0,4,0,3,9,0,9,6,4,0,0,3,9,0,9,6,4,0,0,3,9,0,9,6
4,2,0,2,8,7,1,0,2,0,4,2,1,0,1,0,2,0,4,2,1,0,1,0
2,0,4,0,29,14,15,1,0,4,2,0,15,7,8,0,0,4,2,0,8,3,5,0
0,2,3,0,21,2,19,1,2,3,0,0,19,1,18,1,2,3,0,0,18,1,17,1
1,0,1,3,14,4,10,7,0,1,1,3,10,2,8,5,0,1,1,3,8,2,6,4
2,3,2,0,20,10,10,0,3,2,2,0,10,4,6,0,3,2,2,0,6,2,4,0
0,3,4,0,9,0,9,0,3,4,0,0,9,0,9,0,3,4,0,0,9,0,9,0
3,4,1,1,4,2,2,0,4,1,3,1,2,1,1,0,4,1,3,1,1,0,1,0
1,2,1,1,12,3,9,2,2,1,1,1,9,2,7,2,2,1,1,1,7,2,5,1
1,4,2,3,3,0,3,2,4,2,1,3,3,0,3,2,4,2,1,3,3,0,3,2
4,3,4,0,6,5,1,0,3,4,4,0,1,0,1,0,3,4,4,0,1,0,1,0
2,2,1,4,14,7,7,6,2,1,2,4,7,3,4,3,2,1,2,4,4,2,2,1
1,0,3,2,26,7,19,9,0,3,1,2,19,5,14,7,0,3,1,2,14,4,10,5
0,2,2,3,14,1,13,9,2,2,0,3,13,1,12,8,2,2,0,3,12,1,11,7
1,4,4,1,11,3,8,2,4,4,1,1,8,2,6,1,4,4,1,1,6,1,5,1
2,4,3,1,0,0,0,0,4,3,2,1,0,0,0,0,4,3,2,1,0,0,0,0
3,4,3,2,13,9,4,1,4,3,3,2,4,2,2,1,4,3,3,2,2,1,1,0
3,2,1,0,6,4,2,0,2,1,3,0,2,1,1,0,2,1,3,0,1,0,1,0
2,4,2,4,11,5,6,5,4,2,2,4,6,3,3,2,4,2,2,4,3,1,2,1
1,1,0,1,8,2,6,1,1,0,1,1,6,1,5,1,1,0,1,1,5,1,4,1
2,1,1,4,17,8,9,8,1,1,2,4,9,4,5,4,1,1,2,4,5,2,3,2
3,1,2,2,18,12,6,2,1,2,3,2,6,4,2,1,1,2,3,2,2,1,1,0
0,1,0,4,10,0,10,9,1,0,0,4,10,1,9,8,1,0,0,4,9,0,9,8
4,0,2,2,15,13,2,1,0,2,4,2,2,1,1,0,0,2,4,2,1,0,1,0
3,3,3,3,17,11,6,4,3,3,3,3,6,4,2,1,3,3,3,3,2,1,1,0
0,0,4,0,29,2,27,2,0,4,0,0,27,2,25,2,0,4,0,0,25,2,23,2
3,4,2,2,8,5,3,1,4,2,3,2,3,2,1,0,4,2,3,2,1,0,1,0
2,4,2,2,8,3,5,2,4,2,2,2,5,2,3,1,4,2,2,2,3,1,2,1
0,2,2,1,10,1,9,2,2,2,0,1,9,0,9,2,2,2,0,1,9,0,9,2
1,3,0,0,8,2,6,0,3,0,1,0,6,1,5,0,3,0,1,0,5,1,4,0
2,4,2,4,11,5,6,5,4,2,2,4,6,3,3,2,4,2,2,4,3,1,2,1
4,4,2,4,4,3,1,0,4,2,4,4,1,0,1,0,4,2,4,4,1,0,1,0
3,3,3,0,7,4,3,0,3,3,3,0,3,2,1,0,3,3,3,0,1,0,1,0
2,3,3,3,17,8,9,6,3,3,2,3,9,4,5,3,3,3,2,3,5,2,3,2
3,4,3,3,5,3,2,1,4,3,3,3,2,1,1,0,4,3,3,3,1,0,1,0
1,1,4,2,29,8,21,10,1,4,1,2,21,6,15,7,1,4,1,2,15,4,11,5
0,4,4,0,13,1,12,1,4,4,0,0,12,1,11,1,4,4,0,0,11,1,10,1
3,0,4,0,27,18,9,0,0,4,3,0,9,6,3,0,0,4,3,0,3,2,1,0
0,0,3,1,29,3,26,7,0,3,0,1,26,2,24,7,0,3,0,1,24,2,22,6
2,2,0,2,4,2,2,0,2,0,2,2,2,1,1,0,2,0,2,2,1,0,1,0
3,3,1,3,12,8,4,2,3,1,3,3,4,2,2,1,3,1,3,3,2,1,1,0
2,2,1,0,13,6,7,0,2,1,2,0,7,3,4,0,2,1,2,0,4,2,2,0
3,0,3,0,28,19,9,0,0,3,3,0,9,6,3,0,0,3,3,0,3,2,1,0
1,1,4,1,22,6,16,4,1,4,1,1,16,4,12,3,1,4,1,1,12,3,9,2
0,1,0,0,11,1,10,1,1,0,0,0,10,1,9,0,1,0,0,0,9,0,9,0
0,1,4,1,19,1,18,5,1,4,0,1,18,1,17,5,1,4,0,1,17,1,16,4
4,4,3,1,5,4,1,0,4,3,4,1,1,0,1,0,4,3,4,1,1,0,1,0
4,4,4,2,11,9,2,1,4,4,4,2,2,1,1,0,4,4,4,2,1,0,1,0
0,0,4,3,29,2,27,18,0,4,0,3,27,2,25,17,0,4,0,3,25,2,23,16
3,3,2,1,2,1,1,0,3,2,3,1,1,0,1,0,3,2,3,1,1,0,1,0
4,3,2,1,12,10,2,0,3,2,4,1,2,1,1,0,3,2,4,1,1,0,1,0
0,2,3,0,17,1,16,1,2,3,0,0,16,1,15,1,2,3,0,0,15,1,14,1
1,2,0,3,7,2,5,3,2,0,1,3,5,1,4,2,2,0,1,3,4,1,3,2
2,1,2,1,16,7,9,2,1,2,2,1,9,4,5,1,1,2,2,1,5,2,3,0
0,0,3,3,21,2,19,13,0,3,0,3,19,1,18,12,0,3,0,3,18,1,17,11
0,2,0,0,10,1,9,0,2,0,0,0,9,0,9,0,2,0,0,0,9,0,9,0
4,4,4,4,6,5,1,0,4,4,4,4,1,0,1,0,4,4,4,4,1,0,1,0
3,0,3,4,28,19,9,8,0,3,3,4,9,6,3,2,0,3,3,4,3,2,1,0
0,1,1,4,15,1,14,12,1,1,0,4,14,1,13,11,1,1,0,4,13,1,12,10
0,1,1,2,7,0,7,3,1,1,0,2,7,0,7,3,1,1,0,2,7,0,7,3
4,2,3,3,13,11,2,1,2,3,4,3,2,1,1,0,2,3,4,3,1,0,1,0
2,3,4,4,23,11,12,10,3,4,2,4,12,5,7,6,3,4,2,4,7,3,4,3
3,3,4,0,9,6,3,0,3,4,3,0,3,2,1,0,3,4,3,0,1,0,1,0
0,4,1,2,7,0,7,3,4,1,0,2,7,0,7,3,4,1,0,2,7,0,7,3
2,0,0,4,3,1,2,1,0,0,2,4,2,0,2,1,0,0,2,4,2,1,1,0
1,1,4,4,28,8,20,17,1,4,1,4,20,6,14,12,1,4,1,4,14,4,10,8
2,4,2,0,5,2,3,0,4,2,2,0,3,1,2,0,4,2,2,0,2,0,2,0
4,3,0,1,8,7,1,0,3,0,4,1,1,0,1,0,3,0,4,1,1,0,1,0
2,4,0,3,2,0,2,1,4,0,2,3,2,0,2,1,4,0,2,3,2,0,2,1
3,1,2,4,20,13,7,6,1,2,3,4,7,4,3,2,1,2,3,4,3,2,1,0
0,3,0,4,4,0,4,3,3,0,0,4,4,0,4,3,3,0,0,4,4,0,4,3
3,2,4,4,29,20,9,8,2,4,3,4,9,6,3,2,2,4,3,4,3,2,1,0
4,4,0,0,1,0,1,0,4,0,4,0,1,0,1,0,4,0,4,0,1,0,1,0
4,0,2,1,21,18,3,0,0,2,4,1,3,2,1,0,0,2,4,1,1,0,1,0
0,2,3,0,14,1,13,1,2,3,0,0,13,1,12,1,2,3,0,0,12,1,11,1
0,0,2,3,13,1,12,8,0,2,0,3,12,1,11,7,0,2,0,3,11,1,10,6
3,1,2,0,11,7,4,0,1,2,3,0,4,2,2,0,1,2,3,0,2,1,1,0
4,0,3,4,28,25,3,2,0,3,4,4,3,2,1,0,0,3,4,4,1,0,1,0
0,1,3,3,24,2,22,15,1,3,0,3,22,2,20,14,1,3,0,3,20,1,19,13
0,0,3,3,27,2,25,17,0,3,0,3,25,2,23,16,0,3,0,3,23,2,21,14
0,1,2,3,23,2,21,14,1,2,0,3,21,2,19,13,1,2,0,3,19,1,18,12
3,2,0,1,4,2,2,0,2,0,3,1,2,1,1,0,2,0,3,1,1,0,1,0
2,2,2,3,20,9,11,7,2,2,2,3,11,5,6,4,2,2,2,3,6,2,4,2
2,4,3,2,5,2,3,1,4,3,2,2,3,1,2,0,4,3,2,2,2,0,2,1
3,2,1,2,16,11,5,2,2,1,3,2,5,3,2,0,2,1,3,2,2,1,1,0
3,1,0,2,8,5,3,1,1,0,3,2,3,2,1,0,1,0,3,2,1,0,1,0
2,4,4,2,13,6,7,3,4,4,2,2,7,3,4,2,4,4,2,2,4,2,2,1
2,1,0,0,6,2,4,0,1,0,2,0,4,2,2,0,1,0,2,0,2,0,2,0
0,0,4,1,29,2,27,8,0,4,0,1,27,2,25,7,0,4,0,1,25,2,23,6
2,3,4,3,12,5,7,4,3,4,2,3,7,3,4,2,3,4,2,3,4,1,3,2
4,1,1,0,8,7,1,0,1,1,4,0,1,0,1,0,1,1,4,0,1,0,1,0
3,1,4,0,27,18,9,0,1,4,3,0,9,6,3,0,1,4,3,0,3,2,1,0
1,0,0,4,2,0,2,1,0,0,1,4,2,0,2,1,0,0,1,4,2,0,2,1
0,0,4,2,28,2,26,12,0,4,0,2,26,2,24,12,0,4,0,2,24,2,22,11
2,1,3,0,28,13,15,1,1,3,2,0,15,7,8,0,1,3,2,0,8,4,4,0
3,0,1,4,10,6,4,3,0,1,3,4,4,2,2,1,0,1,3,4,2,1,1,0
3,4,3,4,2,1,1,0,4,3,3,4,1,0,1,0,4,3,3,4,1,0,1,0
1,1,0,4,4,1,3,2,1,0,1,4,3,0,3,2,1,0,1,4,3,0,3,2
3,1,2,2,21,14,7,3,1,2,3,2,7,4,3,1,1,2,3,2,3,2,1,0
4,3,3,0,2,1,1,0,3,3,4,0,1,0,1,0,3,3,4,0,1,0,1,0
2,1,1,3,3,1,2,1,1,1,2,3,2,0,2,1,1,1,2,3,2,0,2,1
2,2,0,2,4,1,3,1,2,0,2,2,3,1,2,0,2,0,2,2,2,0,2,1
3,1,3,2,18,12,6,3,1,3,3,2,6,4,2,0,1,3,3,2,2,1,1,0
0,1,2,1,22,2,20,5,1,2,0,1,20,1,19,5,1,2,0,1,19,1,18,5
4,3,1,4,6,5,1,0,3,1,4,4,1,0,1,0,3,1,4,4,1,0,1,0
0,1,1,3,16,1,15,10,1,1,0,3,15,1,14,9,1,1,0,3,14,1,13,9
1,4,4,2,0,0,0,0,4,4,1,2,0,0,0,0,4,4,1,2,0,0,0,0
0,4,2,3,7,0,7,4,4,2,0,3,7,0,7,4,4,2,0,3,7,0,7,4
2,4,3,0,2,1,1,0,4,3,2,0,1,0,1,0,4,3,2,0,1,0,1,0
0,2,3,4,13,1,12,10,2,3,0,4,12,1,11,9,2,3,0,4,11,1,10,8
0,3,1,1,7,0,7,2,3,1,0,1,7,0,7,2,3,1,0,1,7,0,7,2
4,2,0,1,3,2,1,0,2,0,4,1,1,0,1,0,2,0,4,1,1,0,1,0
1,2,4,4,28,8,20,18,2,4,1,4,20,6,14,12,2,4,1,4,14,4,10,8
2,1,3,1,22,11,11,3,1,3,2,1,11,5,6,1,1,3,2,1,6,3,3,0
1,1,2,1,25,7,18,5,1,2,1,1,18,5,13,3,1,2,1,1,13,3,10,2
4,4,2,4,1,0,1,0,4,2,4,4,1,0,1,0,4,2,4,4,1,0,1,0
0,3,2,4,8,0,8,7,3,2,0,4,8,0,8,7,3,2,0,4,8,0,8,7
3,4,0,1,2,1,1,0,4,0,3,1,1,0,1,0,4,0,3,1,1,0,1,0
4,4,3,3,0,0,0,0,4,3,4,3,0,0,0,0,4,3,4,3,0,0,0,0
2,0,0,1,8,4,4,1,0,0,2,1,4,1,3,0,0,0,2,1,3,1,2,0
0,1,0,0,7,0,7,0,1,0,0,0,7,0,7,0,1,0,0,0,7,0,7,0
4,3,1,4,4,3,1,0,3,1,4,4,1,0,1,0,3,1,4,4,1,0,1,0
0,0,4,2,28,2,26,13,0,4,0,2,26,2,24,12,0,4,0,2,24,2,22,10
2,3,4,0,16,7,9,0,3,4,2,0,9,4,5,0,3,4,2,0,5,2,3,0
0,2,4,3,20,2,18,12,2,4,0,3,18,1,17,11,2,4,0,3,17,1,16,11
2,3,0,1,0,0,0,0,3,0,2,1,0,0,0,0,3,0,2,1,0,0,0,0
3,0,1,0,7,4,3,0,0,1,3,0,3,2,1,0,0,1,3,0,1,0,1,0
1,3,0,4,0,0,0,0,3,0,1,4,0,0,0,0,3,0,1,4,0,0,0,0
2,3,2,1,4,1,3,0,3,2,2,1,3,1,2,0,3,2,2,1,2,0,2,0
2,1,4,2,17,8,9,4,1,4,2,2,9,4,5,2,1,4,2,2,5,2,3,1
2,2,4,3,26,13,13,9,2,4,2,3,13,6,7,4,2,4,2,3,7,3,4,2
3,4,3,3,8,5,3,2,4,3,3,3,3,2,1,0,4,3,3,3,1,0,1,0
4,4,0,0,11,9,2,0,4,0,4,0,2,1,1,0,4,0,4,0,1,0,1,0
0,0,1,2,16,1,15,7,0,1,0,2,15,1,14,7,0,1,0,2,14,1,13,6
3,0,2,1,21,14,7,2,0,2,3,1,7,4,3,0,0,2,3,1,3,2,1,0
1,4,2,4,4,1,3,2,4,2,1,4,3,0,3,2,4,2,1,4,3,0,3,2
0,0,2,3,17,1,16,11,0,2,0,3,16,1,15,10,0,2,0,3,15,1,14,9
4,3,3,1,4,3,1,0,3,3,4,1,1,0,1,0,3,3,4,1,1,0,1,0
0,3,3,1,11,1,10,2,3,3,0,1,10,0,10,2,3,3,0,1,10,1,9,2
3,2,0,3,3,2,1,0,2,0,3,3,1,0,1,0,2,0,3,3,1,0,1,0
0,0,1,2,11,1,10,4,0,1,0,2,10,0,10,4,0,1,0,2,10,1,9,4
4,4,1,2,5,4,1,0,4,1,4,2,1,0,1,0,4,1,4,2,1,0,1,0
0,3,2,3,11,1,10,6,3,2,0,3,10,1,9,6,3,2,0,3,9,0,9,6
1,4,0,0,2,0,2,0,4,0,1,0,2,0,2,0,4,0,1,0,2,0,2,0
3,2,4,4,18,12,6,5,2,4,3,4,6,4,2,1,2,4,3,4,2,1,1,0
0,1,4,2,21,2,19,9,1,4,0,2,19,1,18,9,1,4,0,2,18,1,17,8
3,1,3,3,26,18,8,5,1,3,3,3,8,5,3,2,1,3,3,3,3,2,1,0
0,1,1,2,13,1,12,5,1,1,0,2,12,1,11,5,1,1,0,2,11,1,10,4
1,0,3,1,27,8,19,5,0,3,1,1,19,5,14,4,0,3,1,1,14,4,10,2
0,2,1,2,11,1,10,4,2,1,0,2,10,1,9,4,2,1,0,2,9,0,9,4
0,0,2,4,24,2,22,19,0,2,0,4,22,2,20,17,0,2,0,4,20,1,19,17
2,2,2,4,13,6,7,6,2,2,2,4,7,3,4,3,2,2,2,4,4,1,3,2
2,2,2,4,8,3,5,4,2,2,2,4,5,2,3,2,2,2,2,4,3,1,2,1
0,1,2,4,22,2,20,18,1,2,0,4,20,1,19,17,1,2,0,4,19,1,18,16
3,4,3,1,7,4,3,0,4,3,3,1,3,2,1,0,4,3,3,1,1,0,1,0
0,0,3,4,29,2,27,24,0,3,0,4,27,2,25,22,0,3,0,4,25,2,23,20
4,2,1,1,18,16,2,0,2,1,4,1,2,1,1,0,2,1,4,1,1,0,1,0
1,4,4,4,11,3,8,7,4,4,1,4,8,2,6,5,4,4,1,4,6,1,5,4
0,0,1,4,17,1,16,14,0,1,0,4,16,1,15,13,0,1,0,4,15,1,14,12
2,3,2,3,7,3,4,2,3,2,2,3,4,2,2,1,3,2,2,3,2,1,1,0
2,0,4,2,28,14,14,6,0,4,2,2,14,7,7,3,0,4,2,2,7,3,4,2
1,3,4,0,14,4,10,1,3,4,1,0,10,2,8,0,3,4,1,0,8,2,6,0
3,4,3,4,7,4,3,2,4,3,3,4,3,2,1,0,4,3,3,4,1,0,1,0
1,0,3,0,29,8,21,2,0,3,1,0,21,6,15,1,0,3,1,0,15,4,11,1
4,0,2,4,20,18,2,1,0,2,4,4,2,1,1,0,0,2,4,4,1,0,1,0
0,4,0,4,1,0,1,0,4,0,0,4,1,0,1,0,4,0,0,4,1,0,1,0
1,0,2,0,20,6,14,1,0,2,1,0,14,4,10,0,0,2,1,0,10,3,7,0
0,0,1,3,11,1,10,6,0,1,0,3,10,1,9,6,0,1,0,3,9,0,9,6
1,4,1,3,0,0,0,0,4,1,1,3,0,0,0,0,4,1,1,3,0,0,0,0
4,0,3,2,27,24,3,1,0,3,4,2,3,2,1,0,0,3,4,2,1,0,1,0
0,0,3,3,27,2,25,17,0,3,0,3,25,2,23,16,0,3,0,3,23,2,21,14
0,0,4,0,29,2,27,2,0,4,0,0,27,2,25,2,0,4,0,0,25,2,23,2
3,0,2,3,24,16,8,5,0,2,3,3,8,5,3,2,0,2,3,3,3,2,1,0
4,0,4,0,29,26,3,0,0,4,4,0,3,2,1,0,0,4,4,0,1,0,1,0
0,4,3,3,5,0,5,3,4,3,0,3,5,0,5,3,4,3,0,3,5,0,5,3
1,2,2,0,12,3,9,0,2,2,1,0,9,2,7,0,2,2,1,0,7,2,5,0
1,2,4,0,23,6,17,1,2,4,1,0,17,5,12,1,2,4,1,0,12,3,9,0
1,0,4,1,27,8,19,5,0,4,1,1,19,5,14,4,0,4,1,1,14,4,10,3
4,4,4,0,7,6,1,0,4,4,4,0,1,0,1,0,4,4,4,0,1,0,1,0
0,2,1,1,8,0,8,2,2,1,0,1,8,0,8,2,2,1,0,1,8,0,8,2
2,1,2,4,5,2,3,2,1,2,2,4,3,1,2,1,1,2,2,4,2,1,1,0
4,4,0,4,4,3,1,0,4,0,4,4,1,0,1,0,4,0,4,4,1,0,1,0
0,0,3,2,22,2,20,9,0,3,0,2,20,2,18,8,0,3,0,2,18,1,17,8
0,2,0,3,14,1,13,9,2,0,0,3,13,1,12,8,2,0,0,3,12,1,11,7
3,4,4,1,8,5,3,0,4,4,3,1,3,2,1,0,4,4,3,1,1,0,1,0
1,4,0,0,0,0,0,0,4,0,1,0,0,0,0,0,4,0,1,0,0,0,0,0
0,1,2,2,9,0,9,4,1,2,0,2,9,0,9,4,1,2,0,2,9,0,9,4
3,0,1,0,21,14,7,0,0,1,3,0,7,4,3,0,0,1,3,0,3,2,1,0
4,1,1,3,16,14,2,1,1,1,4,3,2,1,1,0,1,1,4,3,1,0,1,0
3,1,4,3,24,16,8,5,1,4,3,3,8,5,3,2,1,4,3,3,3,2,1,0
4,0,3,2,24,21,3,1,0,3,4,2,3,2,1,0,0,3,4,2,1,0,1,0
3,1,0,3,8,5,3,2,1,0,3,3,3,2,1,0,1,0,3,3,1,0,1,0
4,0,3,0,26,23,3,0,0,3,4,0,3,2,1,0,0,3,4,0,1,0,1,0
0,4,4,3,4,0,4,2,4,4,0,3,4,0,4,2,4,4,0,3,4,0,4,2
1,3,2,3,10,3,7,4,3,2,1,3,7,2,5,3,3,2,1,3,5,1,4,2
0,2,4,2,14,1,13,6,2,4,0,2,13,1,12,6,2,4,0,2,12,1,11,5
3,0,0,3,6,4,2,1,0,0,3,3,2,1,1,0,0,0,3,3,1,0,1,0
3,2,2,0,6,4,2,0,2,2,3,0,2,1,1,0,2,2,3,0,1,0,1,0
0,2,4,4,22,2,20,17,2,4,0,4,20,2,18,16,2,4,0,4,18,1,17,15
1,2,4,3,27,8,19,13,2,4,1,3,19,5,14,9,2,4,1,3,14,4,10,7
4,2,2,2,15,13,2,0,2,2,4,2,2,1,1,0,2,2,4,2,1,0,1,0
2,2,3,2,15,7,8,3,2,3,2,2,8,3,5,2,2,3,2,2,5,2,3,1
0,3,4,4,8,0,8,7,3,4,0,4,8,0,8,7,3,4,0,4,8,0,8,7
4,0,0,0,7,6,1,0,0,0,4,0,1,0,1,0,0,0,4,0,1,0,1,0
2,0,1,4,19,9,10,8,0,1,2,4,10,4,6,5,0,1,2,4,6,3,3,2
1,0,1,1,13,3,10,3,0,1,1,1,10,2,8,2,0,1,1,1,8,2,6,1
1,3,3,2,11,3,8,4,3,3,1,2,8,2,6,3,3,3,1,2,6,1,5,2
4,0,3,2,29,26,3,1,0,3,4,2,3,2,1,0,0,3,4,2,1,0,1,0
1,4,2,0,2,0,2,0,4,2,1,0,2,0,2,0,4,2,1,0,2,0,2,0
2,0,3,2,27,13,14,7,0,3,2,2,14,7,7,3,0,3,2,2,7,3,4,2
0,3,4,4,13,1,12,10,3,4,0,4,12,1,11,9,3,4,0,4,11,1,10,8
2,0,4,1,29,14,15,4,0,4,2,1,15,7,8,2,0,4,2,1,8,4,4,1
3,1,2,1,23,16,7,2,1,2,3,1,7,4,3,0,1,2,3,1,3,2,1,0
0,2,4,3,17,1,16,11,2,4,0,3,16,1,15,10,2,4,0,3,15,1,14,9
2,3,4,2,21,10,11,5,3,4,2,2,11,5,6,3,3,4,2,2,6,2,4,1
2,0,3,1,29,14,15,4,0,3,2,1,15,7,8,2,0,3,2,1,8,3,5,1
2,4,2,4,9,4,5,4,4,2,2,4,5,2,3,2,4,2,2,4,3,1,2,1
1,3,3,1,21,6,15,4,3,3,1,1,15,4,11,3,3,3,1,1,11,3,8,2
2,2,3,2,13,6,7,3,2,3,2,2,7,3,4,2,2,3,2,2,4,2,2,1
0,3,4,1,15,1,14,4,3,4,0,1,14,1,13,3,3,4,0,1,13,1,12,3
3,4,0,1,0,0,0,0,4,0,3,1,0,0,0,0,4,0,3,1,0,0,0,0
4,2,0,0,8,7,1,0,2,0,4,0,1,0,1,0,2,0,4,0,1,0,1,0
3,0,1,1,11,7,4,1,0,1,3,1,4,2,2,0,0,1,3,1,2,1,1,0
3,3,3,0,16,11,5,0,3,3,3,0,5,3,2,0,3,3,3,0,2,1,1,0
2,1,4,4,27,13,14,12,1,4,2,4,14,6,8,7,1,4,2,4,8,4,4,3
0,1,0,1,6,0,6,1,1,0,0,1,6,0,6,1,1,0,0,1,6,0,6,1
3,4,2,0,2,1,1,0,4,2,3,0,1,0,1,0,4,2,3,0,1,0,1,0
1,3,3,3,7,2,5,3,3,3,1,3,5,1,4,2,3,3,1,3,4,1,3,2
4,2,1,3,5,4,1,0,2,1,4,3,1,0,1,0,2,1,4,3,1,0,1,0
1,0,4,0,29,8,21,2,0,4,1,0,21,6,15,1,0,4,1,0,15,4,11,1
0,3,2,1,7,0,7,2,3,2,0,1,7,0,7,2,3,2,0,1,7,0,7,2
3,1,4,3,24,16,8,5,1,4,3,3,8,5,3,2,1,4,3,3,3,2,1,0
3,4,2,0,5,3,2,0,4,2,3,0,2,1,1,0,4,2,3,0,1,0,1,0
1,2,3,1,23,6,17,5,2,3,1,1,17,5,12,3,2,3,1,1,12,3,9,2
3,0,4,0,27,18,9,0,0,4,3,0,9,6,3,0,0,4,3,0,3,2,1,0
0,2,2,4,13,1,12,10,2,2,0,4,12,1,11,9,2,2,0,4,11,1,10,9
4,2,2,3,20,17,3,2,2,2,4,3,3,2,1,0,2,2,4,3,1,0,1,0
0,2,4,2,16,1,15,7,2,4,0,2,15,1,14,7,2,4,0,2,14,1,13,6
3,2,2,3,6,4,2,1,2,2,3,3,2,1,1,0,2,2,3,3,1,0,1,0
3,4,4,2,24,16,8,3,4,4,3,2,8,5,3,1,4,4,3,2,3,2,1,0
1,3,3,1,18,5,13,3,3,3,1,1,13,3,10,2,3,3,1,1,10,3,7,2
2,4,1,2,8,4,4,1,4,1,2,2,4,1,3,1,4,1,2,2,3,1,2,0
0,2,2,4,15,1,14,12,2,2,0,4,14,1,13,11,2,2,0,4,13,1,12,10
3,3,4,2,8,5,3,1,3,4,3,2,3,2,1,0,3,4,3,2,1,0,1,0
4,2,3,2,19,17,2,1,2,3,4,2,2,1,1,0,2,3,4,2,1,0,1,0
3,1,1,2,7,4,3,1,1,1,3,2,3,2,1,0,1,1,3,2,1,0,1,0
1,3,2,2,17,5,12,6,3,2,1,2,12,3,9,4,3,2,1,2,9,2,7,3
2,3,3,1,8,3,5,1,3,3,2,1,5,2,3,0,3,3,2,1,3,1,2,0
0,0,3,0,21,2,19,1,0,3,0,0,19,1,18,1,0,3,0,0,18,1,17,1
4,1,2,4,22,19,3,2,1,2,4,4,3,2,1,0,1,2,4,4,1,0,1,0
4,2,1,0,11,9,2,0,2,1,4,0,2,1,1,0,2,1,4,0,1,0,1,0
4,4,3,4,7,6,1,0,4,3,4,4,1,0,1,0,4,3,4,4,1,0,1,0
2,0,0,2,10,5,5,2,0,0,2,2,5,2,3,1,0,0,2,2,3,1,2,1
0,2,1,3,16,1,15,10,2,1,0,3,15,1,14,9,2,1,0,3,14,1,13,9
1,4,4,1,12,3,9,2,4,4,1,1,9,2,7,2,4,4,1,1,7,2,5,1
3,3,4,2,15,10,5,2,3,4,3,2,5,3,2,1,3,4,3,2,2,1,1,0
4,1,4,3,27,24,3,2,1,4,4,3,3,2,1,0,1,4,4,3,1,0,1,0
2,1,1,3,11,5,6,4,1,1,2,3,6,3,3,2,1,1,2,3,3,1,2,1
1,4,4,1,1,0,1,0,4,4,1,1,1,0,1,0,4,4,1,1,1,0,1,0
0,3,0,0,0,0,0,0,3,0,0,0,0,0,0,0,3,0,0,0,0,0,0,0
4,0,3,4,25,22,3,2,0,3,4,4,3,2,1,0,0,3,4,4,1,0,1,0
1,1,4,0,16,4,12,1,1,4,1,0,12,3,9,0,1,4,1,0,9,2,7,0
4,4,1,4,0,0,0,0,4,1,4,4,0,0,0,0,4,1,4,4,0,0,0,0
2,2,4,3,19,9,10,7,2,4,2,3,10,5,5,3,2,4,2,3,5,2,3,2
4,0,3,1,26,23,3,0,0,3,4,1,3,2,1,0,0,3,4,1,1,0,1,0
0,3,0,1,8,0,8,2,3,0,0,1,8,0,8,2,3,0,0,1,8,0,8,2
0,3,2,0,16,1,15,1,3,2,0,0,15,1,14,1,3,2,0,0,14,1,13,1
2,1,1,1,23,11,12,3,1,1,2,1,12,5,7,2,1,1,2,1,7,3,4,1
4,4,2,3,6,5,1,0,4,2,4,3,1,0,1,0,4,2,4,3,1,0,1,0
1,3,0,0,2,0,2,0,3,0,1,0,2,0,2,0,3,0,1,0,2,0,2,0
3,3,3,2,6,4,2,0,3,3,3,2,2,1,1,0,3,3,3,2,1,0,1,0
2,1,3,3,22,11,11,7,1,3,2,3,11,5,6,4,1,3,2,3,6,2,4,2
3,1,0,0,2,1,1,0,1,0,3,0,1,0,1,0,1,0,3,0,1,0,1,0
0,2,0,4,1,0,1,0,2,0,0,4,1,0,1,0,2,0,0,4,1,0,1,0
3,1,0,0,4,2,2,0,1,0,3,0,2,1,1,0,1,0,3,0,1,0,1,0
4,3,3,4,4,3,1,0,3,3,4,4,1,0,1,0,3,3,4,4,1,0,1,0
2,0,2,0,17,8,9,0,0,2,2,0,9,4,5,0,0,2,2,0,5,2,3,0
3,2,1,0,6,4,2,0,2,1,3,0,2,1,1,0,2,1,3,0,1,0,1,0
4,4,2,2,14,12,2,0,4,2,4,2,2,1,1,0,4,2,4,2,1,0,1,0
4,1,3,0,21,18,3,0,1,3,4,0,3,2,1,0,1,3,4,0,1,0,1,0
0,2,1,0,18,1,17,1,2,1,0,0,17,1,16,1,2,1,0,0,16,1,15,1
0,0,0,4,5,0,5,4,0,0,0,4,5,0,5,4,0,0,0,4,5,0,5,4
3,3,0,4,4,2,2,1,3,0,3,4,2,1,1,0,3,0,3,4,1,0,1,0
1,3,2,1,4,1,3,0,3,2,1,1,3,0,3,0,3,2,1,1,3,0,3,0
1,0,1,0,17,5,12,1,0,1,1,0,12,3,9,0,0,1,1,0,9,2,7,0
2,1,2,3,13,6,7,4,1,2,2,3,7,3,4,2,1,2,2,3,4,1,3,2
3,2,4,3,17,11,6,4,2,4,3,3,6,4,2,1,2,4,3,3,2,1,1,0
2,0,4,0,26,12,14,1,0,4,2,0,14,6,8,0,0,4,2,0,8,3,5,0
3,1,2,3,23,16,7,4,1,2,3,3,7,4,3,2,1,2,3,3,3,2,1,0
2,1,4,1,24,11,13,3,1,4,2,1,13,6,7,2,1,4,2,1,7,3,4,1
1,3,4,4,19,5,14,12,3,4,1,4,14,4,10,8,3,4,1,4,10,2,8,7
1,1,1,4,14,4,10,8,1,1,1,4,10,2,8,7,1,1,1,4,8,2,6,5
2,2,2,3,9,4,5,3,2,2,2,3,5,2,3,2,2,2,2,3,3,1,2,1
1,1,2,2,13,3,10,4,1,2,1,2,10,2,8,3,1,2,1,2,8,2,6,3
4,4,1,1,4,3,1,0,4,1,4,1,1,0,1,0,4,1,4,1,1,0,1,0
2,0,1,2,12,5,7,3,0,1,2,2,7,3,4,2,0,1,2,2,4,2,2,0
3,3,3,3,15,10,5,3,3,3,3,3,5,3,2,1,3,3,3,3,2,1,1,0
3,0,2,2,19,13,6,3,0,2,3,2,6,4,2,0,0,2,3,2,2,1,1,0
0,4,1,3,3,0,3,2,4,1,0,3,3,0,3,2,4,1,0,3,3,0,3,2
0,0,4,1,29,2,27,8,0,4,0,1,27,2,25,7,0,4,0,1,25,2,23,6
4,3,0,1,9,8,1,0,3,0,4,1,1,0,1,0,3,0,4,1,1,0,1,0
2,0,1,3,21,10,11,7,0,1,2,3,11,5,6,4,0,1,2,3,6,3,3,2
4,4,2,4,0,0,0,0,4,2,4,4,0,0,0,0,4,2,4,4,0,0,0,0
2,0,0,3,6,2,4,2,0,0,2,3,4,2,2,1,0,0,2,3,2,1,1,0
3,4,1,0,6,4,2,0,4,1,3,0,2,1,1,0,4,1,3,0,1,0,1,0
3,3,4,3,15,10,5,3,3,4,3,3,5,3,2,1,3,4,3,3,2,1,1,0
0,1,0,1,11,1,10,2,1,0,0,1,10,0,10,2,1,0,0,1,10,0,10,2
2,3,2,2,8,3,5,2,3,2,2,2,5,2,3,1,3,2,2,2,3,1,2,1
2,1,1,2,23,11,12,6,1,1,2,2,12,5,7,3,1,1,2,2,7,3,4,2
3,3,2,3,6,4,2,1,3,2,3,3,2,1,1,0,3,2,3,3,1,0,1,0
0,4,2,4,10,1,9,8,4,2,0,4,9,0,9,8,4,2,0,4,9,0,9,8
2,4,3,0,9,4,5,0,4,3,2,0,5,2,3,0,4,3,2,0,3,1,2,0
0,0,2,3,26,2,24,16,0,2,0,3,24,2,22,15,0,2,0,3,22,2,20,14
0,2,0,4,3,0,3,2,2,0,0,4,3,0,3,2,2,0,0,4,3,0,3,2
4,2,3,0,15,13,2,0,2,3,4,0,2,1,1,0,2,3,4,0,1,0,1,0
2,2,2,2,8,4,4,1,2,2,2,2,4,1,3,1,2,2,2,2,3,1,2,1
3,1,3,1,27,18,9,2,1,3,3,1,9,6,3,0,1,3,3,1,3,2,1,0
1,2,2,3,11,3,8,5,2,2,1,3,8,2,6,4,2,2,1,3,6,1,5,3
4,4,0,4,3,2,1,0,4,0,4,4,1,0,1,0,4,0,4,4,1,0,1,0
1,4,4,1,2,0,2,0,4,4,1,1,2,0,2,0,4,4,1,1,2,0,2,0
4,4,0,0,3,2,1,0,4,0,4,0,1,0,1,0,4,0,4,0,1,0,1,0
0,3,3,1,9,0,9,2,3,3,0,1,9,0,9,2,3,3,0,1,9,0,9,2
0,4,3,0,12,1,11,1,4,3,0,0,11,1,10,1,4,3,0,0,10,0,10,0
1,2,1,2,2,0,2,0,2,1,1,2,2,0,2,1,2,1,1,2,2,0,2,1
0,3,0,4,3,0,3,2,3,0,0,4,3,0,3,2,3,0,0,4,3,0,3,2
0,2,1,0,9,0,9,0,2,1,0,0,9,0,9,0,2,1,0,0,9,0,9,0
4,4,2,2,7,6,1,0,4,2,4,2,1,0,1,0,4,2,4,2,1,0,1,0
3,1,0,1,9,6,3,0,1,0,3,1,3,2,1,0,1,0,3,1,1,0,1,0
3,3,1,4,9,6,3,2,3,1,3,4,3,2,1,0,3,1,3,4,1,0,1,0
3,4,1,1,4,2,2,0,4,1,3,1,2,1,1,0,4,1,3,1,1,0,1,0
2,0,1,3,12,6,6,4,0,1,2,3,6,3,3,2,0,1,2,3,3,1,2,1
0,3,0,0,2,0,2,0,3,0,0,0,2,0,2,0,3,0,0,0,2,0,2,0
3,0,0,3,8,5,3,2,0,0,3,3,3,2,1,0,0,0,3,3,1,0,1,0
2,1,3,1,29,14,15,4,1,3,2,1,15,7,8,2,1,3,2,1,8,4,4,1
4,1,4,1,22,19,3,0,1,4,4,1,3,2,1,0,1,4,4,1,1,0,1,0
0,4,4,4,4,0,4,3,4,4,0,4,4,0,4,3,4,4,0,4,4,0,4,3
0,1,0,4,3,0,3,2,1,0,0,4,3,0,3,2,1,0,0,4,3,0,3,2
0,4,2,3,4,0,4,2,4,2,0,3,4,0,4,2,4,2,0,3,4,0,4,2
2,1,0,2,11,5,6,2,1,0,2,2,6,3,3,1,1,0,2,2,3,1,2,1
4,0,4,1,22,19,3,0,0,4,4,1,3,2,1,0,0,4,4,1,1,0,1,0
2,3,0,3,8,3,5,3,3,0,2,3,5,2,3,2,3,0,2,3,3,1,2,1
3,4,3,1,11,7,4,1,4,3,3,1,4,2,2,0,4,3,3,1,2,1,1,0
3,3,2,4,5,3,2,1,3,2,3,4,2,1,1,0,3,2,3,4,1,0,1,0
2,4,4,1,5,2,3,0,4,4,2,1,3,1,2,0,4,4,2,1,2,1,1,0
2,1,1,4,13,6,7,6,1,1,2,4,7,3,4,3,1,1,2,4,4,1,3,2
2,1,1,0,12,6,6,0,1,1,2,0,6,2,4,0,1,1,2,0,4,2,2,0
3,1,4,4,18,12,6,5,1,4,3,4,6,4,2,1,1,4,3,4,2,1,1,0
4,0,4,0,25,22,3,0,0,4,4,0,3,2,1,0,0,4,4,0,1,0,1,0
1,3,3,0,9,2,7,0,3,3,1,0,7,2,5,0,3,3,1,0,5,1,4,0
4,3,1,2,4,3,1,0,3,1,4,2,1,0,1,0,3,1,4,2,1,0,1,0
2,3,1,0,9,4,5,0,3,1,2,0,5,2,3,0,3,1,2,0,3,1,2,0
1,3,3,0,9,2,7,0,3,3,1,0,7,2,5,0,3,3,1,0,5,1,4,0
4,3,3,3,10,9,1,0,3,3,4,3,1,0,1,0,3,3,4,3,1,0,1,0
2,3,1,0,0,0,0,0,3,1,2,0,0,0,0,0,3,1,2,0,0,0,0,0
4,1,4,3,24,21,3,2,1,4,4,3,3,2,1,0,1,4,4,3,1,0,1,0
2,1,2,2,21,10,11,5,1,2,2,2,11,5,6,2,1,2,2,2,6,2,4,1
2,0,3,4,24,12,12,10,0,3,2,4,12,6,6,5,0,3,2,4,6,3,3,2
2,3,3,1,7,3,4,1,3,3,2,1,4,1,3,0,3,3,2,1,3,1,2,0
0,4,3,4,5,0,5,4,4,3,0,4,5,0,5,4,4,3,0,4,5,0,5,4
3,1,0,4,5,3,2,1,1,0,3,4,2,1,1,0,1,0,3,4,1,0,1,0
4,0,3,4,29,26,3,2,0,3,4,4,3,2,1,0,0,3,4,4,1,0,1,0
3,1,3,2,27,18,9,4,1,3,3,2,9,6,3,1,1,3,3,2,3,2,1,0
3,3,2,0,13,9,4,0,3,2,3,0,4,2,2,0,3,2,3,0,2,1,1,0
2,3,3,2,4,1,3,1,3,3,2,2,3,1,2,0,3,3,2,2,2,0,2,1
1,1,4,3,19,5,14,9,1,4,1,3,14,4,10,6,1,4,1,3,10,2,8,5
0,4,0,1,2,0,2,0,4,0,0,1,2,0,2,0,4,0,0,1,2,0,2,0
3,2,3,1,22,15,7,2,2,3,3,1,7,4,3,0,2,3,3,1,3,2,1,0
3,3,3,0,18,12,6,0,3,3,3,0,6,4,2,0,3,3,3,0,2,1,1,0
4,2,2,1,8,7,1,0,2,2,4,1,1,0,1,0,2,2,4,1,1,0,1,0
1,3,1,0,8,2,6,0,3,1,1,0,6,1,5,0,3,1,1,0,5,1,4,0
0,4,1,3,9,0,9,6,4,1,0,3,9,0,9,6,4,1,0,3,9,0,9,6
4,1,2,3,20,18,2,1,1,2,4,3,2,1,1,0,1,2,4,3,1,0,1,0
3,2,2,3,18,12,6,4,2,2,3,3,6,4,2,1,2,2,3,3,2,1,1,0
4,3,2,3,4,3,1,0,3,2,4,3,1,0,1,0,3,2,4,3,1,0,1,0
4,1,1,3,14,12,2,1,1,1,4,3,2,1,1,0,1,1,4,3,1,0,1,0
2,1,4,2,27,13,14,7,1,4,2,2,14,7,7,3,1,4,2,2,7,3,4,2
4,0,1,4,15,13,2,1,0,1,4,4,2,1,1,0,0,1,4,4,1,0,1,0
2,3,2,0,15,7,8,0,3,2,2,0,8,3,5,0,3,2,2,0,5,2,3,0
0,4,1,3,6,0,6,4,4,1,0,3,6,0,6,4,4,1,0,3,6,0,6,4
4,1,0,0,15,13,2,0,1,0,4,0,2,1,1,0,1,0,4,0,1,0,1,0
4,3,4,0,12,10,2,0,3,4,4,0,2,1,1,0,3,4,4,0,1,0,1,0
4,0,1,1,21,18,3,0,0,1,4,1,3,2,1,0,0,1,4,1,1,0,1,0
1,3,0,1,7,2,5,1,3,0,1,1,5,1,4,1,3,0,1,1,4,1,3,0
4,2,2,0,10,8,2,0,2,2,4,0,2,1,1,0,2,2,4,0,1,0,1,0
4,2,3,1,26,23,3,0,2,3,4,1,3,2,1,0,2,3,4,1,1,0,1,0
3,3,1,2,5,3,2,1,3,1,3,2,2,1,1,0,3,1,3,2,1,0,1,0
4,3,0,1,7,6,1,0,3,0,4,1,1,0,1,0,3,0,4,1,1,0,1,0
4,0,0,1,1,0,1,0,0,0,4,1,1,0,1,0,0,0,4,1,1,0,1,0
0,2,4,0,15,1,14,1,2,4,0,0,14,1,13,1,2,4,0,0,13,1,12,1
4,4,0,2,0,0,0,0,4,0,4,2,0,0,0,0,4,0,4,2,0,0,0,0
2,0,3,2,25,12,13,6,0,3,2,2,13,6,7,3,0,3,2,2,7,3,4,2
2,4,4,0,12,5,7,0,4,4,2,0,7,3,4,0,4,4,2,0,4,2,2,0
1,1,2,0,14,4,10,0,1,2,1,0,10,2,8,0,1,2,1,0,8,2,6,0
3,3,4,0,19,13,6,0,3,4,3,0,6,4,2,0,3,4,3,0,2,1,1,0
3,3,3,2,9,6,3,1,3,3,3,2,3,2,1,0,3,3,3,2,1,0,1,0
2,4,4,2,8,3,5,2,4,4,2,2,5,2,3,1,4,4,2,2,3,1,2,1
1,4,2,4,0,0,0,0,4,2,1,4,0,0,0,0,4,2,1,4,0,0,0,0
2,4,4,0,9,4,5,0,4,4,2,0,5,2,3,0,4,4,2,0,3,1,2,0
1,3,1,4,6,1,5,4,3,1,1,4,5,1,4,3,3,1,1,4,4,1,3,2
0,1,0,1,16,1,15,4,1,0,0,1,15,1,14,4,1,0,0,1,14,1,13,3
3,2,3,2,18,12,6,3,2,3,3,2,6,4,2,0,2,3,3,2,2,1,1,0
1,0,1,1,19,5,14,4,0,1,1,1,14,4,10,3,0,1,1,1,10,3,7,2
1,4,3,4,7,2,5,4,4,3,1,4,5,1,4,3,4,3,1,4,4,1,3,2
2,1,3,4,25,12,13,11,1,3,2,4,13,6,7,6,1,3,2,4,7,3,4,3
0,1,3,0,19,1,18,1,1,3,0,0,18,1,17,1,1,3,0,0,17,1,16,1
1,2,3,0,23,6,17,1,2,3,1,0,17,5,12,1,2,3,1,0,12,3,9,0
3,4,1,0,6,4,2,0,4,1,3,0,2,1,1,0,4,1,3,0,1,0,1,0
2,3,0,3,0,0,0,0,3,0,2,3,0,0,0,0,3,0,2,3,0,0,0,0
2,0,2,3,27,13,14,9,0,2,2,3,14,6,8,5,0,2,2,3,8,4,4,2
3,0,0,4,3,2,1,0,0,0,3,4,1,0,1,0,0,0,3,4,1,0,1,0
2,2,2,4,15,7,8,7,2,2,2,4,8,3,5,4,2,2,2,4,5,2,3,2
3,4,2,0,7,4,3,0,4,2,3,0,3,2,1,0,4,2,3,0,1,0,1,0
4,4,3,3,15,13,2,1,4,3,4,3,2,1,1,0,4,3,4,3,1,0,1,0
4,3,1,3,1,0,1,0,3,1,4,3,1,0,1,0,3,1,4,3,1,0,1,0
0,0,4,3,26,2,24,16,0,4,0,3,24,2,22,15,0,4,0,3,22,2,20,13
3,2,0,0,7,4,3,0,2,0,3,0,3,2,1,0,2,0,3,0,1,0,1,0
2,4,0,3,1,0,1,0,4,0,2,3,1,0,1,0,4,0,2,3,1,0,1,0
4,4,4,2,14,12,2,1,4,4,4,2,2,1,1,0,4,4,4,2,1,0,1,0
2,1,3,1,27,13,14,4,1,3,2,1,14,7,7,2,1,3,2,1,7,3,4,1
4,1,1,4,15,13,2,1,1,1,4,4,2,1,1,0,1,1,4,4,1,0,1,0
1,4,4,4,5,1,4,3,4,4,1,4,4,1,3,2,4,4,1,4,3,0,3,2
4,4,4,2,15,13,2,1,4,4,4,2,2,1,1,0,4,4,4,2,1,0,1,0
0,3,1,4,9,0,9,8,3,1,0,4,9,0,9,8,3,1,0,4,9,0,9,8
2,0,4,4,28,14,14,12,0,4,2,4,14,7,7,6,0,4,2,4,7,3,4,3
3,3,1,1,1,0,1,0,3,1,3,1,1,0,1,0,3,1,3,1,1,0,1,0
2,0,1,4,18,9,9,8,0,1,2,4,9,4,5,4,0,1,2,4,5,2,3,2
1,4,3,2,9,2,7,3,4,3,1,2,7,2,5,2,4,3,1,2,5,1,4,2
3,2,2,0,14,9,5,0,2,2,3,0,5,3,2,0,2,2,3,0,2,1,1,0
0,4,3,1,12,1,11,3,4,3,0,1,11,1,10,2,4,3,0,1,10,0,10,3
4,0,0,2,11,9,2,0,0,0,4,2,2,1,1,0,0,0,4,2,1,0,1,0
3,1,1,0,13,9,4,0,1,1,3,0,4,2,2,0,1,1,3,0,2,1,1,0
4,0,1,4,24,21,3,2,0,1,4,4,3,2,1,0,0,1,4,4,1,0,1,0
2,4,2,3,12,6,6,4,4,2,2,3,6,2,4,2,4,2,2,3,4,1,3,2
3,1,0,1,2,1,1,0,1,0,3,1,1,0,1,0,1,0,3,1,1,0,1,0
4,4,2,1,9,8,1,0,4,2,4,1,1,0,1,0,4,2,4,1,1,0,1,0
3,0,3,2,23,16,7,3,0,3,3,2,7,4,3,1,0,3,3,2,3,2,1,0
4,3,0,3,4,3,1,0,3,0,4,3,1,0,1,0,3,0,4,3,1,0,1,0
0,0,3,3,22,2,20,14,0,3,0,3,20,1,19,13,0,3,0,3,19,1,18,12
0,0,1,3,14,1,13,9,0,1,0,3,13,1,12,8,0,1,0,3,12,1,11,7
4,1,3,2,24,21,3,1,1,3,4,2,3,2,1,0,1,3,4,2,1,0,1,0
2,1,3,1,12,6,6,1,1,3,2,1,6,2,4,1,1,3,2,1,4,1,3,0
4,3,2,1,11,9,2,0,3,2,4,1,2,1,1,0,3,2,4,1,1,0,1,0
1,3,4,0,17,5,12,1,3,4,1,0,12,3,9,0,3,4,1,0,9,2,7,0
1,4,3,0,5,1,4,0,4,3,1,0,4,1,3,0,4,3,1,0,3,0,3,0
2,4,2,4,4,2,2,1,4,2,2,4,2,0,2,1,4,2,2,4,2,0,2,1
1,1,2,2,16,4,12,5,1,2,1,2,12,3,9,4,1,2,1,2,9,2,7,3
2,3,2,3,13,6,7,4,3,2,2,3,7,3,4,2,3,2,2,3,4,1,3,2
0,3,4,3,15,1,14,9,3,4,0,3,14,1,13,9,3,4,0,3,13,1,12,8
0,3,2,4,8,0,8,7,3,2,0,4,8,0,8,7,3,2,0,4,8,0,8,7
4,1,0,0,10,9,1,0,1,0,4,0,1,0,1,0,1,0,4,0,1,0,1,0
3,4,1,4,5,3,2,1,4,1,3,4,2,1,1,0,4,1,3,4,1,0,1,0
3,0,0,3,7,4,3,2,0,0,3,3,3,2,1,0,0,0,3,3,1,0,1,0
4,0,1,4,11,9,2,1,0,1,4,4,2,1,1,0,0,1,4,4,1,0,1,0
3,4,1,1,8,5,3,0,4,1,3,1,3,2,1,0,4,1,3,1,1,0,1,0
4,2,1,2,11,9,2,1,2,1,4,2,2,1,1,0,2,1,4,2,1,0,1,0
2,1,3,1,23,11,12,3,1,3,2,1,12,6,6,1,1,3,2,1,6,3,3,0
2,2,1,1,2,0,2,0,2,1,2,1,2,0,2,0,2,1,2,1,2,1,1,0
1,3,0,3,6,1,5,3,3,0,1,3,5,1,4,2,3,0,1,3,4,1,3,2
2,4,3,1,9,4,5,1,4,3,2,1,5,2,3,0,4,3,2,1,3,1,2,0
2,3,0,3,1,0,1,0,3,0,2,3,1,0,1,0,3,0,2,3,1,0,1,0
3,2,1,1,14,9,5,1,2,1,3,1,5,3,2,0,2,1,3,1,2,1,1,0
1,3,1,1,6,1,5,1,3,1,1,1,5,1,4,1,3,1,1,1,4,1,3,0
4,4,2,2,6,5,1,0,4,2,4,2,1,0,1,0,4,2,4,2,1,0,1,0
3,2,0,0,6,4,2,0,2,0,3,0,2,1,1,0,2,0,3,0,1,0,1,0
1,3,3,3,6,1,5,3,3,3,1,3,5,1,4,2,3,3,1,3,4,1,3,2
3,3,0,0,0,0,0,0,3,0,3,0,0,0,0,0,3,0,3,0,0,0,0,0
3,3,0,4,7,4,3,2,3,0,3,4,3,2,1,0,3,0,3,4,1,0,1,0
3,1,4,2,28,19,9,4,1,4,3,2,9,6,3,1,1,4,3,2,3,2,1,0
1,2,1,1,9,2,7,2,2,1,1,1,7,2,5,1,2,1,1,1,5,1,4,1
1,0,0,1,5,1,4,1,0,0,1,1,4,1,3,0,0,0,1,1,3,0,3,0
0,1,3,3,29,2,27,18,1,3,0,3,27,2,25,17,1,3,0,3,25,2,23,16
0,4,2,0,2,0,2,0,4,2,0,0,2,0,2,0,4,2,0,0,2,0,2,0
2,1,4,2,25,12,13,6,1,4,2,2,13,6,7,3,1,4,2,2,7,3,4,2
1,3,2,2,8,2,6,3,3,2,1,2,6,1,5,2,3,2,1,2,5,1,4,1
0,3,1,0,6,0,6,0,3,1,0,0,6,0,6,0,3,1,0,0,6,0,6,0
0,4,2,3,6,0,6,4,4,2,0,3,6,0,6,4,4,2,0,3,6,0,6,4
3,3,3,3,5,3,2,1,3,3,3,3,2,1,1,0,3,3,3,3,1,0,1,0
3,3,0,4,13,9,4,3,3,0,3,4,4,2,2,1,3,0,3,4,2,1,1,0
0,1,4,0,24,2,22,2,1,4,0,0,22,2,20,1,1,4,0,0,20,2,18,1
1,1,0,0,18,5,13,1,1,0,1,0,13,3,10,0,1,0,1,0,10,2,8,0
3,4,2,1,7,4,3,0,4,2,3,1,3,2,1,0,4,2,3,1,1,0,1,0
1,1,0,0,2,0,2,0,1,0,1,0,2,0,2,0,1,0,1,0,2,0,2,0
4,1,2,0,16,14,2,0,1,2,4,0,2,1,1,0,1,2,4,0,1,0,1,0
4,1,2,1,17,15,2,0,1,2,4,1,2,1,1,0,1,2,4,1,1,0,1,0
0,1,2,0,16,1,15,1,1,2,0,0,15,1,14,1,1,2,0,0,14,1,13,1
4,0,1,0,6,5,1,0,0,1,4,0,1,0,1,0,0,1,4,0,1,0,1,0
0,1,2,2,21,2,19,9,1,2,0,2,19,1,18,8,1,2,0,2,18,1,17,8
2,4,3,4,2,1,1,0,4,3,2,4,1,0,1,0,4,3,2,4,1,0,1,0
3,0,3,2,24,16,8,4,0,3,3,2,8,5,3,1,0,3,3,2,3,2,1,0
4,4,1,0,3,2,1,0,4,1,4,0,1,0,1,0,4,1,4,0,1,0,1,0
4,3,2,0,17,15,2,0,3,2,4,0,2,1,1,0,3,2,4,0,1,0,1,0
4,4,3,2,7,6,1,0,4,3,4,2,1,0,1,0,4,3,4,2,1,0,1,0
2,3,0,1,5,2,3,0,3,0,2,1,3,1,2,0,3,0,2,1,2,0,2,0
4,1,4,4,26,23,3,2,1,4,4,4,3,2,1,0,1,4,4,4,1,0,1,0
2,0,2,0,17,8,9,0,0,2,2,0,9,4,5,0,0,2,2,0,5,2,3,0
0,0,2,2,19,1,18,8,0,2,0,2,18,1,17,8,0,2,0,2,17,1,16,8
2,2,1,2,4,1,3,1,2,1,2,2,3,1,2,0,2,1,2,2,2,1,1,0
4,3,2,4,25,22,3,2,3,2,4,4,3,2,1,0,3,2,4,4,1,0,1,0
4,4,1,0,5,4,1,0,4,1,4,0,1,0,1,0,4,1,4,0,1,0,1,0
3,4,4,1,4,2,2,0,4,4,3,1,2,1,1,0,4,4,3,1,1,0,1,0
4,3,1,4,10,8,2,1,3,1,4,4,2,1,1,0,3,1,4,4,1,0,1,0
4,3,3,1,5,4,1,0,3,3,4,1,1,0,1,0,3,3,4,1,1,0,1,0
3,3,2,0,10,7,3,0,3,2,3,0,3,2,1,0,3,2,3,0,1,0,1,0
2,4,1,3,0,0,0,0,4,1,2,3,0,0,0,0,4,1,2,3,0,0,0,0
4,2,0,4,2,1,1,0,2,0,4,4,1,0,1,0,2,0,4,4,1,0,1,0
4,4,0,1,4,3,1,0,4,0,4,1,1,0,1,0,4,0,4,1,1,0,1,0
2,3,2,3,2,0,2,1,3,2,2,3,2,1,1,0,3,2,2,3,1,0,1,0
1,4,3,3,5,1,4,2,4,3,1,3,4,1,3,2,4,3,1,3,3,0,3,2
3,1,3,1,24,16,8,2,1,3,3,1,8,5,3,0,1,3,3,1,3,2,1,0
2,1,1,1,15,7,8,2,1,1,2,1,8,3,5,1,1,1,2,1,5,2,3,0
4,1,3,2,23,20,3,1,1,3,4,2,3,2,1,0,1,3,4,2,1,0,1,0
2,1,2,4,14,6,8,7,1,2,2,4,8,4,4,3,1,2,2,4,4,1,3,2
1,4,2,3,3,0,3,2,4,2,1,3,3,0,3,2,4,2,1,3,3,0,3,2
3,4,0,4,12,8,4,3,4,0,3,4,4,2,2,1,4,0,3,4,2,1,1,0
2,0,4,4,29,14,15,13,0,4,2,4,15,7,8,7,0,4,2,4,8,4,4,3
0,2,1,1,4,0,4,1,2,1,0,1,4,0,4,1,2,1,0,1,4,0,4,1
1,4,3,0,8,2,6,0,4,3,1,0,6,1,5,0,4,3,1,0,5,1,4,0
0,2,2,1,14,1,13,3,2,2,0,1,13,1,12,3,2,2,0,1,12,1,11,3
0,0,2,1,16,1,15,4,0,2,0,1,15,1,14,4,0,2,0,1,14,1,13,3
3,2,4,3,22,15,7,4,2,4,3,3,7,4,3,2,2,4,3,3,3,2,1,0
3,2,2,3,16,11,5,3,2,2,3,3,5,3,2,1,2,2,3,3,2,1,1,0
2,3,1,1,4,2,2,0,3,1,2,1,2,0,2,0,3,1,2,1,2,0,2,0
2,1,3,3,18,8,10,7,1,3,2,3,10,5,5,3,1,3,2,3,5,2,3,2
3,4,2,1,5,3,2,0,4,2,3,1,2,1,1,0,4,2,3,1,1,0,1,0
0,4,0,2,2,0,2,0,4,0,0,2,2,0,2,1,4,0,0,2,2,0,2,1
2,2,2,2,14,6,8,4,2,2,2,2,8,3,5,2,2,2,2,2,5,2,3,1
1,0,1,0,11,3,8,0,0,1,1,0,8,2,6,0,0,1,1,0,6,1,5,0
4,3,1,4,5,4,1,0,3,1,4,4,1,0,1,0,3,1,4,4,1,0,1,0
4,3,1,1,8,7,1,0,3,1,4,1,1,0,1,0,3,1,4,1,1,0,1,0
0,4,3,1,7,0,7,2,4,3,0,1,7,0,7,2,4,3,0,1,7,0,7,2
2,0,3,2,27,13,14,7,0,3,2,2,14,6,8,4,0,3,2,2,8,4,4,2
1,3,0,3,2,0,2,1,3,0,1,3,2,0,2,1,3,0,1,3,2,0,2,1
0,1,1,1,5,0,5,1,1,1,0,1,5,0,5,1,1,1,0,1,5,0,5,1
3,1,2,4,18,12,6,5,1,2,3,4,6,4,2,1,1,2,3,4,2,1,1,0
3,2,1,0,5,3,2,0,2,1,3,0,2,1,1,0,2,1,3,0,1,0,1,0
1,3,3,0,10,3,7,0,3,3,1,0,7,2,5,0,3,3,1,0,5,1,4,0
2,3,4,2,25,12,13,6,3,4,2,2,13,6,7,3,3,4,2,2,7,3,4,2
4,2,2,1,9,8,1,0,2,2,4,1,1,0,1,0,2,2,4,1,1,0,1,0
1,0,4,2,27,8,19,9,0,4,1,2,19,5,14,6,0,4,1,2,14,4,10,5
1,3,0,0,6,1,5,0,3,0,1,0,5,1,4,0,3,0,1,0,4,1,3,0
4,3,4,2,11,9,2,1,3,4,4,2,2,1,1,0,3,4,4,2,1,0,1,0
3,1,3,4,27,18,9,8,1,3,3,4,9,6,3,2,1,3,3,4,3,2,1,0
3,2,4,0,13,9,4,0,2,4,3,0,4,2,2,0,2,4,3,0,2,1,1,0
2,0,0,2,4,2,2,0,0,0,2,2,2,1,1,0,0,0,2,2,1,0,1,0
3,0,4,4,29,20,9,8,0,4,3,4,9,6,3,2,0,4,3,4,3,2,1,0
1,1,3,1,27,8,19,5,1,3,1,1,19,5,14,4,1,3,1,1,14,4,10,3
2,2,0,0,1,0,1,0,2,0,2,0,1,0,1,0,2,0,2,0,1,0,1,0
4,2,3,1,17,15,2,0,2,3,4,1,2,1,1,0,2,3,4,1,1,0,1,0
0,1,3,2,25,2,23,11,1,3,0,2,23,2,21,10,1,3,0,2,21,2,19,9
3,1,4,4,28,19,9,8,1,4,3,4,9,6,3,2,1,4,3,4,3,2,1,0
4,1,3,2,20,18,2,1,1,3,4,2,2,1,1,0,1,3,4,2,1,0,1,0
0,4,3,3,14,1,13,9,4,3,0,3,13,1,12,8,4,3,0,3,12,1,11,7
0,2,4,0,27,2,25,2,2,4,0,0,25,2,23,2,2,4,0,0,23,2,21,2
4,4,3,1,8,7,1,0,4,3,4,1,1,0,1,0,4,3,4,1,1,0,1,0
3,4,0,2,11,7,4,1,4,0,3,2,4,2,2,0,4,0,3,2,2,1,1,0
0,3,4,3,19,1,18,12,3,4,0,3,18,1,17,11,3,4,0,3,17,1,16,11
2,2,3,4,24,12,12,10,2,3,2,4,12,5,7,6,2,3,2,4,7,3,4,3
0,2,2,1,20,2,18,5,2,2,0,1,18,1,17,5,2,2,0,1,17,1,16,4
4,1,1,1,7,6,1,0,1,1,4,1,1,0,1,0,1,1,4,1,1,0,1,0
4,2,4,0,24,21,3,0,2,4,4,0,3,2,1,0,2,4,4,0,1,0,1,0
0,3,3,1,18,1,17,5,3,3,0,1,17,1,16,4,3,3,0,1,16,1,15,4
4,2,4,2,24,21,3,1,2,4,4,2,3,2,1,0,2,4,4,2,1,0,1,0
0,1,3,4,26,2,24,21,1,3,0,4,24,2,22,19,1,3,0,4,22,2,20,17
2,1,4,0,29,14,15,1,1,4,2,0,15,7,8,0,1,4,2,0,8,3,5,0
3,1,4,0,29,20,9,0,1,4,3,0,9,6,3,0,1,4,3,0,3,2,1,0
1,1,2,2,11,3,8,4,1,2,1,2,8,2,6,3,1,2,1,2,6,1,5,2
3,4,2,1,8,5,3,0,4,2,3,1,3,2,1,0,4,2,3,1,1,0,1,0
3,4,2,4,2,1,1,0,4,2,3,4,1,0,1,0,4,2,3,4,1,0,1,0
1,1,4,2,29,8,21,10,1,4,1,2,21,6,15,7,1,4,1,2,15,4,11,5
4,2,1,2,13,11,2,0,2,1,4,2,2,1,1,0,2,1,4,2,1,0,1,0
3,3,4,4,11,7,4,3,3,4,3,4,4,2,2,1,3,4,3,4,2,1,1,0
2,2,0,2,2,1,1,0,2,0,2,2,1,0,1,0,2,0,2,2,1,0,1,0
0,2,2,2,21,2,19,9,2,2,0,2,19,1,18,9,2,2,0,2,18,1,17,8
2,0,3,3,26,13,13,9,0,3,2,3,13,6,7,4,0,3,2,3,7,3,4,2
3,2,2,4,12,8,4,3,2,2,3,4,4,2,2,1,2,2,3,4,2,1,1,0
4,4,3,1,5,4,1,0,4,3,4,1,1,0,1,0,4,3,4,1,1,0,1,0
0,2,1,2,4,0,4,2,2,1,0,2,4,0,4,2,2,1,0,2,4,0,4,2
1,3,0,3,5,1,4,2,3,0,1,3,4,1,3,2,3,0,1,3,3,0,3,2
0,3,2,3,3,0,3,2,3,2,0,3,3,0,3,2,3,2,0,3,3,0,3,2
1,0,4,4,28,8,20,18,0,4,1,4,20,6,14,12,0,4,1,4,14,4,10,8
1,0,2,3,28,8,20,13,0,2,1,3,20,6,14,9,0,2,1,3,14,4,10,7
3,2,0,2,0,0,0,0,2,0,3,2,0,0,0,0,2,0,3,2,0,0,0,0
2,3,3,4,12,6,6,5,3,3,2,4,6,3,3,2,3,3,2,4,3,1,2,1
1,0,4,0,27,8,19,1,0,4,1,0,19,5,14,1,0,4,1,0,14,4,10,1
4,1,4,3,24,21,3,2,1,4,4,3,3,2,1,0,1,4,4,3,1,0,1,0
0,3,3,2,12,1,11,5,3,3,0,2,11,1,10,5,3,3,0,2,10,1,9,4
4,1,0,4,0,0,0,0,1,0,4,4,0,0,0,0,1,0,4,4,0,0,0,0
1,4,0,0,5,1,4,0,4,0,1,0,4,1,3,0,4,0,1,0,3,0,3,0
0,1,4,3,19,1,18,12,1,4,0,3,18,1,17,11,1,4,0,3,17,1,16,11
1,1,4,1,23,6,17,5,1,4,1,1,17,5,12,3,1,4,1,1,12,3,9,2
1,1,3,4,15,4,11,9,1,3,1,4,11,3,8,7,1,3,1,4,8,2,6,5
3,1,3,3,20,13,7,4,1,3,3,3,7,4,3,2,1,3,3,3,3,2,1,0
2,2,3,2,21,10,11,5,2,3,2,2,11,5,6,3,2,3,2,2,6,2,4,1
1,1,2,2,19,5,14,7,1,2,1,2,14,4,10,4,1,2,1,2,10,2,8,3
1,3,2,0,15,4,11,1,3,2,1,0,11,3,8,0,3,2,1,0,8,2,6,0
1,4,2,0,6,1,5,0,4,2,1,0,5,1,4,0,4,2,1,0,4,1,3,0
4,1,0,0,14,12,2,0,1,0,4,0,2,1,1,0,1,0,4,0,1,0,1,0
4,4,1,0,1,0,1,0,4,1,4,0,1,0,1,0,4,1,4,0,1,0,1,0
1,1,3,1,24,7,17,5,1,3,1,1,17,5,12,3,1,3,1,1,12,3,9,2
3,4,3,4,7,4,3,2,4,3,3,4,3,2,1,0,4,3,3,4,1,0,1,0
2,4,3,4,5,2,3,2,4,3,2,4,3,1,2,1,4,3,2,4,2,0,2,1
1,2,4,3,25,7,18,12,2,4,1,3,18,5,13,9,2,4,1,3,13,3,10,6
1,1,0,3,8,2,6,4,1,0,1,3,6,1,5,3,1,0,1,3,5,1,4,2
0,4,4,0,8,0,8,0,4,4,0,0,8,0,8,0,4,4,0,0,8,0,8,0
4,4,1,0,6,5,1,0,4,1,4,0,1,0,1,0,4,1,4,0,1,0,1,0
3,1,3,0,27,18,9,0,1,3,3,0,9,6,3,0,1,3,3,0,3,2,1,0
3,2,3,4,20,13,7,6,2,3,3,4,7,4,3,2,2,3,3,4,3,2,1,0
0,2,2,4,15,1,14,12,2,2,0,4,14,1,13,11,2,2,0,4,13,1,12,10
3,2,2,2,22,15,7,3,2,2,3,2,7,4,3,1,2,2,3,2,3,2,1,0
3,0,3,0,23,16,7,0,0,3,3,0,7,4,3,0,0,3,3,0,3,2,1,0
4,1,0,2,5,4,1,0,1,0,4,2,1,0,1,0,1,0,4,2,1,0,1,0
4,2,2,4,10,8,2,1,2,2,4,4,2,1,1,0,2,2,4,4,1,0,1,0
0,4,0,1,1,0,1,0,4,0,0,1,1,0,1,0,4,0,0,1,1,0,1,0
0,3,2,0,12,1,11,1,3,2,0,0,11,1,10,0,3,2,0,0,10,1,9,0
0,3,1,2,5,0,5,2,3,1,0,2,5,0,5,2,3,1,0,2,5,0,5,2
2,4,4,4,12,5,7,6,4,4,2,4,7,3,4,3,4,4,2,4,4,1,3,2
3,1,0,3,2,1,1,0,1,0,3,3,1,0,1,0,1,0,3,3,1,0,1,0
1,1,0,3,2,0,2,1,1,0,1,3,2,0,2,1,1,0,1,3,2,0,2,1
1,2,2,4,8,2,6,5,2,2,1,4,6,1,5,4,2,2,1,4,5,1,4,3
4,3,0,3,0,0,0,0,3,0,4,3,0,0,0,0,3,0,4,3,0,0,0,0
1,1,3,2,27,8,19,9,1,3,1,2,19,5,14,7,1,3,1,2,14,4,10,5
3,4,3,4,4,2,2,1,4,3,3,4,2,1,1,0,4,3,3,4,1,0,1,0
4,2,1,1,5,4,1,0,2,1,4,1,1,0,1,0,2,1,4,1,1,0,1,0
3,2,0,0,12,8,4,0,2,0,3,0,4,2,2,0,2,0,3,0,2,1,1,0
1,3,2,1,12,3,9,2,3,2,1,1,9,2,7,2,3,2,1,1,7,2,5,1
2,2,1,2,5,2,3,1,2,1,2,2,3,1,2,0,2,1,2,2,2,0,2,0
0,3,2,1,5,0,5,1,3,2,0,1,5,0,5,1,3,2,0,1,5,0,5,1
4,3,4,2,22,19,3,1,3,4,4,2,3,2,1,0,3,4,4,2,1,0,1,0
0,1,1,4,4,0,4,3,1,1,0,4,4,0,4,3,1,1,0,4,4,0,4,3
0,3,4,4,15,1,14,12,3,4,0,4,14,1,13,11,3,4,0,4,13,1,12,10
0,3,1,4,6,0,6,5,3,1,0,4,6,0,6,5,3,1,0,4,6,0,6,5
4,2,0,0,10,9,1,0,2,0,4,0,1,0,1,0,2,0,4,0,1,0,1,0
1,0,4,1,26,7,19,5,0,4,1,1,19,5,14,4,0,4,1,1,14,4,10,2
1,0,0,2,0,0,0,0,0,0,1,2,0,0,0,0,0,0,1,2,0,0,0,0
2,0,0,3,1,0,1,0,0,0,2,3,1,0,1,0,0,0,2,3,1,0,1,0
3,3,2,3,12,8,4,2,3,2,3,3,4,2,2,1,3,2,3,3,2,1,1,0
2,3,3,4,7,3,4,3,3,3,2,4,4,1,3,2,3,3,2,4,3,1,2,1
3,1,4,2,25,17,8,4,1,4,3,2,8,5,3,1,1,4,3,2,3,2,1,0
3,1,1,3,17,11,6,4,1,1,3,3,6,4,2,1,1,1,3,3,2,1,1,0
2,3,3,1,14,6,8,2,3,3,2,1,8,4,4,1,3,3,2,1,4,1,3,0
3,0,0,0,13,9,4,0,0,0,3,0,4,2,2,0,0,0,3,0,2,1,1,0
1,2,0,2,14,4,10,4,2,0,1,2,10,3,7,3,2,0,1,2,7,2,5,2
1,2,2,0,19,5,14,1,2,2,1,0,14,4,10,1,2,2,1,0,10,2,8,0
4,1,4,0,26,23,3,0,1,4,4,0,3,2,1,0,1,4,4,0,1,0,1,0
0,3,0,3,7,0,7,4,3,0,0,3,7,0,7,4,3,0,0,3,7,0,7,4
4,1,2,1,11,9,2,0,1,2,4,1,2,1,1,0,1,2,4,1,1,0,1,0
3,3,4,2,13,9,4,2,3,4,3,2,4,2,2,0,3,4,3,2,2,1,1,0
4,3,3,1,15,13,2,0,3,3,4,1,2,1,1,0,3,3,4,1,1,0,1,0
3,2,3,1,27,18,9,2,2,3,3,1,9,6,3,0,2,3,3,1,3,2,1,0
3,3,2,1,7,4,3,0,3,2,3,1,3,2,1,0,3,2,3,1,1,0,1,0
0,2,0,4,6,0,6,5,2,0,0,4,6,0,6,5,2,0,0,4,6,0,6,5
2,0,4,0,24,12,12,1,0,4,2,0,12,5,7,0,0,4,2,0,7,3,4,0
2,3,0,4,2,1,1,0,3,0,2,4,1,0,1,0,3,0,2,4,1,0,1,0
3,3,4,0,7,4,3,0,3,4,3,0,3,2,1,0,3,4,3,0,1,0,1,0
1,0,1,4,7,2,5,4,0,1,1,4,5,1,4,3,0,1,1,4,4,1,3,2
0,3,2,4,7,0,7,6,3,2,0,4,7,0,7,6,3,2,0,4,7,0,7,6
4,4,3,0,8,7,1,0,4,3,4,0,1,0,1,0,4,3,4,0,1,0,1,0
3,1,3,0,18,12,6,0,1,3,3,0,6,4,2,0,1,3,3,0,2,1,1,0
3,0,1,2,18,12,6,2,0,1,3,2,6,4,2,1,0,1,3,2,2,1,1,0
3,4,2,0,0,0,0,0,4,2,3,0,0,0,0,0,4,2,3,0,0,0,0,0
2,4,2,0,6,3,3,0,4,2,2,0,3,1,2,0,4,2,2,0,2,1,1,0
2,4,0,2,0,0,0,0,4,0,2,2,0,0,0,0,4,0,2,2,0,0,0,0
3,4,3,4,9,6,3,2,4,3,3,4,3,2,1,0,4,3,3,4,1,0,1,0
1,1,1,4,6,1,5,4,1,1,1,4,5,1,4,3,1,1,1,4,4,1,3,2
1,2,1,4,17,5,12,10,2,1,1,4,12,3,9,8,2,1,1,4,9,2,7,6
3,0,0,4,8,5,3,2,0,0,3,4,3,2,1,0,0,0,3,4,1,0,1,0
4,2,2,4,10,9,1,0,2,2,4,4,1,0,1,0,2,2,4,4,1,0,1,0
4,2,2,3,15,13,2,1,2,2,4,3,2,1,1,0,2,2,4,3,1,0,1,0
0,2,0,1,4,0,4,1,2,0,0,1,4,0,4,1,2,0,0,1,4,0,4,1
3,0,1,3,23,16,7,4,0,1,3,3,7,4,3,2,0,1,3,3,3,2,1,0
4,3,4,0,17,15,2,0,3,4,4,0,2,1,1,0,3,4,4,0,1,0,1,0
1,3,0,3,0,0,0,0,3,0,1,3,0,0,0,0,3,0,1,3,0,0,0,0
2,2,1,0,13,6,7,0,2,1,2,0,7,3,4,0,2,1,2,0,4,1,3,0
4,0,2,2,27,24,3,1,0,2,4,2,3,2,1,0,0,2,4,2,1,0,1,0
1,1,3,1,28,8,20,5,1,3,1,1,20,6,14,4,1,3,1,1,14,4,10,2
2,2,4,2,23,11,12,6,2,4,2,2,12,6,6,2,2,4,2,2,6,3,3,1
4,4,0,3,6,5,1,0,4,0,4,3,1,0,1,0,4,0,4,3,1,0,1,0
4,2,1,1,1,0,1,0,2,1,4,1,1,0,1,0,2,1,4,1,1,0,1,0
2,1,0,4,12,6,6,5,1,0,2,4,6,3,3,2,1,0,2,4,3,1,2,1
2,1,3,4,24,11,13,11,1,3,2,4,13,6,7,6,1,3,2,4,7,3,4,3
3,2,1,4,11,7,4,3,2,1,3,4,4,2,2,1,2,1,3,4,2,1,1,0
1,2,0,2,3,0,3,1,2,0,1,2,3,0,3,1,2,0,1,2,3,0,3,1
2,4,3,2,8,4,4,1,4,3,2,2,4,2,2,0,4,3,2,2,2,1,1,0
1,3,2,0,0,0,0,0,3,2,1,0,0,0,0,0,3,2,1,0,0,0,0,0
1,2,2,2,9,2,7,3,2,2,1,2,7,2,5,2,2,2,1,2,5,1,4,2
2,1,1,2,12,5,7,3,1,1,2,2,7,3,4,1,1,1,2,2,4,1,3,1
3,0,4,4,29,20,9,8,0,4,3,4,9,6,3,2,0,4,3,4,3,2,1,0
3,3,1,1,14,9,5,1,3,1,3,1,5,3,2,0,3,1,3,1,2,1,1,0
1,3,2,0,8,2,6,0,3,2,1,0,6,1,5,0,3,2,1,0,5,1,4,0
3,0,0,3,9,6,3,2,0,0,3,3,3,2,1,0,0,0,3,3,1,0,1,0
4,3,4,0,6,5,1,0,3,4,4,0,1,0,1,0,3,4,4,0,1,0,1,0
0,1,2,4,20,2,18,16,1,2,0,4,18,1,17,15,1,2,0,4,17,1,16,14
0,4,2,1,1,0,1,0,4,2,0,1,1,0,1,0,4,2,0,1,1,0,1,0
1,2,3,0,17,5,12,1,2,3,1,0,12,3,9,0,2,3,1,0,9,2,7,0
0,1,4,0,28,2,26,2,1,4,0,0,26,2,24,2,1,4,0,0,24,2,22,2
1,4,2,0,6,1,5,0,4,2,1,0,5,1,4,0,4,2,1,0,4,1,3,0
1,3,3,2,1,0,1,0,3,3,1,2,1,0,1,0,3,3,1,2,1,0,1,0
4,4,1,0,8,7,1,0,4,1,4,0,1,0,1,0,4,1,4,0,1,0,1,0
3,1,1,3,11,7,4,2,1,1,3,3,4,2,2,1,1,1,3,3,2,1,1,0
3,0,4,1,26,18,8,2,0,4,3,1,8,5,3,0,0,4,3,1,3,2,1,0
1,0,1,1,9,2,7,2,0,1,1,1,7,2,5,1,0,1,1,1,5,1,4,1
4,1,2,3,11,9,2,1,1,2,4,3,2,1,1,0,1,2,4,3,1,0,1,0
3,1,1,2,10,7,3,1,1,1,3,2,3,2,1,0,1,1,3,2,1,0,1,0
2,2,0,4,2,0,2,1,2,0,2,4,2,1,1,0,2,0,2,4,1,0,1,0
4,2,0,0,8,7,1,0,2,0,4,0,1,0,1,0,2,0,4,0,1,0,1,0
4,0,0,1,5,4,1,0,0,0,4,1,1,0,1,0,0,0,4,1,1,0,1,0
3,3,4,0,13,9,4,0,3,4,3,0,4,2,2,0,3,4,3,0,2,1,1,0
3,1,1,3,11,7,4,2,1,1,3,3,4,2,2,1,1,1,3,3,2,1,1,0
1,2,4,4,26,7,19,17,2,4,1,4,19,5,14,12,2,4,1,4,14,4,10,8
3,2,2,0,18,12,6,0,2,2,3,0,6,4,2,0,2,2,3,0,2,1,1,0
2,4,1,1,4,1,3,0,4,1,2,1,3,1,2,0,4,1,2,1,2,0,2,0
1,0,3,4,27,8,19,17,0,3,1,4,19,5,14,12,0,3,1,4,14,4,10,9
2,1,0,0,5,2,3,0,1,0,2,0,3,1,2,0,1,0,2,0,2,1,1,0
0,0,0,3,13,1,12,8,0,0,0,3,12,1,11,7,0,0,0,3,11,1,10,6
1,2,0,0,7,2,5,0,2,0,1,0,5,1,4,0,2,0,1,0,4,1,3,0
2,2,3,4,11,5,6,5,2,3,2,4,6,3,3,2,2,3,2,4,3,1,2,1
2,3,0,2,5,2,3,1,3,0,2,2,3,1,2,1,3,0,2,2,2,0,2,0
2,3,0,3,7,3,4,2,3,0,2,3,4,1,3,2,3,0,2,3,3,1,2,1
4,0,3,1,28,25,3,0,0,3,4,1,3,2,1,0,0,3,4,1,1,0,1,0
2,0,0,0,12,5,7,0,0,0,2,0,7,3,4,0,0,0,2,0,4,1,3,0
3,0,4,2,28,19,9,4,0,4,3,2,9,6,3,1,0,4,3,2,3,2,1,0
0,2,3,0,23,2,21,2,2,3,0,0,21,2,19,1,2,3,0,0,19,1,18,1
2,0,0,3,7,3,4,2,0,0,2,3,4,1,3,2,0,0,2,3,3,1,2,1
1,1,2,2,15,4,11,5,1,2,1,2,11,3,8,3,1,2,1,2,8,2,6,2
4,4,3,1,6,5,1,0,4,3,4,1,1,0,1,0,4,3,4,1,1,0,1,0
4,2,4,2,28,25,3,1,2,4,4,2,3,2,1,0,2,4,4,2,1,0,1,0
1,1,0,2,5,1,4,1,1,0,1,2,4,1,3,1,1,0,1,2,3,0,3,1
3,1,1,2,16,11,5,2,1,1,3,2,5,3,2,0,1,1,3,2,2,1,1,0
2,2,2,2,17,8,9,4,2,2,2,2,9,4,5,2,2,2,2,2,5,2,3,1
2,4,3,1,7,3,4,1,4,3,2,1,4,1,3,0,4,3,2,1,3,1,2,0
2,3,0,2,4,2,2,0,3,0,2,2,2,0,2,1,3,0,2,2,2,0,2,1
4,3,0,4,3,2,1,0,3,0,4,4,1,0,1,0,3,0,4,4,1,0,1,0
2,2,1,3,5,2,3,2,2,1,2,3,3,1,2,1,2,1,2,3,2,1,1,0
2,3,4,1,17,8,9,2,3,4,2,1,9,4,5,1,3,4,2,1,5,2,3,0
3,0,4,2,29,20,9,4,0,4,3,2,9,6,3,1,0,4,3,2,3,2,1,0
2,3,1,4,5,2,3,2,3,1,2,4,3,1,2,1,3,1,2,4,2,0,2,1
3,4,4,0,12,8,4,0,4,4,3,0,4,2,2,0,4,4,3,0,2,1,1,0
0,0,3,1,27,2,25,7,0,3,0,1,25,2,23,6,0,3,0,1,23,2,21,6
3,1,3,1,17,11,6,1,1,3,3,1,6,4,2,0,1,3,3,1,2,1,1,0
1,0,2,2,16,4,12,5,0,2,1,2,12,3,9,4,0,2,1,2,9,2,7,3
1,0,1,0,12,3,9,0,0,1,1,0,9,2,7,0,0,1,1,0,7,2,5,0
3,3,4,4,20,14,6,5,3,4,3,4,6,4,2,1,3,4,3,4,2,1,1,0
0,4,0,4,4,0,4,3,4,0,0,4,4,0,4,3,4,0,0,4,4,0,4,3
0,1,4,2,23,2,21,10,1,4,0,2,21,2,19,9,1,4,0,2,19,1,18,8
2,3,4,3,7,3,4,2,3,4,2,3,4,2,2,1,3,4,2,3,2,0,2,1
2,3,2,1,14,7,7,2,3,2,2,1,7,3,4,1,3,2,2,1,4,2,2,0
2,4,0,0,0,0,0,0,4,0,2,0,0,0,0,0,4,0,2,0,0,0,0,0
3,1,1,1,12,8,4,1,1,1,3,1,4,2,2,0,1,1,3,1,2,1,1,0
0,4,0,2,0,0,0,0,4,0,0,2,0,0,0,0,4,0,0,2,0,0,0,0
2,4,0,3,0,0,0,0,4,0,2,3,0,0,0,0,4,0,2,3,0,0,0,0
3,2,2,1,9,6,3,0,2,2,3,1,3,2,1,0,2,2,3,1,1,0,1,0
0,4,2,2,10,1,9,4,4,2,0,2,9,0,9,4,4,2,0,2,9,0,9,4
4,3,1,2,3,2,1,0,3,1,4,2,1,0,1,0,3,1,4,2,1,0,1,0
2,0,3,4,25,12,13,11,0,3,2,4,13,6,7,6,0,3,2,4,7,3,4,3
3,2,0,4,3,2,1,0,2,0,3,4,1,0,1,0,2,0,3,4,1,0,1,0
3,1,1,2,19,13,6,2,1,1,3,2,6,4,2,0,1,1,3,2,2,1,1,0
4,1,4,2,26,23,3,1,1,4,4,2,3,2,1,0,1,4,4,2,1,0,1,0
1,0,2,2,22,6,16,7,0,2,1,2,16,4,12,5,0,2,1,2,12,3,9,4
2,0,4,1,27,13,14,4,0,4,2,1,14,7,7,2,0,4,2,1,7,3,4,1
3,0,3,3,27,18,9,6,0,3,3,3,9,6,3,2,0,3,3,3,3,2,1,0
0,4,4,1,10,1,9,2,4,4,0,1,9,0,9,2,4,4,0,1,9,0,9,2
2,1,1,2,15,7,8,3,1,1,2,2,8,4,4,2,1,1,2,2,4,2,2,1
4,1,1,4,10,8,2,1,1,1,4,4,2,1,1,0,1,1,4,4,1,0,1,0
1,0,4,3,29,8,21,14,0,4,1,3,21,6,15,10,0,4,1,3,15,4,11,7
3,0,2,2,20,14,6,2,0,2,3,2,6,4,2,0,0,2,3,2,2,1,1,0
2,4,2,2,9,4,5,2,4,2,2,2,5,2,3,1,4,2,2,2,3,1,2,1
1,0,2,1,26,7,19,5,0,2,1,1,19,5,14,4,0,2,1,1,14,4,10,2
4,2,0,0,5,4,1,0,2,0,4,0,1,0,1,0,2,0,4,0,1,0,1,0
1,0,2,1,29,8,21,6,0,2,1,1,21,6,15,4,0,2,1,1,15,4,11,3
2,4,2,3,1,0,1,0,4,2,2,3,1,0,1,0,4,2,2,3,1,0,1,0
1,3,1,4,10,2,8,7,3,1,1,4,8,2,6,5,3,1,1,4,6,1,5,4
2,1,4,2,28,13,15,7,1,4,2,2,15,7,8,4,1,4,2,2,8,4,4,2
3,1,3,1,18,12,6,1,1,3,3,1,6,4,2,0,1,3,3,1,2,1,1,0
1,2,3,0,14,4,10,0,2,3,1,0,10,3,7,0,2,3,1,0,7,2,5,0
2,2,2,0,11,5,6,0,2,2,2,0,6,2,4,0,2,2,2,0,4,2,2,0
3,4,2,4,6,4,2,1,4,2,3,4,2,1,1,0,4,2,3,4,1,0,1,0
1,3,0,1,7,2,5,1,3,0,1,1,5,1,4,1,3,0,1,1,4,1,3,0
2,1,3,1,27,13,14,4,1,3,2,1,14,7,7,2,1,3,2,1,7,3,4,1
0,2,2,3,14,1,13,9,2,2,0,3,13,1,12,8,2,2,0,3,12,1,11,7
1,3,4,4,9,2,7,6,3,4,1,4,7,2,5,4,3,4,1,4,5,1,4,3
1,3,4,1,7,2,5,1,3,4,1,1,5,1,4,1,3,4,1,1,4,1,3,0
1,2,4,0,21,6,15,1,2,4,1,0,15,4,11,1,2,4,1,0,11,3,8,0
0,1,1,1,8,0,8,2,1,1,0,1,8,0,8,2,1,1,0,1,8,0,8,2
3,0,0,0,5,3,2,0,0,0,3,0,2,1,1,0,0,0,3,0,1,0,1,0
1,0,2,3,10,3,7,4,0,2,1,3,7,2,5,3,0,2,1,3,5,1,4,2
0,2,1,2,7,0,7,3,2,1,0,2,7,0,7,3,2,1,0,2,7,0,7,3
2,2,2,1,17,8,9,2,2,2,2,1,9,4,5,1,2,2,2,1,5,2,3,0
3,2,1,2,11,7,4,2,2,1,3,2,4,2,2,0,2,1,3,2,2,1,1,0
0,1,2,0,10,0,10,1,1,2,0,0,10,0,10,0,1,2,0,0,10,1,9,0
3,0,0,1,6,4,2,0,0,0,3,1,2,1,1,0,0,0,3,1,1,0,1,0
3,1,2,0,14,9,5,0,1,2,3,0,5,3,2,0,1,2,3,0,2,1,1,0
0,0,1,1,13,1,12,3,0,1,0,1,12,1,11,3,0,1,0,1,11,1,10,3
0,2,4,3,21,2,19,13,2,4,0,3,19,1,18,12,2,4,0,3,18,1,17,11
2,3,4,2,7,3,4,1,3,4,2,2,4,1,3,1,3,4,2,2,3,1,2,0
2,4,1,2,4,1,3,1,4,1,2,2,3,1,2,0,4,1,2,2,2,0,2,1
0,4,0,1,1,0,1,0,4,0,0,1,1,0,1,0,4,0,0,1,1,0,1,0
3,4,0,0,2,1,1,0,4,0,3,0,1,0,1,0,4,0,3,0,1,0,1,0
0,3,0,3,11,1,10,7,3,0,0,3,10,0,10,6,3,0,0,3,10,0,10,6
3,3,1,4,4,2,2,1,3,1,3,4,2,1,1,0,3,1,3,4,1,0,1,0
2,3,3,1,4,2,2,0,3,3,2,1,2,1,1,0,3,3,2,1,1,0,1,0
2,4,1,4,1,0,1,0,4,1,2,4,1,0,1,0,4,1,2,4,1,0,1,0
0,1,4,3,25,2,23,16,1,4,0,3,23,2,21,14,1,4,0,3,21,2,19,13
4,0,0,0,7,6,1,0,0,0,4,0,1,0,1,0,0,0,4,0,1,0,1,0
2,4,2,2,6,2,4,2,4,2,2,2,4,1,3,1,4,2,2,2,3,1,2,1
0,4,3,1,7,0,7,2,4,3,0,1,7,0,7,2,4,3,0,1,7,0,7,2
3,1,4,3,28,19,9,6,1,4,3,3,9,6,3,2,1,4,3,3,3,2,1,0
2,4,0,2,7,3,4,2,4,0,2,2,4,1,3,1,4,0,2,2,3,1,2,1
4,0,1,2,14,12,2,1,0,1,4,2,2,1,1,0,0,1,4,2,1,0,1,0
4,2,3,4,21,18,3,2,2,3,4,4,3,2,1,0,2,3,4,4,1,0,1,0
2,0,1,3,22,10,12,8,0,1,2,3,12,6,6,4,0,1,2,3,6,3,3,2
4,3,0,0,3,2,1,0,3,0,4,0,1,0,1,0,3,0,4,0,1,0,1,0
3,3,2,4,4,2,2,1,3,2,3,4,2,1,1,0,3,2,3,4,1,0,1,0
4,2,3,0,16,14,2,0,2,3,4,0,2,1,1,0,2,3,4,0,1,0,1,0
3,2,4,2,13,9,4,1,2,4,3,2,4,2,2,0,2,4,3,2,2,1,1,0
3,1,4,2,27,18,9,4,1,4,3,2,9,6,3,1,1,4,3,2,3,2,1,0
0,2,0,3,13,1,12,8,2,0,0,3,12,1,11,7,2,0,0,3,11,1,10,7
1,1,3,0,24,7,17,1,1,3,1,0,17,5,12,1,1,3,1,0,12,3,9,0
1,4,2,4,8,2,6,5,4,2,1,4,6,1,5,4,4,2,1,4,5,1,4,3
2,1,1,1,11,5,6,1,1,1,2,1,6,2,4,1,1,1,2,1,4,1,3,0
0,4,1,3,0,0,0,0,4,1,0,3,0,0,0,0,4,1,0,3,0,0,0,0
3,1,0,2,4,2,2,1,1,0,3,2,2,1,1,0,1,0,3,2,1,0,1,0
0,4,1,3,10,0,10,7,4,1,0,3,10,0,10,7,4,1,0,3,10,1,9,6
4,4,3,3,2,1,1,0,4,3,4,3,1,0,1,0,4,3,4,3,1,0,1,0
2,0,2,1,15,7,8,2,0,2,2,1,8,3,5,1,0,2,2,1,5,2,3,0
4,4,0,1,1,0,1,0,4,0,4,1,1,0,1,0,4,0,4,1,1,0,1,0
0,0,2,1,21,2,19,5,0,2,0,1,19,1,18,5,0,2,0,1,18,1,17,5
3,1,3,3,21,14,7,4,1,3,3,3,7,4,3,2,1,3,3,3,3,2,1,0
4,3,2,1,9,8,1,0,3,2,4,1,1,0,1,0,3,2,4,1,1,0,1,0
2,0,4,2,29,14,15,7,0,4,2,2,15,7,8,4,0,4,2,2,8,3,5,2
1,1,0,2,10,2,8,3,1,0,1,2,8,2,6,3,1,0,1,2,6,1,5,2
1,3,4,0,20,5,15,1,3,4,1,0,15,4,11,1,3,4,1,0,11,3,8,0
3,2,4,4,22,15,7,6,2,4,3,4,7,4,3,2,2,4,3,4,3,2,1,0
3,0,4,3,28,19,9,6,0,4,3,3,9,6,3,2,0,4,3,3,3,2,1,0
2,4,1,2,4,1,3,1,4,1,2,2,3,1,2,1,4,1,2,2,2,0,2,1
4,3,2,1,6,5,1,0,3,2,4,1,1,0,1,0,3,2,4,1,1,0,1,0
4,3,3,4,23,20,3,2,3,3,4,4,3,2,1,0,3,3,4,4,1,0,1,0
3,0,2,1,20,14,6,1,0,2,3,1,6,4,2,0,0,2,3,1,2,1,1,0
3,2,1,1,1,0,1,0,2,1,3,1,1,0,1,0,2,1,3,1,1,0,1,0
1,3,4,4,15,4,11,9,3,4,1,4,11,3,8,7,3,4,1,4,8,2,6,5
2,3,1,3,2,1,1,0,3,1,2,3,1,0,1,0,3,1,2,3,1,0,1,0
4,1,0,2,11,9,2,0,1,0,4,2,2,1,1,0,1,0,4,2,1,0,1,0
1,1,1,1,12,3,9,2,1,1,1,1,9,2,7,2,1,1,1,1,7,2,5,1
4,4,4,1,4,3,1,0,4,4,4,1,1,0,1,0,4,4,4,1,1,0,1,0
3,0,2,4,20,14,6,5,0,2,3,4,6,4,2,1,0,2,3,4,2,1,1,0
1,3,3,1,7,2,5,1,3,3,1,1,5,1,4,1,3,3,1,1,4,1,3,0
2,3,1,1,6,3,3,0,3,1,2,1,3,1,2,0,3,1,2,1,2,1,1,0
2,3,3,3,3,1,2,1,3,3,2,3,2,1,1,0,3,3,2,3,1,0,1,0
2,1,1,4,15,7,8,7,1,1,2,4,8,4,4,3,1,1,2,4,4,1,3,2
2,3,3,4,8,4,4,3,3,3,2,4,4,2,2,1,3,3,2,4,2,1,1,0
2,4,0,0,5,2,3,0,4,0,2,0,3,1,2,0,4,0,2,0,2,1,1,0
2,2,0,0,3,1,2,0,2,0,2,0,2,1,1,0,2,0,2,0,1,0,1,0
4,1,0,3,5,4,1,0,1,0,4,3,1,0,1,0,1,0,4,3,1,0,1,0
2,4,1,4,6,2,4,3,4,1,2,4,4,1,3,2,4,1,2,4,3,1,2,1
0,3,1,3,5,0,5,3,3,1,0,3,5,0,5,3,3,1,0,3,5,0,5,3
1,3,3,0,3,0,3,0,3,3,1,0,3,0,3,0,3,3,1,0,3,0,3,0
3,0,3,0,29,20,9,0,0,3,3,0,9,6,3,0,0,3,3,0,3,2,1,0
0,0,1,0,11,1,10,1,0,1,0,0,10,0,10,1,0,1,0,0,10,0,10,0
0,1,1,4,23,2,21,18,1,1,0,4,21,2,19,17,1,1,0,4,19,1,18,16
1,2,4,4,17,5,12,10,2,4,1,4,12,3,9,8,2,4,1,4,9,2,7,6
1,0,3,1,25,7,18,5,0,3,1,1,18,5,13,3,0,3,1,1,13,3,10,3
1,3,3,4,5,1,4,3,3,3,1,4,4,1,3,2,3,3,1,4,3,0,3,2
4,2,3,2,28,25,3,1,2,3,4,2,3,2,1,0,2,3,4,2,1,0,1,0
1,3,0,0,8,2,6,0,3,0,1,0,6,1,5,0,3,0,1,0,5,1,4,0
2,3,1,0,7,3,4,0,3,1,2,0,4,2,2,0,3,1,2,0,2,1,1,0
2,4,1,4,4,2,2,1,4,1,2,4,2,0,2,1,4,1,2,4,2,0,2,1
0,3,3,3,11,1,10,7,3,3,0,3,10,1,9,6,3,3,0,3,9,0,9,6
1,3,0,0,5,1,4,0,3,0,1,0,4,1,3,0,3,0,1,0,3,0,3,0
1,1,2,3,15,4,11,7,1,2,1,3,11,3,8,5,1,2,1,3,8,2,6,4
2,2,3,1,22,11,11,3,2,3,2,1,11,5,6,1,2,3,2,1,6,3,3,0
4,3,2,3,13,11,2,1,3,2,4,3,2,1,1,0,3,2,4,3,1,0,1,0
2,1,1,4,5,2,3,2,1,1,2,4,3,1,2,1,1,1,2,4,2,0,2,1
0,4,2,2,9,0,9,4,4,2,0,2,9,0,9,4,4,2,0,2,9,0,9,4
3,1,4,4,29,20,9,8,1,4,3,4,9,6,3,2,1,4,3,4,3,2,1,0
2,0,2,1,25,12,13,3,0,2,2,1,13,6,7,2,0,2,2,1,7,3,4,1
0,3,2,4,2,0,2,1,3,2,0,4,2,0,2,1,3,2,0,4,2,0,2,1
1,3,1,3,2,0,2,1,3,1,1,3,2,0,2,1,3,1,1,3,2,0,2,1
4,3,3,0,8,7,1,0,3,3,4,0,1,0,1,0,3,3,4,0,1,0,1,0
2,2,4,4,22,10,12,10,2,4,2,4,12,6,6,5,2,4,2,4,6,2,4,3
0,3,4,3,14,1,13,9,3,4,0,3,13,1,12,8,3,4,0,3,12,1,11,7
0,3,0,2,2,0,2,0,3,0,0,2,2,0,2,1,3,0,0,2,2,0,2,0
2,2,4,0,18,8,10,1,2,4,2,0,10,5,5,0,2,4,2,0,5,2,3,0
2,3,1,4,3,1,2,1,3,1,2,4,2,1,1,0,3,1,2,4,1,0,1,0
4,3,1,1,5,4,1,0,3,1,4,1,1,0,1,0,3,1,4,1,1,0,1,0
1,1,1,1,12,3,9,2,1,1,1,1,9,2,7,2,1,1,1,1,7,2,5,1
4,1,4,2,23,20,3,1,1,4,4,2,3,2,1,0,1,4,4,2,1,0,1,0
2,1,2,4,15,7,8,7,1,2,2,4,8,4,4,3,1,2,2,4,4,1,3,2
2,4,3,1,5,2,3,0,4,3,2,1,3,1,2,0,4,3,2,1,2,0,2,0
3,2,2,0,12,8,4,0,2,2,3,0,4,2,2,0,2,2,3,0,2,1,1,0
2,1,0,3,3,1,2,1,1,0,2,3,2,1,1,0,1,0,2,3,1,0,1,0
3,4,3,0,7,4,3,0,4,3,3,0,3,2,1,0,4,3,3,0,1,0,1,0
1,2,3,3,16,4,12,8,2,3,1,3,12,3,9,6,2,3,1,3,9,2,7,4
2,4,4,3,13,6,7,4,4,4,2,3,7,3,4,2,4,4,2,3,4,2,2,1
4,3,1,2,4,3,1,0,3,1,4,2,1,0,1,0,3,1,4,2,1,0,1,0
1,4,2,2,6,1,5,2,4,2,1,2,5,1,4,2,4,2,1,2,4,1,3,1
2,0,1,0,17,8,9,0,0,1,2,0,9,4,5,0,0,1,2,0,5,2,3,0
1,0,2,3,19,5,14,9,0,2,1,3,14,4,10,7,0,2,1,3,10,3,7,4
3,0,1,0,16,11,5,0,0,1,3,0,5,3,2,0,0,1,3,0,2,1,1,0
3,1,4,0,27,18,9,0,1,4,3,0,9,6,3,0,1,4,3,0,3,2,1,0
3,2,2,2,11,7,4,2,2,2,3,2,4,2,2,1,2,2,3,2,2,1,1,0
1,2,4,1,27,8,19,5,2,4,1,1,19,5,14,4,2,4,1,1,14,4,10,3
1,3,4,3,17,5,12,8,3,4,1,3,12,3,9,6,3,4,1,3,9,2,7,4
4,2,3,3,23,20,3,2,2,3,4,3,3,2,1,0,2,3,4,3,1,0,1,0
3,1,0,1,14,9,5,1,1,0,3,1,5,3,2,0,1,0,3,1,2,1,1,0
4,2,1,1,6,5,1,0,2,1,4,1,1,0,1,0,2,1,4,1,1,0,1,0
2,4,4,1,7,3,4,1,4,4,2,1,4,2,2,0,4,4,2,1,2,1,1,0
2,3,3,2,10,5,5,2,3,3,2,2,5,2,3,1,3,3,2,2,3,1,2,0
2,1,2,0,5,2,3,0,1,2,2,0,3,1,2,0,1,2,2,0,2,0,2,0
2,0,3,0,23,11,12,1,0,3,2,0,12,6,6,0,0,3,2,0,6,3,3,0
1,1,3,4,17,5,12,10,1,3,1,4,12,3,9,8,1,3,1,4,9,2,7,6
2,2,0,3,4,1,3,2,2,0,2,3,3,1,2,1,2,0,2,3,2,1,1,0
0,4,4,0,10,0,10,0,4,4,0,0,10,0,10,0,4,4,0,0,10,0,10,1
1,4,4,4,11,3,8,7,4,4,1,4,8,2,6,5,4,4,1,4,6,1,5,4
2,4,2,0,7,3,4,0,4,2,2,0,4,1,3,0,4,2,2,0,3,1,2,0
2,2,4,0,28,13,15,1,2,4,2,0,15,7,8,0,2,4,2,0,8,4,4,0
2,3,0,2,5,2,3,1,3,0,2,2,3,1,2,1,3,0,2,2,2,0,2,0
4,1,0,0,10,8,2,0,1,0,4,0,2,1,1,0,1,0,4,0,1,0,1,0
0,3,0,1,7,0,7,2,3,0,0,1,7,0,7,2,3,0,0,1,7,0,7,2
3,3,1,1,7,4,3,0,3,1,3,1,3,2,1,0,3,1,3,1,1,0,1,0
1,4,4,4,12,3,9,8,4,4,1,4,9,2,7,6,4,4,1,4,7,2,5,4
0,3,1,1,11,1,10,2,3,1,0,1,10,1,9,2,3,1,0,1,9,0,9,2
1,4,0,4,0,0,0,0,4,0,1,4,0,0,0,0,4,0,1,4,0,0,0,0
2,3,4,0,18,9,9,0,3,4,2,0,9,4,5,0,3,4,2,0,5,2,3,0
3,0,2,2,28,19,9,4,0,2,3,2,9,6,3,1,0,2,3,2,3,2,1,0
3,3,1,4,4,2,2,1,3,1,3,4,2,1,1,0,3,1,3,4,1,0,1,0
0,0,2,2,16,1,15,7,0,2,0,2,15,1,14,6,0,2,0,2,14,1,13,6
3,2,1,2,16,11,5,2,2,1,3,2,5,3,2,0,2,1,3,2,2,1,1,0
1,3,2,4,10,2,8,7,3,2,1,4,8,2,6,5,3,2,1,4,6,1,5,4
2,4,3,1,8,3,5,1,4,3,2,1,5,2,3,0,4,3,2,1,3,1,2,0
3,4,2,3,6,4,2,1,4,2,3,3,2,1,1,0,4,2,3,3,1,0,1,0
1,1,3,4,22,6,16,14,1,3,1,4,16,4,12,10,1,3,1,4,12,3,9,8
2,1,2,3,22,10,12,8,1,2,2,3,12,5,7,4,1,2,2,3,7,3,4,2
1,1,3,3,25,7,18,12,1,3,1,3,18,5,13,9,1,3,1,3,13,3,10,7
1,2,1,1,10,2,8,2,2,1,1,1,8,2,6,1,2,1,1,1,6,1,5,1
2,1,3,2,28,13,15,7,1,3,2,2,15,7,8,3,1,3,2,2,8,4,4,2
2,0,2,4,19,9,10,9,0,2,2,4,10,4,6,5,0,2,2,4,6,2,4,3
1,4,4,1,1,0,1,0,4,4,1,1,1,0,1,0,4,4,1,1,1,0,1,0
3,1,4,2,25,17,8,3,1,4,3,2,8,5,3,1,1,4,3,2,3,2,1,0
0,1,3,0,27,2,25,2,1,3,0,0,25,2,23,2,1,3,0,0,23,2,21,2
4,3,4,0,25,22,3,0,3,4,4,0,3,2,1,0,3,4,4,0,1,0,1,0
1,1,0,1,6,1,5,1,1,0,1,1,5,1,4,1,1,0,1,1,4,1,3,0
2,4,4,4,14,6,8,7,4,4,2,4,8,4,4,3,4,4,2,4,4,1,3,2
3,0,2,1,20,13,7,2,0,2,3,1,7,4,3,0,0,2,3,1,3,2,1,0
2,0,3,0,17,8,9,0,0,3,2,0,9,4,5,0,0,3,2,0,5,2,3,0
2,0,3,4,24,12,12,10,0,3,2,4,12,6,6,5,0,3,2,4,6,3,3,2
4,4,0,3,2,1,1,0,4,0,4,3,1,0,1,0,4,0,4,3,1,0,1,0
0,1,1,4,16,1,15,13,1,1,0,4,15,1,14,12,1,1,0,4,14,1,13,11
3,1,1,0,16,11,5,0,1,1,3,0,5,3,2,0,1,1,3,0,2,1,1,0
0,3,1,0,2,0,2,0,3,1,0,0,2,0,2,0,3,1,0,0,2,0,2,0
1,1,1,0,19,5,14,1,1,1,1,0,14,4,10,1,1,1,1,0,10,3,7,0
2,4,2,1,9,4,5,1,4,2,2,1,5,2,3,0,4,2,2,1,3,1,2,0
3,3,2,1,6,4,2,0,3,2,3,1,2,1,1,0,3,2,3,1,1,0,1,0
4,1,3,2,23,20,3,1,1,3,4,2,3,2,1,0,1,3,4,2,1,0,1,0
0,0,1,1,17,1,16,4,0,1,0,1,16,1,15,4,0,1,0,1,15,1,14,4
4,2,3,4,19,17,2,1,2,3,4,4,2,1,1,0,2,3,4,4,1,0,1,0
0,1,1,2,12,1,11,5,1,1,0,2,11,1,10,4,1,1,0,2,10,1,9,4
0,3,0,0,5,0,5,0,3,0,0,0,5,0,5,0,3,0,0,0,5,0,5,0
1,4,4,4,12,3,9,8,4,4,1,4,9,2,7,6,4,4,1,4,7,2,5,4
1,1,1,3,7,2,5,3,1,1,1,3,5,1,4,2,1,1,1,3,4,1,3,2
4,4,2,2,11,9,2,0,4,2,4,2,2,1,1,0,4,2,4,2,1,0,1,0
1,3,3,1,11,3,8,2,3,3,1,1,8,2,6,1,3,3,1,1,6,1,5,1
2,1,0,3,10,5,5,3,1,0,2,3,5,2,3,2,1,0,2,3,3,1,2,1
1,3,4,1,12,3,9,2,3,4,1,1,9,2,7,2,3,4,1,1,7,2,5,1
2,4,2,2,6,2,4,1,4,2,2,2,4,1,3,1,4,2,2,2,3,1,2,0
0,3,2,2,6,0,6,3,3,2,0,2,6,0,6,3,3,2,0,2,6,0,6,3
0,0,4,2,29,2,27,13,0,4,0,2,27,2,25,12,0,4,0,2,25,2,23,11
3,2,0,4,4,2,2,1,2,0,3,4,2,1,1,0,2,0,3,4,1,0,1,0
2,0,0,3,2,0,2,1,0,0,2,3,2,1,1,0,0,0,2,3,1,0,1,0
0,0,0,4,9,0,9,8,0,0,0,4,9,0,9,8,0,0,0,4,9,0,9,8
2,2,0,4,5,2,3,2,2,0,2,4,3,1,2,1,2,0,2,4,2,0,2,1
2,4,4,2,14,7,7,3,4,4,2,2,7,3,4,2,4,4,2,2,4,2,2,1
0,1,0,2,10,0,10,4,1,0,0,2,10,0,10,5,1,0,0,2,10,0,10,4
4,1,0,2,10,9,1,0,1,0,4,2,1,0,1,0,1,0,4,2,1,0,1,0
1,3,3,3,17,5,12,8,3,3,1,3,12,3,9,6,3,3,1,3,9,2,7,4
1,4,2,3,0,0,0,0,4,2,1,3,0,0,0,0,4,2,1,3,0,0,0,0
4,2,1,4,8,7,1,0,2,1,4,4,1,0,1,0,2,1,4,4,1,0,1,0
1,3,4,2,17,5,12,6,3,4,1,2,12,3,9,4,3,4,1,2,9,2,7,3
0,0,3,3,23,2,21,14,0,3,0,3,21,2,19,13,0,3,0,3,19,1,18,12
0,4,4,3,8,0,8,5,4,4,0,3,8,0,8,5,4,4,0,3,8,0,8,5
4,1,4,1,25,22,3,0,1,4,4,1,3,2,1,0,1,4,4,1,1,0,1,0
2,3,0,3,17,8,9,6,3,0,2,3,9,4,5,3,3,0,2,3,5,2,3,2
4,3,1,3,11,9,2,1,3,1,4,3,2,1,1,0,3,1,4,3,1,0,1,0
3,2,1,1,4,2,2,0,2,1,3,1,2,1,1,0,2,1,3,1,1,0,1,0
0,2,4,3,21,2,19,13,2,4,0,3,19,1,18,12,2,4,0,3,18,1,17,11
2,3,3,4,14,6,8,7,3,3,2,4,8,4,4,3,3,3,2,4,4,1,3,2
2,4,4,1,5,2,3,0,4,4,2,1,3,1,2,0,4,4,2,1,2,1,1,0
1,3,3,1,11,3,8,2,3,3,1,1,8,2,6,1,3,3,1,1,6,1,5,1
1,1,4,3,27,8,19,13,1,4,1,3,19,5,14,9,1,4,1,3,14,4,10,7
1,1,1,3,13,3,10,7,1,1,1,3,10,2,8,5,1,1,1,3,8,2,6,4
0,3,2,4,4,0,4,3,3,2,0,4,4,0,4,3,3,2,0,4,4,0,4,3
1,3,2,0,9,2,7,0,3,2,1,0,7,2,5,0,3,2,1,0,5,1,4,0
4,4,1,3,5,4,1,0,4,1,4,3,1,0,1,0,4,1,4,3,1,0,1,0
0,4,3,4,5,0,5,4,4,3,0,4,5,0,5,4,4,3,0,4,5,0,5,4
2,0,2,2,14,7,7,3,0,2,2,2,7,3,4,2,0,2,2,2,4,2,2,0
0,2,3,2,18,1,17,8,2,3,0,2,17,1,16,7,2,3,0,2,16,1,15,7
2,1,2,3,19,9,10,6,1,2,2,3,10,5,5,3,1,2,2,3,5,2,3,2
3,2,3,2,11,7,4,2,2,3,3,2,4,2,2,1,2,3,3,2,2,1,1,0
1,4,2,0,3,0,3,0,4,2,1,0,3,0,3,0,4,2,1,0,3,0,3,0
1,3,4,3,18,5,13,9,3,4,1,3,13,3,10,6,3,4,1,3,10,3,7,4
4,1,1,4,11,9,2,1,1,1,4,4,2,1,1,0,1,1,4,4,1,0,1,0
0,4,4,2,3,0,3,1,4,4,0,2,3,0,3,1,4,4,0,2,3,0,3,1
1,0,4,4,26,7,19,17,0,4,1,4,19,5,14,12,0,4,1,4,14,4,10,9
2,2,1,1,1,0,1,0,2,1,2,1,1,0,1,0,2,1,2,1,1,0,1,0
3,3,3,0,8,5,3,0,3,3,3,0,3,2,1,0,3,3,3,0,1,0,1,0
1,4,1,1,6,1,5,1,4,1,1,1,5,1,4,1,4,1,1,1,4,1,3,0
3,1,3,2,11,7,4,2,1,3,3,2,4,2,2,1,1,3,3,2,2,1,1,0
2,4,0,0,3,1,2,0,4,0,2,0,2,0,2,0,4,0,2,0,2,1,1,0
0,0,2,4,28,2,26,23,0,2,0,4,26,2,24,21,0,2,0,4,24,2,22,19
3,0,0,3,5,3,2,1,0,0,3,3,2,1,1,0,0,0,3,3,1,0,1,0
3,4,4,0,8,5,3,0,4,4,3,0,3,2,1,0,4,4,3,0,1,0,1,0
4,2,1,3,12,10,2,1,2,1,4,3,2,1,1,0,2,1,4,3,1,0,1,0
1,0,0,4,4,1,3,2,0,0,1,4,3,0,3,2,0,0,1,4,3,0,3,2
3,4,4,1,7,4,3,0,4,4,3,1,3,2,1,0,4,4,3,1,1,0,1,0
4,3,0,2,1,0,1,0,3,0,4,2,1,0,1,0,3,0,4,2,1,0,1,0
3,0,4,1,29,20,9,2,0,4,3,1,9,6,3,0,0,4,3,1,3,2,1,0
3,3,1,3,1,0,1,0,3,1,3,3,1,0,1,0,3,1,3,3,1,0,1,0
4,3,2,4,4,3,1,0,3,2,4,4,1,0,1,0,3,2,4,4,1,0,1,0
3,1,2,2,12,8,4,1,1,2,3,2,4,2,2,1,1,2,3,2,2,1,1,0
0,4,2,1,8,0,8,2,4,2,0,1,8,0,8,2,4,2,0,1,8,0,8,2
4,4,2,1,7,6,1,0,4,2,4,1,1,0,1,0,4,2,4,1,1,0,1,0
2,0,1,2,17,8,9,4,0,1,2,2,9,4,5,2,0,1,2,2,5,2,3,1
0,4,1,1,1,0,1,0,4,1,0,1,1,0,1,0,4,1,0,1,1,0,1,0
1,3,0,4,0,0,0,0,3,0,1,4,0,0,0,0,3,0,1,4,0,0,0,0
4,1,4,1,22,19,3,0,1,4,4,1,3,2,1,0,1,4,4,1,1,0,1,0
2,0,2,2,29,14,15,7,0,2,2,2,15,7,8,3,0,2,2,2,8,3,5,2
0,3,3,2,12,1,11,5,3,3,0,2,11,1,10,4,3,3,0,2,10,1,9,4
2,1,0,2,7,3,4,2,1,0,2,2,4,2,2,0,1,0,2,2,2,1,1,0
3,1,0,4,3,2,1,0,1,0,3,4,1,0,1,0,1,0,3,4,1,0,1,0
3,3,0,2,4,2,2,0,3,0,3,2,2,1,1,0,3,0,3,2,1,0,1,0
0,0,3,2,23,2,21,10,0,3,0,2,21,2,19,9,0,3,0,2,19,1,18,9
4,0,2,2,19,17,2,0,0,2,4,2,2,1,1,0,0,2,4,2,1,0,1,0
4,0,4,2,26,23,3,1,0,4,4,2,3,2,1,0,0,4,4,2,1,0,1,0
2,1,1,4,8,4,4,3,1,1,2,4,4,1,3,2,1,1,2,4,3,1,2,1
0,4,0,3,3,0,3,2,4,0,0,3,3,0,3,2,4,0,0,3,3,0,3,2
3,1,0,0,0,0,0,0,1,0,3,0,0,0,0,0,1,0,3,0,0,0,0,0
2,4,3,2,10,4,6,3,4,3,2,2,6,3,3,1,4,3,2,2,3,1,2,0
2,3,2,1,7,3,4,1,3,2,2,1,4,1,3,0,3,2,2,1,3,1,2,0
1,0,2,3,18,5,13,9,0,2,1,3,13,3,10,6,0,2,1,3,10,3,7,4
2,3,3,3,8,3,5,3,3,3,2,3,5,2,3,2,3,3,2,3,3,1,2,1
2,2,4,1,23,11,12,3,2,4,2,1,12,5,7,2,2,4,2,1,7,3,4,1
2,3,2,1,6,2,4,1,3,2,2,1,4,1,3,0,3,2,2,1,3,1,2,0
4,0,2,1,17,15,2,0,0,2,4,1,2,1,1,0,0,2,4,1,1,0,1,0
2,3,0,1,3,1,2,0,3,0,2,1,2,0,2,0,3,0,2,1,2,0,2,0
1,0,0,2,6,1,5,2,0,0,1,2,5,1,4,1,0,0,1,2,4,1,3,1
2,3,3,0,11,5,6,0,3,3,2,0,6,3,3,0,3,3,2,0,3,1,2,0
3,2,2,3,17,11,6,4,2,2,3,3,6,4,2,1,2,2,3,3,2,1,1,0
4,4,1,1,0,0,0,0,4,1,4,1,0,0,0,0,4,1,4,1,0,0,0,0
0,0,2,1,12,1,11,3,0,2,0,1,11,1,10,2,0,2,0,1,10,0,10,2
3,2,1,3,1,0,1,0,2,1,3,3,1,0,1,0,2,1,3,3,1,0,1,0
4,4,4,0,7,6,1,0,4,4,4,0,1,0,1,0,4,4,4,0,1,0,1,0
3,3,1,1,10,6,4,1,3,1,3,1,4,2,2,0,3,1,3,1,2,1,1,0
2,3,0,2,2,1,1,0,3,0,2,2,1,0,1,0,3,0,2,2,1,0,1,0
4,2,1,0,5,4,1,0,2,1,4,0,1,0,1,0,2,1,4,0,1,0,1,0
1,3,0,3,9,2,7,4,3,0,1,3,7,2,5,3,3,0,1,3,5,1,4,2
4,2,3,1,14,12,2,0,2,3,4,1,2,1,1,0,2,3,4,1,1,0,1,0
2,0,3,4,27,13,14,12,0,3,2,4,14,6,8,7,0,3,2,4,8,4,4,3
4,4,3,1,4,3,1,0,4,3,4,1,1,0,1,0,4,3,4,1,1,0,1,0
2,2,1,0,4,2,2,0,2,1,2,0,2,0,2,0,2,1,2,0,2,0,2,0
3,4,0,2,1,0,1,0,4,0,3,2,1,0,1,0,4,0,3,2,1,0,1,0
1,1,4,1,21,6,15,4,1,4,1,1,15,4,11,3,1,4,1,1,11,3,8,2
3,0,2,1,15,10,5,1,0,2,3,1,5,3,2,0,0,2,3,1,2,1,1,0
4,1,0,4,2,1,1,0,1,0,4,4,1,0,1,0,1,0,4,4,1,0,1,0
3,3,4,2,19,13,6,2,3,4,3,2,6,4,2,0,3,4,3,2,2,1,1,0
4,0,0,0,7,6,1,0,0,0,4,0,1,0,1,0,0,0,4,0,1,0,1,0
2,0,0,1,10,5,5,1,0,0,2,1,5,2,3,0,0,0,2,1,3,1,2,0
1,2,2,1,14,4,10,3,2,2,1,1,10,3,7,2,2,2,1,1,7,2,5,1
1,1,1,1,8,2,6,1,1,1,1,1,6,1,5,1,1,1,1,1,5,1,4,1
2,3,2,3,20,9,11,7,3,2,2,3,11,5,6,4,3,2,2,3,6,2,4,2
4,0,4,3,29,26,3,2,0,4,4,3,3,2,1,0,0,4,4,3,1,0,1,0
3,2,2,4,17,11,6,5,2,2,3,4,6,4,2,1,2,2,3,4,2,1,1,0
4,3,3,3,9,8,1,0,3,3,4,3,1,0,1,0,3,3,4,3,1,0,1,0
3,4,1,0,3,2,1,0,4,1,3,0,1,0,1,0,4,1,3,0,1,0,1,0
0,0,3,3,21,2,19,13,0,3,0,3,19,1,18,12,0,3,0,3,18,1,17,11
1,0,2,0,19,5,14,1,0,2,1,0,14,4,10,0,0,2,1,0,10,3,7,0
3,0,4,0,29,20,9,0,0,4,3,0,9,6,3,0,0,4,3,0,3,2,1,0
1,2,4,1,22,6,16,4,2,4,1,1,16,4,12,3,2,4,1,1,12,3,9,2
3,2,3,3,17,11,6,4,2,3,3,3,6,4,2,1,2,3,3,3,2,1,1,0
4,3,3,1,8,7,1,0,3,3,4,1,1,0,1,0,3,3,4,1,1,0,1,0
3,0,4,1,29,20,9,2,0,4,3,1,9,6,3,0,0,4,3,1,3,2,1,0
4,3,2,0,4,3,1,0,3,2,4,0,1,0,1,0,3,2,4,0,1,0,1,0
4,0,0,2,1,0,1,0,0,0,4,2,1,0,1,0,0,0,4,2,1,0,1,0
2,3,0,2,2,0,2,1,3,0,2,2,2,0,2,1,3,0,2,2,2,1,1,0
1,2,1,4,8,2,6,5,2,1,1,4,6,1,5,4,2,1,1,4,5,1,4,3
4,0,1,3,11,9,2,1,0,1,4,3,2,1,1,0,0,1,4,3,1,0,1,0
4,1,0,0,3,2,1,0,1,0,4,0,1,0,1,0,1,0,4,0,1,0,1,0
2,3,2,3,0,0,0,0,3,2,2,3,0,0,0,0,3,2,2,3,0,0,0,0
0,1,1,0,6,0,6,0,1,1,0,0,6,0,6,0,1,1,0,0,6,0,6,0
0,3,1,4,7,0,7,6,3,1,0,4,7,0,7,6,3,1,0,4,7,0,7,6
3,2,2,3,22,15,7,4,2,2,3,3,7,4,3,2,2,2,3,3,3,2,1,0
1,4,0,4,6,1,5,4,4,0,1,4,5,1,4,3,4,0,1,4,4,1,3,2
1,4,0,2,7,2,5,2,4,0,1,2,5,1,4,1,4,0,1,2,4,1,3,1
3,1,1,3,11,7,4,2,1,1,3,3,4,2,2,1,1,1,3,3,2,1,1,0
1,1,2,1,12,3,9,2,1,2,1,1,9,2,7,2,1,2,1,1,7,2,5,1
3,1,2,3,26,18,8,5,1,2,3,3,8,5,3,2,1,2,3,3,3,2,1,0
0,0,1,3,21,2,19,13,0,1,0,3,19,1,18,12,0,1,0,3,18,1,17,11
1,4,3,1,10,2,8,2,4,3,1,1,8,2,6,1,4,3,1,1,6,1,5,1
2,1,0,1,6,2,4,1,1,0,2,1,4,2,2,0,1,0,2,1,2,0,2,0
2,0,2,1,24,12,12,3,0,2,2,1,12,5,7,2,0,2,2,1,7,3,4,1
3,3,4,4,14,9,5,4,3,4,3,4,5,3,2,1,3,4,3,4,2,1,1,0
4,4,2,1,0,0,0,0,4,2,4,1,0,0,0,0,4,2,4,1,0,0,0,0
3,2,4,4,18,12,6,5,2,4,3,4,6,4,2,1,2,4,3,4,2,1,1,0
0,0,0,0,0,0,0,0,0,0,0,0,0,0,0,0,0,0,0,0,0,0,0,0
4,4,0,0,1,0,1,0,4,0,4,0,1,0,1,0,4,0,4,0,1,0,1,0
0,1,1,4,8,0,8,7,1,1,0,4,8,0,8,7,1,1,0,4,8,0,8,7
2,4,3,0,6,3,3,0,4,3,2,0,3,1,2,0,4,3,2,0,2,0,2,0
0,3,1,4,0,0,0,0,3,1,0,4,0,0,0,0,3,1,0,4,0,0,0,0
1,1,0,3,4,1,3,2,1,0,1,3,3,0,3,2,1,0,1,3,3,0,3,2
4,0,3,4,20,17,3,2,0,3,4,4,3,2,1,0,0,3,4,4,1,0,1,0
1,4,1,1,1,0,1,0,4,1,1,1,1,0,1,0,4,1,1,1,1,0,1,0
4,4,1,0,4,3,1,0,4,1,4,0,1,0,1,0,4,1,4,0,1,0,1,0
4,2,1,1,14,12,2,0,2,1,4,1,2,1,1,0,2,1,4,1,1,0,1,0
4,1,2,2,14,12,2,1,1,2,4,2,2,1,1,0,1,2,4,2,1,0,1,0
1,3,1,0,7,2,5,0,3,1,1,0,5,1,4,0,3,1,1,0,4,1,3,0
4,4,4,1,10,9,1,0,4,4,4,1,1,0,1,0,4,4,4,1,1,0,1,0
4,2,4,2,21,18,3,1,2,4,4,2,3,2,1,0,2,4,4,2,1,0,1,0
0,1,0,2,4,0,4,2,1,0,0,2,4,0,4,1,1,0,0,2,4,0,4,2
3,4,2,1,6,4,2,0,4,2,3,1,2,1,1,0,4,2,3,1,1,0,1,0
4,0,3,1,28,25,3,0,0,3,4,1,3,2,1,0,0,3,4,1,1,0,1,0
3,3,1,1,6,4,2,0,3,1,3,1,2,1,1,0,3,1,3,1,1,0,1,0
3,2,4,1,19,13,6,1,2,4,3,1,6,4,2,0,2,4,3,1,2,1,1,0
2,3,3,1,14,6,8,2,3,3,2,1,8,3,5,1,3,3,2,1,5,2,3,0
1,4,4,4,5,1,4,3,4,4,1,4,4,1,3,2,4,4,1,4,3,0,3,2
4,2,2,1,20,17,3,0,2,2,4,1,3,2,1,0,2,2,4,1,1,0,1,0
4,3,0,3,4,3,1,0,3,0,4,3,1,0,1,0,3,0,4,3,1,0,1,0
4,4,3,2,6,5,1,0,4,3,4,2,1,0,1,0,4,3,4,2,1,0,1,0
4,4,1,4,5,4,1,0,4,1,4,4,1,0,1,0,4,1,4,4,1,0,1,0
3,0,1,4,13,9,4,3,0,1,3,4,4,2,2,1,0,1,3,4,2,1,1,0
1,4,4,2,10,3,7,3,4,4,1,2,7,2,5,2,4,4,1,2,5,1,4,2
1,3,1,3,10,2,8,5,3,1,1,3,8,2,6,4,3,1,1,3,6,1,5,3
4,3,4,3,12,10,2,1,3,4,4,3,2,1,1,0,3,4,4,3,1,0,1,0
0,3,3,0,10,1,9,0,3,3,0,0,9,0,9,0,3,3,0,0,9,0,9,0
0,0,4,0,29,2,27,2,0,4,0,0,27,2,25,2,0,4,0,0,25,2,23,2
4,1,0,1,3,2,1,0,1,0,4,1,1,0,1,0,1,0,4,1,1,0,1,0
0,0,1,2,14,1,13,6,0,1,0,2,13,1,12,6,0,1,0,2,12,1,11,5
1,1,0,0,10,2,8,0,1,0,1,0,8,2,6,0,1,0,1,0,6,1,5,0
1,0,0,1,5,1,4,1,0,0,1,1,4,1,3,0,0,0,1,1,3,0,3,0
2,0,4,0,29,14,15,1,0,4,2,0,15,7,8,0,0,4,2,0,8,4,4,0
1,3,1,2,11,3,8,3,3,1,1,2,8,2,6,3,3,1,1,2,6,1,5,2
0,4,3,1,3,0,3,0,4,3,0,1,3,0,3,0,4,3,0,1,3,0,3,0
4,0,1,1,14,12,2,0,0,1,4,1,2,1,1,0,0,1,4,1,1,0,1,0
4,1,4,3,29,26,3,2,1,4,4,3,3,2,1,0,1,4,4,3,1,0,1,0
2,3,4,1,14,7,7,2,3,4,2,1,7,3,4,1,3,4,2,1,4,1,3,0
3,3,3,3,15,10,5,3,3,3,3,3,5,3,2,1,3,3,3,3,2,1,1,0
1,0,3,3,28,8,20,13,0,3,1,3,20,5,15,10,0,3,1,3,15,4,11,7
1,4,2,0,8,2,6,0,4,2,1,0,6,1,5,0,4,2,1,0,5,1,4,0
3,4,0,2,5,3,2,1,4,0,3,2,2,1,1,0,4,0,3,2,1,0,1,0
2,4,1,4,0,0,0,0,4,1,2,4,0,0,0,0,4,1,2,4,0,0,0,0
4,3,0,2,2,1,1,0,3,0,4,2,1,0,1,0,3,0,4,2,1,0,1,0
1,0,0,4,9,2,7,6,0,0,1,4,7,2,5,4,0,0,1,4,5,1,4,3
2,3,4,3,12,5,7,4,3,4,2,3,7,3,4,2,3,4,2,3,4,2,2,1
4,4,3,1,1,0,1,0,4,3,4,1,1,0,1,0,4,3,4,1,1,0,1,0
3,1,1,3,5,3,2,1,1,1,3,3,2,1,1,0,1,1,3,3,1,0,1,0
2,4,1,1,4,1,3,0,4,1,2,1,3,1,2,0,4,1,2,1,2,1,1,0
2,1,1,3,10,4,6,4,1,1,2,3,6,3,3,2,1,1,2,3,3,1,2,1
0,4,1,3,2,0,2,1,4,1,0,3,2,0,2,1,4,1,0,3,2,0,2,1
2,2,3,4,15,7,8,7,2,3,2,4,8,4,4,3,2,3,2,4,4,1,3,2
3,0,0,1,14,9,5,1,0,0,3,1,5,3,2,0,0,0,3,1,2,1,1,0
4,3,4,2,8,7,1,0,3,4,4,2,1,0,1,0,3,4,4,2,1,0,1,0
2,0,0,1,5,2,3,0,0,0,2,1,3,1,2,0,0,0,2,1,2,0,2,0
1,3,1,0,6,1,5,0,3,1,1,0,5,1,4,0,3,1,1,0,4,1,3,0
2,1,3,2,21,10,11,5,1,3,2,2,11,5,6,3,1,3,2,2,6,2,4,2
3,2,2,0,5,3,2,0,2,2,3,0,2,1,1,0,2,2,3,0,1,0,1,0
2,2,3,0,8,4,4,0,2,3,2,0,4,2,2,0,2,3,2,0,2,1,1,0
2,0,3,1,24,12,12,3,0,3,2,1,12,6,6,1,0,3,2,1,6,3,3,0
0,4,3,0,16,1,15,1,4,3,0,0,15,1,14,1,4,3,0,0,14,1,13,1
3,4,3,1,4,2,2,0,4,3,3,1,2,1,1,0,4,3,3,1,1,0,1,0
4,1,4,0,25,22,3,0,1,4,4,0,3,2,1,0,1,4,4,0,1,0,1,0
2,0,4,2,26,13,13,6,0,4,2,2,13,6,7,3,0,4,2,2,7,3,4,1
0,1,0,3,11,1,10,7,1,0,0,3,10,1,9,6,1,0,0,3,9,0,9,6
1,0,4,3,28,8,20,13,0,4,1,3,20,6,14,9,0,4,1,3,14,4,10,6
1,3,2,0,11,3,8,0,3,2,1,0,8,2,6,0,3,2,1,0,6,1,5,0
2,1,0,3,9,4,5,3,1,0,2,3,5,2,3,2,1,0,2,3,3,1,2,1
1,2,4,3,25,7,18,12,2,4,1,3,18,5,13,9,2,4,1,3,13,3,10,6
3,1,0,1,2,1,1,0,1,0,3,1,1,0,1,0,1,0,3,1,1,0,1,0
1,2,1,3,5,1,4,2,2,1,1,3,4,1,3,2,2,1,1,3,3,0,3,2
1,4,4,2,7,2,5,2,4,4,1,2,5,1,4,1,4,4,1,2,4,1,3,1
4,0,4,2,27,24,3,1,0,4,4,2,3,2,1,0,0,4,4,2,1,0,1,0
0,0,0,4,7,0,7,6,0,0,0,4,7,0,7,6,0,0,0,4,7,0,7,6
4,2,3,1,16,14,2,0,2,3,4,1,2,1,1,0,2,3,4,1,1,0,1,0
3,3,1,4,12,8,4,3,3,1,3,4,4,2,2,1,3,1,3,4,2,1,1,0
1,1,2,4,19,5,14,12,1,2,1,4,14,4,10,8,1,2,1,4,10,2,8,7
4,3,0,3,1,0,1,0,3,0,4,3,1,0,1,0,3,0,4,3,1,0,1,0
0,2,1,0,11,1,10,1,2,1,0,0,10,1,9,0,2,1,0,0,9,0,9,0
4,4,1,3,0,0,0,0,4,1,4,3,0,0,0,0,4,1,4,3,0,0,0,0
1,4,2,3,10,2,8,5,4,2,1,3,8,2,6,4,4,2,1,3,6,1,5,3
4,4,2,1,9,8,1,0,4,2,4,1,1,0,1,0,4,2,4,1,1,0,1,0
2,0,2,4,24,12,12,10,0,2,2,4,12,6,6,5,0,2,2,4,6,3,3,2
1,3,4,1,16,4,12,3,3,4,1,1,12,3,9,2,3,4,1,1,9,2,7,2
1,3,3,4,10,2,8,7,3,3,1,4,8,2,6,5,3,3,1,4,6,1,5,4
2,3,0,0,2,0,2,0,3,0,2,0,2,1,1,0,3,0,2,0,1,0,1,0
4,3,1,0,1,0,1,0,3,1,4,0,1,0,1,0,3,1,4,0,1,0,1,0
0,0,4,2,29,2,27,13,0,4,0,2,27,2,25,12,0,4,0,2,25,2,23,11
3,2,2,3,8,5,3,2,2,2,3,3,3,2,1,0,2,2,3,3,1,0,1,0
0,4,0,2,9,0,9,4,4,0,0,2,9,0,9,4,4,0,0,2,9,0,9,4
2,2,0,4,12,6,6,5,2,0,2,4,6,3,3,2,2,0,2,4,3,1,2,1
1,0,0,1,5,1,4,1,0,0,1,1,4,1,3,0,0,0,1,1,3,0,3,0
2,2,2,1,17,8,9,2,2,2,2,1,9,4,5,1,2,2,2,1,5,2,3,0
4,0,2,3,21,18,3,2,0,2,4,3,3,2,1,0,0,2,4,3,1,0,1,0
3,3,3,2,9,6,3,1,3,3,3,2,3,2,1,0,3,3,3,2,1,0,1,0
1,3,2,3,18,5,13,9,3,2,1,3,13,3,10,6,3,2,1,3,10,2,8,5
3,2,3,0,14,9,5,0,2,3,3,0,5,3,2,0,2,3,3,0,2,1,1,0
2,3,0,2,1,0,1,0,3,0,2,2,1,0,1,0,3,0,2,2,1,0,1,0
4,4,1,4,6,5,1,0,4,1,4,4,1,0,1,0,4,1,4,4,1,0,1,0
4,2,4,0,25,22,3,0,2,4,4,0,3,2,1,0,2,4,4,0,1,0,1,0
3,1,1,2,22,15,7,3,1,1,3,2,7,4,3,1,1,1,3,2,3,2,1,0
3,1,3,3,19,13,6,4,1,3,3,3,6,4,2,1,1,3,3,3,2,1,1,0
0,1,2,1,19,1,18,5,1,2,0,1,18,1,17,5,1,2,0,1,17,1,16,4
2,3,2,2,6,3,3,1,3,2,2,2,3,1,2,0,3,2,2,2,2,0,2,1
3,2,4,2,22,15,7,3,2,4,3,2,7,4,3,1,2,4,3,2,3,2,1,0
3,2,1,4,9,6,3,2,2,1,3,4,3,2,1,0,2,1,3,4,1,0,1,0
2,1,4,4,27,13,14,12,1,4,2,4,14,6,8,7,1,4,2,4,8,3,5,4
2,4,1,1,0,0,0,0,4,1,2,1,0,0,0,0,4,1,2,1,0,0,0,0
4,4,3,4,14,12,2,1,4,3,4,4,2,1,1,0,4,3,4,4,1,0,1,0
1,1,4,3,22,6,16,11,1,4,1,3,16,4,12,8,1,4,1,3,12,3,9,6
1,0,4,0,26,7,19,1,0,4,1,0,19,5,14,1,0,4,1,0,14,4,10,0
1,1,1,3,12,3,9,6,1,1,1,3,9,2,7,4,1,1,1,3,7,2,5,3
4,0,3,4,27,24,3,2,0,3,4,4,3,2,1,0,0,3,4,4,1,0,1,0
3,1,1,0,10,7,3,0,1,1,3,0,3,2,1,0,1,1,3,0,1,0,1,0
0,1,3,2,24,2,22,10,1,3,0,2,22,2,20,9,1,3,0,2,20,1,19,9
1,1,1,4,14,4,10,8,1,1,1,4,10,2,8,7,1,1,1,4,8,2,6,5
4,2,0,2,9,8,1,0,2,0,4,2,1,0,1,0,2,0,4,2,1,0,1,0
0,4,2,4,2,0,2,1,4,2,0,4,2,0,2,1,4,2,0,4,2,0,2,1
3,4,4,3,11,7,4,2,4,4,3,3,4,2,2,1,4,4,3,3,2,1,1,0
0,3,4,2,13,1,12,5,3,4,0,2,12,1,11,5,3,4,0,2,11,1,10,5
4,1,3,3,16,14,2,1,1,3,4,3,2,1,1,0,1,3,4,3,1,0,1,0
1,1,3,2,23,6,17,8,1,3,1,2,17,5,12,5,1,3,1,2,12,3,9,4
0,0,3,2,24,2,22,10,0,3,0,2,22,2,20,9,0,3,0,2,20,2,18,8
4,4,0,0,5,4,1,0,4,0,4,0,1,0,1,0,4,0,4,0,1,0,1,0
0,3,1,2,6,0,6,3,3,1,0,2,6,0,6,2,3,1,0,2,6,0,6,2
4,3,4,3,21,18,3,2,3,4,4,3,3,2,1,0,3,4,4,3,1,0,1,0
0,1,0,4,6,0,6,5,1,0,0,4,6,0,6,5,1,0,0,4,6,0,6,5
0,1,3,2,19,1,18,9,1,3,0,2,18,1,17,8,1,3,0,2,17,1,16,7
2,0,2,1,19,9,10,3,0,2,2,1,10,5,5,1,0,2,2,1,5,2,3,0
1,3,1,4,4,1,3,2,3,1,1,4,3,0,3,2,3,1,1,4,3,0,3,2
1,4,2,2,10,2,8,3,4,2,1,2,8,2,6,3,4,2,1,2,6,1,5,2
0,1,0,3,1,0,1,0,1,0,0,3,1,0,1,0,1,0,0,3,1,0,1,0
4,0,3,1,28,25,3,0,0,3,4,1,3,2,1,0,0,3,4,1,1,0,1,0
0,1,3,1,19,1,18,5,1,3,0,1,18,1,17,5,1,3,0,1,17,1,16,4
4,2,4,4,25,22,3,2,2,4,4,4,3,2,1,0,2,4,4,4,1,0,1,0
4,4,0,3,14,12,2,1,4,0,4,3,2,1,1,0,4,0,4,3,1,0,1,0
1,0,2,4,21,6,15,13,0,2,1,4,15,4,11,9,0,2,1,4,11,3,8,7
2,0,1,2,19,9,10,4,0,1,2,2,10,4,6,3,0,1,2,2,6,2,4,1
4,2,2,3,13,11,2,1,2,2,4,3,2,1,1,0,2,2,4,3,1,0,1,0
1,0,3,2,28,8,20,9,0,3,1,2,20,5,15,7,0,3,1,2,15,4,11,5
3,3,3,1,6,4,2,0,3,3,3,1,2,1,1,0,3,3,3,1,1,0,1,0
2,4,1,4,3,1,2,1,4,1,2,4,2,0,2,1,4,1,2,4,2,1,1,0
2,0,2,2,22,11,11,5,0,2,2,2,11,5,6,2,0,2,2,2,6,2,4,1
0,4,3,2,14,1,13,6,4,3,0,2,13,1,12,5,4,3,0,2,12,1,11,5
4,1,2,2,21,18,3,1,1,2,4,2,3,2,1,0,1,2,4,2,1,0,1,0
0,2,2,1,2,0,2,0,2,2,0,1,2,0,2,0,2,2,0,1,2,0,2,0
4,1,4,3,26,23,3,2,1,4,4,3,3,2,1,0,1,4,4,3,1,0,1,0
3,3,4,1,17,11,6,1,3,4,3,1,6,4,2,0,3,4,3,1,2,1,1,0
1,0,3,4,26,7,19,17,0,3,1,4,19,5,14,12,0,3,1,4,14,4,10,8
1,2,1,0,4,1,3,0,2,1,1,0,3,0,3,0,2,1,1,0,3,0,3,0
0,0,2,2,16,1,15,7,0,2,0,2,15,1,14,7,0,2,0,2,14,1,13,6
2,4,2,0,10,5,5,0,4,2,2,0,5,2,3,0,4,2,2,0,3,1,2,0
4,1,2,2,9,8,1,0,1,2,4,2,1,0,1,0,1,2,4,2,1,0,1,0
2,0,0,1,7,3,4,1,0,0,2,1,4,2,2,0,0,0,2,1,2,0,2,0
0,3,4,4,11,1,10,8,3,4,0,4,10,0,10,8,3,4,0,4,10,1,9,8
1,2,2,2,14,4,10,4,2,2,1,2,10,2,8,3,2,2,1,2,8,2,6,3
3,2,0,3,0,0,0,0,2,0,3,3,0,0,0,0,2,0,3,3,0,0,0,0
1,3,0,1,3,0,3,0,3,0,1,1,3,0,3,0,3,0,1,1,3,0,3,0
3,4,4,4,5,3,2,1,4,4,3,4,2,1,1,0,4,4,3,4,1,0,1,0
4,4,3,3,8,7,1,0,4,3,4,3,1,0,1,0,4,3,4,3,1,0,1,0
4,4,3,0,8,7,1,0,4,3,4,0,1,0,1,0,4,3,4,0,1,0,1,0
4,0,4,2,28,25,3,1,0,4,4,2,3,2,1,0,0,4,4,2,1,0,1,0
2,1,1,0,14,7,7,0,1,1,2,0,7,3,4,0,1,1,2,0,4,1,3,0
3,3,3,0,16,11,5,0,3,3,3,0,5,3,2,0,3,3,3,0,2,1,1,0
4,4,4,4,23,20,3,2,4,4,4,4,3,2,1,0,4,4,4,4,1,0,1,0
3,4,0,3,1,0,1,0,4,0,3,3,1,0,1,0,4,0,3,3,1,0,1,0
1,4,1,4,6,1,5,4,4,1,1,4,5,1,4,3,4,1,1,4,4,1,3,2
2,4,3,4,14,6,8,7,4,3,2,4,8,3,5,4,4,3,2,4,5,2,3,2
0,0,3,3,20,1,19,13,0,3,0,3,19,1,18,12,0,3,0,3,18,1,17,11
3,4,1,3,3,2,1,0,4,1,3,3,1,0,1,0,4,1,3,3,1,0,1,0
4,1,0,0,6,5,1,0,1,0,4,0,1,0,1,0,1,0,4,0,1,0,1,0
0,3,2,1,2,0,2,0,3,2,0,1,2,0,2,0,3,2,0,1,2,0,2,0
3,1,4,2,22,15,7,3,1,4,3,2,7,4,3,1,1,4,3,2,3,2,1,0
1,4,3,4,7,2,5,4,4,3,1,4,5,1,4,3,4,3,1,4,4,1,3,2
4,2,2,3,13,11,2,1,2,2,4,3,2,1,1,0,2,2,4,3,1,0,1,0
1,1,1,4,18,5,13,11,1,1,1,4,13,3,10,9,1,1,1,4,10,3,7,6
1,4,4,2,5,1,4,1,4,4,1,2,4,1,3,1,4,4,1,2,3,0,3,1
3,2,2,1,12,8,4,1,2,2,3,1,4,2,2,0,2,2,3,1,2,1,1,0
4,0,4,4,25,22,3,2,0,4,4,4,3,2,1,0,0,4,4,4,1,0,1,0
2,3,4,3,19,9,10,6,3,4,2,3,10,4,6,4,3,4,2,3,6,3,3,2
1,3,1,2,7,2,5,2,3,1,1,2,5,1,4,1,3,1,1,2,4,1,3,1
0,1,3,1,22,2,20,5,1,3,0,1,20,2,18,5,1,3,0,1,18,1,17,5
2,1,2,0,23,11,12,1,1,2,2,0,12,5,7,0,1,2,2,0,7,3,4,0
1,0,1,3,14,4,10,7,0,1,1,3,10,3,7,4,0,1,1,3,7,2,5,3
0,2,0,2,13,1,12,5,2,0,0,2,12,1,11,5,2,0,0,2,11,1,10,4
0,1,3,1,25,2,23,6,1,3,0,1,23,2,21,6,1,3,0,1,21,2,19,5
3,0,1,0,17,11,6,0,0,1,3,0,6,4,2,0,0,1,3,0,2,1,1,0
0,4,4,4,14,1,13,11,4,4,0,4,13,1,12,10,4,4,0,4,12,1,11,9
3,2,1,0,3,2,1,0,2,1,3,0,1,0,1,0,2,1,3,0,1,0,1,0
3,2,2,3,18,12,6,4,2,2,3,3,6,4,2,1,2,2,3,3,2,1,1,0
4,3,2,1,5,4,1,0,3,2,4,1,1,0,1,0,3,2,4,1,1,0,1,0
3,2,3,0,18,12,6,0,2,3,3,0,6,4,2,0,2,3,3,0,2,1,1,0
4,1,4,1,29,26,3,0,1,4,4,1,3,2,1,0,1,4,4,1,1,0,1,0
2,2,4,0,22,10,12,1,2,4,2,0,12,6,6,0,2,4,2,0,6,3,3,0
4,2,0,4,8,7,1,0,2,0,4,4,1,0,1,0,2,0,4,4,1,0,1,0
2,4,0,2,2,1,1,0,4,0,2,2,1,0,1,0,4,0,2,2,1,0,1,0
1,0,0,0,3,0,3,0,0,0,1,0,3,0,3,0,0,0,1,0,3,0,3,0
1,0,4,4,28,8,20,18,0,4,1,4,20,5,15,13,0,4,1,4,15,4,11,9
3,1,1,0,15,10,5,0,1,1,3,0,5,3,2,0,1,1,3,0,2,1,1,0
2,0,1,0,13,6,7,0,0,1,2,0,7,3,4,0,0,1,2,0,4,1,3,0
2,1,2,4,16,8,8,7,1,2,2,4,8,3,5,4,1,2,2,4,5,2,3,2
3,3,4,0,21,14,7,0,3,4,3,0,7,4,3,0,3,4,3,0,3,2,1,0
0,0,2,3,17,1,16,11,0,2,0,3,16,1,15,10,0,2,0,3,15,1,14,9
1,2,3,0,18,5,13,1,2,3,1,0,13,3,10,1,2,3,1,0,10,2,8,0
4,0,3,1,29,26,3,0,0,3,4,1,3,2,1,0,0,3,4,1,1,0,1,0
3,1,0,1,2,1,1,0,1,0,3,1,1,0,1,0,1,0,3,1,1,0,1,0
4,0,1,0,12,10,2,0,0,1,4,0,2,1,1,0,0,1,4,0,1,0,1,0
0,4,3,0,10,1,9,0,4,3,0,0,9,0,9,0,4,3,0,0,9,0,9,0
0,3,2,4,1,0,1,0,3,2,0,4,1,0,1,0,3,2,0,4,1,0,1,0
0,1,1,0,14,1,13,1,1,1,0,0,13,1,12,1,1,1,0,0,12,1,11,1
2,4,3,2,6,2,4,2,4,3,2,2,4,2,2,1,4,3,2,2,2,0,2,0
3,0,1,1,13,9,4,1,0,1,3,1,4,2,2,0,0,1,3,1,2,1,1,0
3,1,1,0,18,12,6,0,1,1,3,0,6,4,2,0,1,1,3,0,2,1,1,0
4,4,2,1,4,3,1,0,4,2,4,1,1,0,1,0,4,2,4,1,1,0,1,0
2,1,2,2,25,12,13,6,1,2,2,2,13,6,7,3,1,2,2,2,7,3,4,2
0,0,3,4,29,2,27,24,0,3,0,4,27,2,25,22,0,3,0,4,25,2,23,20
3,1,4,2,15,10,5,2,1,4,3,2,5,3,2,0,1,4,3,2,2,1,1,0
0,2,3,0,16,1,15,1,2,3,0,0,15,1,14,1,2,3,0,0,14,1,13,1
1,1,2,1,25,7,18,5,1,2,1,1,18,5,13,3,1,2,1,1,13,3,10,3
0,2,2,2,16,1,15,7,2,2,0,2,15,1,14,6,2,2,0,2,14,1,13,6
2,1,3,4,26,12,14,12,1,3,2,4,14,6,8,7,1,3,2,4,8,4,4,3
0,0,2,4,24,2,22,19,0,2,0,4,22,2,20,17,0,2,0,4,20,1,19,17
0,0,1,4,19,1,18,16,0,1,0,4,18,1,17,15,0,1,0,4,17,1,16,14
2,1,1,3,10,4,6,4,1,1,2,3,6,3,3,2,1,1,2,3,3,1,2,1
1,0,3,4,28,8,20,18,0,3,1,4,20,5,15,13,0,3,1,4,15,4,11,9
2,4,3,3,7,3,4,2,4,3,2,3,4,2,2,1,4,3,2,3,2,0,2,1
3,4,0,1,2,1,1,0,4,0,3,1,1,0,1,0,4,0,3,1,1,0,1,0
2,3,0,2,2,0,2,1,3,0,2,2,2,1,1,0,3,0,2,2,1,0,1,0
3,1,4,1,22,15,7,2,1,4,3,1,7,4,3,0,1,4,3,1,3,2,1,0
3,3,4,3,19,13,6,4,3,4,3,3,6,4,2,1,3,4,3,3,2,1,1,0
0,2,3,4,14,1,13,11,2,3,0,4,13,1,12,10,2,3,0,4,12,1,11,9
3,0,4,2,26,18,8,3,0,4,3,2,8,5,3,1,0,4,3,2,3,2,1,0
1,4,2,3,1,0,1,0,4,2,1,3,1,0,1,0,4,2,1,3,1,0,1,0
2,4,3,4,0,0,0,0,4,3,2,4,0,0,0,0,4,3,2,4,0,0,0,0
0,0,3,4,28,2,26,23,0,3,0,4,26,2,24,21,0,3,0,4,24,2,22,19
4,0,0,1,11,9,2,0,0,0,4,1,2,1,1,0,0,0,4,1,1,0,1,0
0,1,2,4,7,0,7,6,1,2,0,4,7,0,7,6,1,2,0,4,7,0,7,6
1,1,0,3,2,0,2,1,1,0,1,3,2,0,2,1,1,0,1,3,2,0,2,1
2,3,1,4,8,4,4,3,3,1,2,4,4,2,2,1,3,1,2,4,2,1,1,0
2,1,0,4,14,6,8,7,1,0,2,4,8,4,4,3,1,0,2,4,4,1,3,2
4,1,0,3,14,12,2,1,1,0,4,3,2,1,1,0,1,0,4,3,1,0,1,0
0,4,0,4,3,0,3,2,4,0,0,4,3,0,3,2,4,0,0,4,3,0,3,2
3,4,2,0,1,0,1,0,4,2,3,0,1,0,1,0,4,2,3,0,1,0,1,0
3,4,3,4,3,2,1,0,4,3,3,4,1,0,1,0,4,3,3,4,1,0,1,0
3,1,2,3,3,2,1,0,1,2,3,3,1,0,1,0,1,2,3,3,1,0,1,0
1,4,0,3,4,1,3,2,4,0,1,3,3,0,3,2,4,0,1,3,3,0,3,2
4,2,3,3,10,8,2,1,2,3,4,3,2,1,1,0,2,3,4,3,1,0,1,0
1,2,4,2,18,5,13,6,2,4,1,2,13,3,10,4,2,4,1,2,10,2,8,3
2,4,4,3,8,3,5,3,4,4,2,3,5,2,3,2,4,4,2,3,3,1,2,1
4,2,0,1,6,5,1,0,2,0,4,1,1,0,1,0,2,0,4,1,1,0,1,0
1,4,4,4,3,0,3,2,4,4,1,4,3,0,3,2,4,4,1,4,3,0,3,2
2,2,1,0,13,6,7,0,2,1,2,0,7,3,4,0,2,1,2,0,4,2,2,0
3,2,4,3,10,6,4,2,2,4,3,3,4,2,2,1,2,4,3,3,2,1,1,0
2,4,3,4,6,2,4,3,4,3,2,4,4,1,3,2,4,3,2,4,3,1,2,1
4,2,2,3,21,18,3,2,2,2,4,3,3,2,1,0,2,2,4,3,1,0,1,0
0,4,2,0,4,0,4,0,4,2,0,0,4,0,4,0,4,2,0,0,4,0,4,0
0,2,3,1,13,1,12,3,2,3,0,1,12,1,11,3,2,3,0,1,11,1,10,2
3,0,3,1,27,18,9,2,0,3,3,1,9,6,3,0,0,3,3,1,3,2,1,0
2,1,2,3,17,8,9,6,1,2,2,3,9,4,5,3,1,2,2,3,5,2,3,2
0,2,0,3,1,0,1,0,2,0,0,3,1,0,1,0,2,0,0,3,1,0,1,0
3,1,1,0,14,9,5,0,1,1,3,0,5,3,2,0,1,1,3,0,2,1,1,0
4,4,3,3,3,2,1,0,4,3,4,3,1,0,1,0,4,3,4,3,1,0,1,0
1,4,2,0,2,0,2,0,4,2,1,0,2,0,2,0,4,2,1,0,2,0,2,0
4,4,1,2,1,0,1,0,4,1,4,2,1,0,1,0,4,1,4,2,1,0,1,0
0,0,4,2,28,2,26,13,0,4,0,2,26,2,24,11,0,4,0,2,24,2,22,11
1,3,4,4,2,0,2,1,3,4,1,4,2,0,2,1,3,4,1,4,2,0,2,1
3,4,1,4,13,9,4,3,4,1,3,4,4,2,2,1,4,1,3,4,2,1,1,0
1,2,3,2,24,7,17,8,2,3,1,2,17,5,12,5,2,3,1,2,12,3,9,4
0,4,1,4,12,1,11,9,4,1,0,4,11,1,10,9,4,1,0,4,10,1,9,8
2,2,4,1,21,10,11,3,2,4,2,1,11,5,6,1,2,4,2,1,6,3,3,0
3,0,4,2,26,18,8,3,0,4,3,2,8,5,3,1,0,4,3,2,3,2,1,0
2,1,4,0,29,14,15,1,1,4,2,0,15,7,8,0,1,4,2,0,8,4,4,0
0,2,0,4,3,0,3,2,2,0,0,4,3,0,3,2,2,0,0,4,3,0,3,2
1,1,2,3,17,5,12,8,1,2,1,3,12,3,9,6,1,2,1,3,9,2,7,4
0,1,4,1,28,2,26,7,1,4,0,1,26,2,24,7,1,4,0,1,24,2,22,6
2,3,0,0,2,1,1,0,3,0,2,0,1,0,1,0,3,0,2,0,1,0,1,0
1,4,2,4,1,0,1,0,4,2,1,4,1,0,1,0,4,2,1,4,1,0,1,0
0,0,2,4,22,2,20,17,0,2,0,4,20,2,18,16,0,2,0,4,18,1,17,15
2,4,4,1,3,1,2,0,4,4,2,1,2,0,2,0,4,4,2,1,2,0,2,0
1,2,3,4,12,3,9,8,2,3,1,4,9,2,7,6,2,3,1,4,7,2,5,4
4,0,3,0,22,19,3,0,0,3,4,0,3,2,1,0,0,3,4,0,1,0,1,0
4,3,4,3,29,26,3,2,3,4,4,3,3,2,1,0,3,4,4,3,1,0,1,0
0,2,2,2,16,1,15,7,2,2,0,2,15,1,14,6,2,2,0,2,14,1,13,6
3,0,1,4,17,11,6,5,0,1,3,4,6,4,2,1,0,1,3,4,2,1,1,0
3,3,3,2,17,11,6,3,3,3,3,2,6,4,2,1,3,3,3,2,2,1,1,0
4,0,0,4,8,7,1,0,0,0,4,4,1,0,1,0,0,0,4,4,1,0,1,0
2,0,2,1,20,9,11,3,0,2,2,1,11,5,6,1,0,2,2,1,6,3,3,0
3,0,4,3,28,19,9,6,0,4,3,3,9,6,3,2,0,4,3,3,3,2,1,0
3,2,4,1,26,18,8,2,2,4,3,1,8,5,3,0,2,4,3,1,3,2,1,0
4,0,1,0,15,13,2,0,0,1,4,0,2,1,1,0,0,1,4,0,1,0,1,0
0,3,0,1,12,1,11,3,3,0,0,1,11,1,10,3,3,0,0,1,10,1,9,2
2,2,0,4,1,0,1,0,2,0,2,4,1,0,1,0,2,0,2,4,1,0,1,0
2,2,1,4,0,0,0,0,2,1,2,4,0,0,0,0,2,1,2,4,0,0,0,0
0,3,1,1,5,0,5,1,3,1,0,1,5,0,5,1,3,1,0,1,5,0,5,1
1,0,1,1,19,5,14,4,0,1,1,1,14,4,10,3,0,1,1,1,10,2,8,2
4,4,1,3,9,8,1,0,4,1,4,3,1,0,1,0,4,1,4,3,1,0,1,0
3,3,3,4,12,8,4,3,3,3,3,4,4,2,2,1,3,3,3,4,2,1,1,0
3,3,0,2,1,0,1,0,3,0,3,2,1,0,1,0,3,0,3,2,1,0,1,0
2,1,0,1,7,3,4,1,1,0,2,1,4,1,3,0,1,0,2,1,3,1,2,0
1,0,0,3,5,1,4,2,0,0,1,3,4,1,3,2,0,0,1,3,3,0,3,2
4,4,2,0,4,3,1,0,4,2,4,0,1,0,1,0,4,2,4,0,1,0,1,0
1,1,0,1,4,1,3,0,1,0,1,1,3,0,3,0,1,0,1,1,3,0,3,0
4,4,0,2,11,9,2,1,4,0,4,2,2,1,1,0,4,0,4,2,1,0,1,0
2,4,4,4,2,1,1,0,4,4,2,4,1,0,1,0,4,4,2,4,1,0,1,0
3,2,1,1,8,5,3,0,2,1,3,1,3,2,1,0,2,1,3,1,1,0,1,0
0,3,2,2,11,1,10,4,3,2,0,2,10,1,9,4,3,2,0,2,9,0,9,4
0,0,1,0,23,2,21,2,0,1,0,0,21,2,19,1,0,1,0,0,19,1,18,1
3,2,0,0,11,7,4,0,2,0,3,0,4,2,2,0,2,0,3,0,2,1,1,0
2,3,3,4,12,6,6,5,3,3,2,4,6,3,3,2,3,3,2,4,3,1,2,1
1,3,2,3,11,3,8,5,3,2,1,3,8,2,6,4,3,2,1,3,6,1,5,3
0,1,2,2,16,1,15,7,1,2,0,2,15,1,14,6,1,2,0,2,14,1,13,6
3,0,4,4,28,19,9,8,0,4,3,4,9,6,3,2,0,4,3,4,3,2,1,0
2,2,1,1,7,3,4,1,2,1,2,1,4,1,3,0,2,1,2,1,3,1,2,0
1,4,0,4,2,0,2,1,4,0,1,4,2,0,2,1,4,0,1,4,2,0,2,1
2,1,3,0,28,14,14,1,1,3,2,0,14,6,8,0,1,3,2,0,8,4,4,0
4,2,4,4,21,18,3,2,2,4,4,4,3,2,1,0,2,4,4,4,1,0,1,0
2,2,4,0,20,9,11,1,2,4,2,0,11,5,6,0,2,4,2,0,6,3,3,0
0,0,2,4,16,1,15,13,0,2,0,4,15,1,14,12,0,2,0,4,14,1,13,11
0,4,1,3,4,0,4,2,4,1,0,3,4,0,4,2,4,1,0,3,4,0,4,2
3,1,2,2,25,17,8,4,1,2,3,2,8,5,3,1,1,2,3,2,3,2,1,0
0,2,2,3,9,0,9,6,2,2,0,3,9,0,9,6,2,2,0,3,9,0,9,6
1,1,0,0,7,2,5,0,1,0,1,0,5,1,4,0,1,0,1,0,4,1,3,0
0,0,3,4,27,2,25,22,0,3,0,4,25,2,23,20,0,3,0,4,23,2,21,18
0,1,3,0,19,1,18,1,1,3,0,0,18,1,17,1,1,3,0,0,17,1,16,1
1,0,2,1,17,5,12,3,0,2,1,1,12,3,9,2,0,2,1,1,9,2,7,2
1,1,4,2,26,7,19,9,1,4,1,2,19,5,14,6,1,4,1,2,14,4,10,4
2,2,0,1,4,1,3,0,2,0,2,1,3,1,2,0,2,0,2,1,2,0,2,0
0,1,2,2,22,2,20,9,1,2,0,2,20,1,19,9,1,2,0,2,19,1,18,8
3,4,0,0,1,0,1,0,4,0,3,0,1,0,1,0,4,0,3,0,1,0,1,0
1,4,2,3,13,3,10,6,4,2,1,3,10,3,7,4,4,2,1,3,7,2,5,3
2,4,1,2,5,2,3,1,4,1,2,2,3,1,2,1,4,1,2,2,2,0,2,0
0,3,0,3,0,0,0,0,3,0,0,3,0,0,0,0,3,0,0,3,0,0,0,0
3,2,0,2,9,6,3,1,2,0,3,2,3,2,1,0,2,0,3,2,1,0,1,0
0,1,1,3,13,1,12,8,1,1,0,3,12,1,11,7,1,1,0,3,11,1,10,6
1,2,0,2,2,0,2,1,2,0,1,2,2,0,2,0,2,0,1,2,2,0,2,0
3,2,3,3,17,11,6,4,2,3,3,3,6,4,2,1,2,3,3,3,2,1,1,0
2,1,0,3,9,4,5,3,1,0,2,3,5,2,3,2,1,0,2,3,3,1,2,1
4,0,4,3,29,26,3,2,0,4,4,3,3,2,1,0,0,4,4,3,1,0,1,0
3,0,3,4,25,17,8,7,0,3,3,4,8,5,3,2,0,3,3,4,3,2,1,0
0,4,0,3,3,0,3,2,4,0,0,3,3,0,3,2,4,0,0,3,3,0,3,2
3,1,1,3,9,6,3,2,1,1,3,3,3,2,1,0,1,1,3,3,1,0,1,0
3,2,3,2,10,7,3,1,2,3,3,2,3,2,1,0,2,3,3,2,1,0,1,0
2,2,4,3,25,12,13,9,2,4,2,3,13,6,7,4,2,4,2,3,7,3,4,2
3,3,1,2,3,2,1,0,3,1,3,2,1,0,1,0,3,1,3,2,1,0,1,0
3,2,0,4,7,4,3,2,2,0,3,4,3,2,1,0,2,0,3,4,1,0,1,0
2,3,1,1,8,3,5,1,3,1,2,1,5,2,3,0,3,1,2,1,3,1,2,0
4,3,1,3,16,14,2,1,3,1,4,3,2,1,1,0,3,1,4,3,1,0,1,0
0,0,0,1,1,0,1,0,0,0,0,1,1,0,1,0,0,0,0,1,1,0,1,0
0,0,2,4,27,2,25,22,0,2,0,4,25,2,23,20,0,2,0,4,23,2,21,18
0,2,1,3,8,0,8,5,2,1,0,3,8,0,8,5,2,1,0,3,8,0,8,5
2,1,4,2,22,11,11,5,1,4,2,2,11,5,6,3,1,4,2,2,6,3,3,1
0,4,2,4,13,1,12,10,4,2,0,4,12,1,11,9,4,2,0,4,11,1,10,8
1,1,0,4,10,2,8,7,1,0,1,4,8,2,6,5,1,0,1,4,6,1,5,4
2,1,2,1,12,5,7,2,1,2,2,1,7,3,4,1,1,2,2,1,4,2,2,0
0,3,0,3,0,0,0,0,3,0,0,3,0,0,0,0,3,0,0,3,0,0,0,0
2,0,1,4,8,4,4,3,0,1,2,4,4,2,2,1,0,1,2,4,2,1,1,0
3,2,3,4,21,14,7,6,2,3,3,4,7,4,3,2,2,3,3,4,3,2,1,0
4,4,3,2,5,4,1,0,4,3,4,2,1,0,1,0,4,3,4,2,1,0,1,0
2,0,4,4,26,12,14,12,0,4,2,4,14,7,7,6,0,4,2,4,7,3,4,3
4,1,1,1,6,5,1,0,1,1,4,1,1,0,1,0,1,1,4,1,1,0,1,0
3,0,3,0,24,16,8,0,0,3,3,0,8,5,3,0,0,3,3,0,3,2,1,0
2,3,0,2,3,1,2,1,3,0,2,2,2,0,2,0,3,0,2,2,2,0,2,0
0,2,2,1,15,1,14,4,2,2,0,1,14,1,13,3,2,2,0,1,13,1,12,3
3,2,0,4,1,0,1,0,2,0,3,4,1,0,1,0,2,0,3,4,1,0,1,0
0,3,0,2,7,0,7,3,3,0,0,2,7,0,7,3,3,0,0,2,7,0,7,3
3,4,2,3,8,5,3,2,4,2,3,3,3,2,1,0,4,2,3,3,1,0,1,0
2,3,1,2,10,4,6,2,3,1,2,2,6,2,4,2,3,1,2,2,4,1,3,1
4,3,2,3,10,8,2,1,3,2,4,3,2,1,1,0,3,2,4,3,1,0,1,0
2,1,3,4,18,8,10,8,1,3,2,4,10,4,6,5,1,3,2,4,6,2,4,3
0,3,2,1,1,0,1,0,3,2,0,1,1,0,1,0,3,2,0,1,1,0,1,0
3,1,0,2,7,4,3,1,1,0,3,2,3,2,1,0,1,0,3,2,1,0,1,0
3,1,2,2,23,16,7,3,1,2,3,2,7,4,3,1,1,2,3,2,3,2,1,0
2,0,1,4,8,4,4,3,0,1,2,4,4,2,2,1,0,1,2,4,2,1,1,0
0,2,3,1,10,0,10,3,2,3,0,1,10,0,10,2,2,3,0,1,10,1,9,2
0,3,4,3,22,2,20,13,3,4,0,3,20,1,19,13,3,4,0,3,19,1,18,12
1,2,4,3,19,5,14,9,2,4,1,3,14,4,10,6,2,4,1,3,10,2,8,5
4,2,4,4,24,21,3,2,2,4,4,4,3,2,1,0,2,4,4,4,1,0,1,0
4,2,4,3,25,22,3,2,2,4,4,3,3,2,1,0,2,4,4,3,1,0,1,0
3,4,3,2,11,7,4,2,4,3,3,2,4,2,2,0,4,3,3,2,2,1,1,0
1,4,1,4,6,1,5,4,4,1,1,4,5,1,4,3,4,1,1,4,4,1,3,2
1,1,2,2,12,3,9,4,1,2,1,2,9,2,7,3,1,2,1,2,7,2,5,2
3,0,2,0,22,15,7,0,0,2,3,0,7,4,3,0,0,2,3,0,3,2,1,0
4,3,3,3,10,9,1,0,3,3,4,3,1,0,1,0,3,3,4,3,1,0,1,0
0,4,3,2,0,0,0,0,4,3,0,2,0,0,0,0,4,3,0,2,0,0,0,0
2,1,1,0,11,5,6,0,1,1,2,0,6,2,4,0,1,1,2,0,4,2,2,0
0,2,3,2,22,2,20,9,2,3,0,2,20,1,19,9,2,3,0,2,19,1,18,8
4,1,0,3,2,1,1,0,1,0,4,3,1,0,1,0,1,0,4,3,1,0,1,0
1,0,4,0,29,8,21,2,0,4,1,0,21,6,15,1,0,4,1,0,15,4,11,1
2,4,4,1,6,3,3,0,4,4,2,1,3,1,2,0,4,4,2,1,2,0,2,0
0,3,1,1,1,0,1,0,3,1,0,1,1,0,1,0,3,1,0,1,1,0,1,0
2,0,3,2,28,13,15,7,0,3,2,2,15,7,8,3,0,3,2,2,8,4,4,2
0,4,1,3,1,0,1,0,4,1,0,3,1,0,1,0,4,1,0,3,1,0,1,0
2,2,4,1,20,10,10,3,2,4,2,1,10,5,5,1,2,4,2,1,5,2,3,0
0,3,4,1,8,0,8,2,3,4,0,1,8,0,8,2,3,4,0,1,8,0,8,2
4,0,4,4,29,26,3,2,0,4,4,4,3,2,1,0,0,4,4,4,1,0,1,0
0,4,3,3,3,0,3,2,4,3,0,3,3,0,3,2,4,3,0,3,3,0,3,2
4,1,1,0,14,12,2,0,1,1,4,0,2,1,1,0,1,1,4,0,1,0,1,0
1,3,3,0,8,2,6,0,3,3,1,0,6,1,5,0,3,3,1,0,5,1,4,0
2,3,0,4,1,0,1,0,3,0,2,4,1,0,1,0,3,0,2,4,1,0,1,0
2,3,0,0,4,1,3,0,3,0,2,0,3,1,2,0,3,0,2,0,2,1,1,0
4,0,0,4,5,4,1,0,0,0,4,4,1,0,1,0,0,0,4,4,1,0,1,0
4,4,0,3,4,3,1,0,4,0,4,3,1,0,1,0,4,0,4,3,1,0,1,0
1,2,4,1,24,7,17,5,2,4,1,1,17,5,12,3,2,4,1,1,12,3,9,2
1,2,0,2,7,2,5,2,2,0,1,2,5,1,4,1,2,0,1,2,4,1,3,1
4,2,0,4,6,5,1,0,2,0,4,4,1,0,1,0,2,0,4,4,1,0,1,0
0,2,4,3,29,2,27,18,2,4,0,3,27,2,25,17,2,4,0,3,25,2,23,16
2,3,4,4,19,9,10,9,3,4,2,4,10,5,5,4,3,4,2,4,5,2,3,2
2,1,0,4,0,0,0,0,1,0,2,4,0,0,0,0,1,0,2,4,0,0,0,0
4,2,1,0,3,2,1,0,2,1,4,0,1,0,1,0,2,1,4,0,1,0,1,0
2,4,4,4,8,4,4,3,4,4,2,4,4,1,3,2,4,4,2,4,3,1,2,1
3,4,0,4,3,2,1,0,4,0,3,4,1,0,1,0,4,0,3,4,1,0,1,0
2,0,4,0,22,11,11,1,0,4,2,0,11,5,6,0,0,4,2,0,6,3,3,0
4,4,2,3,4,3,1,0,4,2,4,3,1,0,1,0,4,2,4,3,1,0,1,0
0,2,2,3,10,1,9,6,2,2,0,3,9,0,9,6,2,2,0,3,9,0,9,6
2,1,4,2,18,9,9,4,1,4,2,2,9,4,5,2,1,4,2,2,5,2,3,1
4,0,0,1,4,3,1,0,0,0,4,1,1,0,1,0,0,0,4,1,1,0,1,0
2,0,1,2,19,9,10,5,0,1,2,2,10,5,5,2,0,1,2,2,5,2,3,1
0,3,1,3,7,0,7,4,3,1,0,3,7,0,7,4,3,1,0,3,7,0,7,4
0,2,2,4,15,1,14,12,2,2,0,4,14,1,13,11,2,2,0,4,13,1,12,10
3,2,4,0,29,20,9,0,2,4,3,0,9,6,3,0,2,4,3,0,3,2,1,0
3,0,0,4,6,4,2,1,0,0,3,4,2,1,1,0,0,0,3,4,1,0,1,0
4,2,4,3,19,17,2,1,2,4,4,3,2,1,1,0,2,4,4,3,1,0,1,0
4,4,4,4,12,10,2,1,4,4,4,4,2,1,1,0,4,4,4,4,1,0,1,0
3,0,1,3,20,14,6,4,0,1,3,3,6,4,2,1,0,1,3,3,2,1,1,0
2,2,4,2,24,12,12,6,2,4,2,2,12,5,7,3,2,4,2,2,7,3,4,1
0,4,4,0,7,0,7,0,4,4,0,0,7,0,7,0,4,4,0,0,7,0,7,0
4,0,2,3,27,24,3,2,0,2,4,3,3,2,1,0,0,2,4,3,1,0,1,0
2,1,1,2,1,0,1,0,1,1,2,2,1,0,1,0,1,1,2,2,1,0,1,0
4,1,3,4,20,17,3,2,1,3,4,4,3,2,1,0,1,3,4,4,1,0,1,0
0,0,3,2,25,2,23,11,0,3,0,2,23,2,21,10,0,3,0,2,21,2,19,9
4,2,4,4,28,25,3,2,2,4,4,4,3,2,1,0,2,4,4,4,1,0,1,0
2,0,3,1,24,11,13,3,0,3,2,1,13,6,7,2,0,3,2,1,7,3,4,1
0,3,2,2,7,0,7,3,3,2,0,2,7,0,7,3,3,2,0,2,7,0,7,3
3,3,3,1,16,11,5,1,3,3,3,1,5,3,2,0,3,3,3,1,2,1,1,0
1,2,4,1,25,7,18,5,2,4,1,1,18,5,13,3,2,4,1,1,13,3,10,3
4,2,2,4,21,18,3,2,2,2,4,4,3,2,1,0,2,2,4,4,1,0,1,0
4,1,0,3,4,3,1,0,1,0,4,3,1,0,1,0,1,0,4,3,1,0,1,0
0,3,1,2,8,0,8,3,3,1,0,2,8,0,8,3,3,1,0,2,8,0,8,3
4,4,3,0,1,0,1,0,4,3,4,0,1,0,1,0,4,3,4,0,1,0,1,0
4,0,2,2,23,20,3,1,0,2,4,2,3,2,1,0,0,2,4,2,1,0,1,0
3,3,4,4,18,12,6,5,3,4,3,4,6,4,2,1,3,4,3,4,2,1,1,0
1,4,3,3,11,3,8,5,4,3,1,3,8,2,6,4,4,3,1,3,6,1,5,3
0,2,0,4,0,0,0,0,2,0,0,4,0,0,0,0,2,0,0,4,0,0,0,0
2,4,3,1,10,5,5,1,4,3,2,1,5,2,3,0,4,3,2,1,3,1,2,0
2,1,4,4,18,9,9,8,1,4,2,4,9,4,5,4,1,4,2,4,5,2,3,2
3,0,0,2,9,6,3,1,0,0,3,2,3,2,1,0,0,0,3,2,1,0,1,0
1,3,2,4,6,1,5,4,3,2,1,4,5,1,4,3,3,2,1,4,4,1,3,2
2,0,0,3,8,4,4,2,0,0,2,3,4,1,3,2,0,0,2,3,3,1,2,1
1,4,2,2,4,1,3,1,4,2,1,2,3,0,3,1,4,2,1,2,3,0,3,1
2,1,2,2,12,6,6,3,1,2,2,2,6,3,3,1,1,2,2,2,3,1,2,1
1,1,0,1,9,2,7,2,1,0,1,1,7,2,5,1,1,0,1,1,5,1,4,1
1,0,3,4,22,6,16,14,0,3,1,4,16,4,12,10,0,3,1,4,12,3,9,8
1,3,3,3,0,0,0,0,3,3,1,3,0,0,0,0,3,3,1,3,0,0,0,0
1,1,0,1,7,2,5,1,1,0,1,1,5,1,4,1,1,0,1,1,4,1,3,0
3,2,0,0,9,6,3,0,2,0,3,0,3,2,1,0,2,0,3,0,1,0,1,0
3,2,4,1,26,18,8,2,2,4,3,1,8,5,3,0,2,4,3,1,3,2,1,0
0,3,4,4,4,0,4,3,3,4,0,4,4,0,4,3,3,4,0,4,4,0,4,3
1,3,3,4,6,1,5,4,3,3,1,4,5,1,4,3,3,3,1,4,4,1,3,2
4,0,3,4,20,18,2,1,0,3,4,4,2,1,1,0,0,3,4,4,1,0,1,0
4,4,3,4,4,3,1,0,4,3,4,4,1,0,1,0,4,3,4,4,1,0,1,0
2,3,3,0,12,5,7,0,3,3,2,0,7,3,4,0,3,3,2,0,4,2,2,0
1,3,4,3,20,5,15,10,3,4,1,3,15,4,11,7,3,4,1,3,11,3,8,5
4,0,0,0,8,7,1,0,0,0,4,0,1,0,1,0,0,0,4,0,1,0,1,0
0,2,2,2,17,1,16,8,2,2,0,2,16,1,15,7,2,2,0,2,15,1,14,7
4,4,1,0,2,1,1,0,4,1,4,0,1,0,1,0,4,1,4,0,1,0,1,0
0,4,1,3,1,0,1,0,4,1,0,3,1,0,1,0,4,1,0,3,1,0,1,0
2,0,4,4,25,12,13,11,0,4,2,4,13,6,7,6,0,4,2,4,7,3,4,3
3,4,4,1,16,11,5,1,4,4,3,1,5,3,2,0,4,4,3,1,2,1,1,0
4,2,2,1,19,17,2,0,2,2,4,1,2,1,1,0,2,2,4,1,1,0,1,0
0,3,4,1,6,0,6,1,3,4,0,1,6,0,6,1,3,4,0,1,6,0,6,1
1,2,1,1,8,2,6,1,2,1,1,1,6,1,5,1,2,1,1,1,5,1,4,1
3,1,2,3,13,9,4,2,1,2,3,3,4,2,2,1,1,2,3,3,2,1,1,0
4,0,3,4,23,20,3,2,0,3,4,4,3,2,1,0,0,3,4,4,1,0,1,0
2,2,2,1,16,7,9,2,2,2,2,1,9,4,5,1,2,2,2,1,5,2,3,0
1,4,4,0,7,2,5,0,4,4,1,0,5,1,4,0,4,4,1,0,4,1,3,0
1,2,1,4,6,1,5,4,2,1,1,4,5,1,4,3,2,1,1,4,4,1,3,2
4,3,0,4,7,6,1,0,3,0,4,4,1,0,1,0,3,0,4,4,1,0,1,0
3,0,4,4,28,19,9,8,0,4,3,4,9,6,3,2,0,4,3,4,3,2,1,0
4,2,2,1,12,10,2,0,2,2,4,1,2,1,1,0,2,2,4,1,1,0,1,0
1,3,4,3,20,5,15,10,3,4,1,3,15,4,11,7,3,4,1,3,11,3,8,5
3,1,2,0,17,11,6,0,1,2,3,0,6,4,2,0,1,2,3,0,2,1,1,0
2,4,0,2,6,3,3,1,4,0,2,2,3,1,2,0,4,0,2,2,2,0,2,0
2,2,2,0,7,3,4,0,2,2,2,0,4,1,3,0,2,2,2,0,3,1,2,0
4,3,1,4,3,2,1,0,3,1,4,4,1,0,1,0,3,1,4,4,1,0,1,0
3,1,3,4,20,14,6,5,1,3,3,4,6,4,2,1,1,3,3,4,2,1,1,0
3,4,1,0,6,4,2,0,4,1,3,0,2,1,1,0,4,1,3,0,1,0,1,0
1,2,1,3,8,2,6,4,2,1,1,3,6,1,5,3,2,1,1,3,5,1,4,2
1,4,4,4,2,0,2,1,4,4,1,4,2,0,2,1,4,4,1,4,2,0,2,1
0,1,2,3,15,1,14,9,1,2,0,3,14,1,13,9,1,2,0,3,13,1,12,8
2,4,2,0,6,2,4,0,4,2,2,0,4,2,2,0,4,2,2,0,2,1,1,0
2,0,4,0,28,14,14,1,0,4,2,0,14,6,8,0,0,4,2,0,8,4,4,0
4,2,4,4,16,14,2,1,2,4,4,4,2,1,1,0,2,4,4,4,1,0,1,0
3,1,3,3,25,17,8,5,1,3,3,3,8,5,3,2,1,3,3,3,3,2,1,0
0,2,2,4,14,1,13,11,2,2,0,4,13,1,12,10,2,2,0,4,12,1,11,9
3,2,4,3,11,7,4,2,2,4,3,3,4,2,2,1,2,4,3,3,2,1,1,0
4,2,1,2,8,7,1,0,2,1,4,2,1,0,1,0,2,1,4,2,1,0,1,0
1,3,3,2,20,6,14,7,3,3,1,2,14,4,10,5,3,3,1,2,10,2,8,3
4,4,4,3,11,9,2,1,4,4,4,3,2,1,1,0,4,4,4,3,1,0,1,0
1,4,3,4,3,0,3,2,4,3,1,4,3,0,3,2,4,3,1,4,3,0,3,2
1,0,3,3,22,6,16,11,0,3,1,3,16,4,12,8,0,3,1,3,12,3,9,6
1,0,2,3,21,6,15,10,0,2,1,3,15,4,11,7,0,2,1,3,11,3,8,5
4,4,4,2,13,11,2,0,4,4,4,2,2,1,1,0,4,4,4,2,1,0,1,0
4,0,2,0,23,20,3,0,0,2,4,0,3,2,1,0,0,2,4,0,1,0,1,0
4,2,0,2,4,3,1,0,2,0,4,2,1,0,1,0,2,0,4,2,1,0,1,0
4,0,2,0,21,18,3,0,0,2,4,0,3,2,1,0,0,2,4,0,1,0,1,0
4,4,1,4,10,9,1,0,4,1,4,4,1,0,1,0,4,1,4,4,1,0,1,0
2,2,4,4,28,13,15,13,2,4,2,4,15,7,8,7,2,4,2,4,8,4,4,3
0,1,1,0,15,1,14,1,1,1,0,0,14,1,13,1,1,1,0,0,13,1,12,1
3,4,3,2,10,6,4,2,4,3,3,2,4,2,2,0,4,3,3,2,2,1,1,0
2,4,1,2,2,1,1,0,4,1,2,2,1,0,1,0,4,1,2,2,1,0,1,0
3,1,1,1,2,1,1,0,1,1,3,1,1,0,1,0,1,1,3,1,1,0,1,0
0,4,0,4,3,0,3,2,4,0,0,4,3,0,3,2,4,0,0,4,3,0,3,2
3,3,4,4,9,6,3,2,3,4,3,4,3,2,1,0,3,4,3,4,1,0,1,0
3,2,0,3,13,9,4,2,2,0,3,3,4,2,2,1,2,0,3,3,2,1,1,0
2,1,4,0,26,12,14,1,1,4,2,0,14,6,8,0,1,4,2,0,8,3,5,0
2,0,2,2,14,7,7,3,0,2,2,2,7,3,4,1,0,2,2,2,4,2,2,0
3,3,2,2,12,8,4,2,3,2,3,2,4,2,2,0,3,2,3,2,2,1,1,0
1,4,4,2,1,0,1,0,4,4,1,2,1,0,1,0,4,4,1,2,1,0,1,0
0,4,1,4,5,0,5,4,4,1,0,4,5,0,5,4,4,1,0,4,5,0,5,4
2,2,3,1,7,3,4,1,2,3,2,1,4,2,2,0,2,3,2,1,2,1,1,0
0,2,4,0,23,2,21,2,2,4,0,0,21,2,19,1,2,4,0,0,19,1,18,1
0,2,2,0,16,1,15,1,2,2,0,0,15,1,14,1,2,2,0,0,14,1,13,1
2,3,1,2,16,8,8,4,3,1,2,2,8,4,4,1,3,1,2,2,4,1,3,1
3,4,1,2,5,3,2,0,4,1,3,2,2,1,1,0,4,1,3,2,1,0,1,0
1,4,1,1,6,1,5,1,4,1,1,1,5,1,4,1,4,1,1,1,4,1,3,0
4,0,2,1,22,19,3,0,0,2,4,1,3,2,1,0,0,2,4,1,1,0,1,0
0,0,2,0,16,1,15,1,0,2,0,0,15,1,14,1,0,2,0,0,14,1,13,1
3,4,4,1,9,6,3,0,4,4,3,1,3,2,1,0,4,4,3,1,1,0,1,0
2,0,3,2,21,10,11,5,0,3,2,2,11,5,6,3,0,3,2,2,6,2,4,1
1,0,0,0,12,3,9,0,0,0,1,0,9,2,7,0,0,0,1,0,7,2,5,0
1,2,4,0,25,7,18,1,2,4,1,0,18,5,13,1,2,4,1,0,13,3,10,0
4,1,4,0,29,26,3,0,1,4,4,0,3,2,1,0,1,4,4,0,1,0,1,0
3,1,3,2,28,19,9,4,1,3,3,2,9,6,3,1,1,3,3,2,3,2,1,0
2,2,1,1,13,6,7,2,2,1,2,1,7,3,4,1,2,1,2,1,4,2,2,0
1,1,1,2,17,5,12,6,1,1,1,2,12,3,9,4,1,1,1,2,9,2,7,3
4,0,1,1,10,9,1,0,0,1,4,1,1,0,1,0,0,1,4,1,1,0,1,0
2,2,0,4,7,3,4,3,2,0,2,4,4,1,3,2,2,0,2,4,3,1,2,1
3,4,1,1,5,3,2,0,4,1,3,1,2,1,1,0,4,1,3,1,1,0,1,0
2,3,1,1,1,0,1,0,3,1,2,1,1,0,1,0,3,1,2,1,1,0,1,0
3,2,3,1,21,14,7,2,2,3,3,1,7,4,3,0,2,3,3,1,3,2,1,0
3,0,1,1,11,7,4,1,0,1,3,1,4,2,2,0,0,1,3,1,2,1,1,0
0,2,3,3,11,1,10,6,2,3,0,3,10,1,9,6,2,3,0,3,9,0,9,6
4,0,2,2,10,8,2,1,0,2,4,2,2,1,1,0,0,2,4,2,1,0,1,0
1,3,3,4,10,3,7,6,3,3,1,4,7,2,5,4,3,3,1,4,5,1,4,3
4,4,0,1,4,3,1,0,4,0,4,1,1,0,1,0,4,0,4,1,1,0,1,0
4,0,2,0,28,25,3,0,0,2,4,0,3,2,1,0,0,2,4,0,1,0,1,0
2,3,2,1,7,3,4,1,3,2,2,1,4,1,3,0,3,2,2,1,3,1,2,0
0,2,0,2,0,0,0,0,2,0,0,2,0,0,0,0,2,0,0,2,0,0,0,0
1,0,3,3,28,8,20,13,0,3,1,3,20,5,15,10,0,3,1,3,15,4,11,7
0,4,3,3,0,0,0,0,4,3,0,3,0,0,0,0,4,3,0,3,0,0,0,0
0,4,1,0,0,0,0,0,4,1,0,0,0,0,0,0,4,1,0,0,0,0,0,0
2,4,3,2,14,6,8,4,4,3,2,2,8,3,5,2,4,3,2,2,5,2,3,1
0,2,1,3,15,1,14,9,2,1,0,3,14,1,13,9,2,1,0,3,13,1,12,8
2,0,1,2,15,7,8,3,0,1,2,2,8,4,4,1,0,1,2,2,4,1,3,1
0,2,1,1,6,0,6,1,2,1,0,1,6,0,6,1,2,1,0,1,6,0,6,1
3,3,3,3,7,4,3,2,3,3,3,3,3,2,1,0,3,3,3,3,1,0,1,0
3,1,0,3,2,1,1,0,1,0,3,3,1,0,1,0,1,0,3,3,1,0,1,0
4,1,4,4,26,23,3,2,1,4,4,4,3,2,1,0,1,4,4,4,1,0,1,0
4,3,4,1,13,11,2,0,3,4,4,1,2,1,1,0,3,4,4,1,1,0,1,0
4,4,1,3,3,2,1,0,4,1,4,3,1,0,1,0,4,1,4,3,1,0,1,0
0,2,4,4,25,2,23,20,2,4,0,4,23,2,21,18,2,4,0,4,21,2,19,17
3,0,3,1,29,20,9,2,0,3,3,1,9,6,3,0,0,3,3,1,3,2,1,0
3,4,3,2,5,3,2,1,4,3,3,2,2,1,1,0,4,3,3,2,1,0,1,0
3,0,0,1,5,3,2,0,0,0,3,1,2,1,1,0,0,0,3,1,1,0,1,0
4,4,0,0,1,0,1,0,4,0,4,0,1,0,1,0,4,0,4,0,1,0,1,0
1,3,0,0,15,4,11,1,3,0,1,0,11,3,8,0,3,0,1,0,8,2,6,0
4,0,0,3,11,9,2,1,0,0,4,3,2,1,1,0,0,0,4,3,1,0,1,0
4,2,4,2,26,23,3,1,2,4,4,2,3,2,1,0,2,4,4,2,1,0,1,0
1,2,1,1,19,5,14,4,2,1,1,1,14,4,10,3,2,1,1,1,10,3,7,2
1,4,0,0,8,2,6,0,4,0,1,0,6,1,5,0,4,0,1,0,5,1,4,0
4,1,1,4,14,12,2,1,1,1,4,4,2,1,1,0,1,1,4,4,1,0,1,0
3,2,3,0,19,13,6,0,2,3,3,0,6,4,2,0,2,3,3,0,2,1,1,0
4,3,0,1,0,0,0,0,3,0,4,1,0,0,0,0,3,0,4,1,0,0,0,0
2,4,1,3,6,2,4,2,4,1,2,3,4,2,2,1,4,1,2,3,2,0,2,1
2,1,3,1,26,13,13,3,1,3,2,1,13,6,7,2,1,3,2,1,7,3,4,1
0,4,1,4,6,0,6,5,4,1,0,4,6,0,6,5,4,1,0,4,6,0,6,5
2,1,1,0,13,6,7,0,1,1,2,0,7,3,4,0,1,1,2,0,4,1,3,0
4,0,1,0,21,18,3,0,0,1,4,0,3,2,1,0,0,1,4,0,1,0,1,0
2,2,4,1,19,9,10,3,2,4,2,1,10,5,5,1,2,4,2,1,5,2,3,0
4,2,0,4,3,2,1,0,2,0,4,4,1,0,1,0,2,0,4,4,1,0,1,0
2,1,4,4,28,13,15,13,1,4,2,4,15,7,8,7,1,4,2,4,8,3,5,4
3,4,2,0,8,5,3,0,4,2,3,0,3,2,1,0,4,2,3,0,1,0,1,0
1,3,0,1,3,0,3,0,3,0,1,1,3,0,3,0,3,0,1,1,3,0,3,0
4,2,1,1,8,7,1,0,2,1,4,1,1,0,1,0,2,1,4,1,1,0,1,0
3,3,3,3,7,4,3,2,3,3,3,3,3,2,1,0,3,3,3,3,1,0,1,0
0,1,3,2,18,1,17,8,1,3,0,2,17,1,16,7,1,3,0,2,16,1,15,7
1,0,2,2,17,5,12,5,0,2,1,2,12,3,9,4,0,2,1,2,9,2,7,3
0,2,1,0,4,0,4,0,2,1,0,0,4,0,4,0,2,1,0,0,4,0,4,0
0,3,3,1,9,0,9,2,3,3,0,1,9,0,9,2,3,3,0,1,9,0,9,2
3,3,3,0,12,8,4,0,3,3,3,0,4,2,2,0,3,3,3,0,2,1,1,0
0,3,1,4,8,0,8,7,3,1,0,4,8,0,8,7,3,1,0,4,8,0,8,7
4,3,0,3,0,0,0,0,3,0,4,3,0,0,0,0,3,0,4,3,0,0,0,0
0,0,1,4,15,1,14,12,0,1,0,4,14,1,13,11,0,1,0,4,13,1,12,10
2,1,3,3,18,8,10,7,1,3,2,3,10,5,5,3,1,3,2,3,5,2,3,2
1,2,3,2,9,2,7,3,2,3,1,2,7,2,5,2,2,3,1,2,5,1,4,2
1,0,0,4,10,3,7,6,0,0,1,4,7,2,5,4,0,0,1,4,5,1,4,3
1,4,3,0,7,2,5,0,4,3,1,0,5,1,4,0,4,3,1,0,4,1,3,0
1,4,1,3,3,0,3,2,4,1,1,3,3,0,3,2,4,1,1,3,3,0,3,2
2,3,0,3,10,5,5,3,3,0,2,3,5,2,3,2,3,0,2,3,3,1,2,1
4,3,4,0,14,12,2,0,3,4,4,0,2,1,1,0,3,4,4,0,1,0,1,0
4,1,4,0,23,20,3,0,1,4,4,0,3,2,1,0,1,4,4,0,1,0,1,0
3,1,1,4,12,8,4,3,1,1,3,4,4,2,2,1,1,1,3,4,2,1,1,0
0,0,2,1,16,1,15,4,0,2,0,1,15,1,14,4,0,2,0,1,14,1,13,3
1,4,3,3,8,2,6,4,4,3,1,3,6,1,5,3,4,3,1,3,5,1,4,2
0,2,3,0,15,1,14,1,2,3,0,0,14,1,13,1,2,3,0,0,13,1,12,1
1,1,1,3,10,2,8,5,1,1,1,3,8,2,6,4,1,1,1,3,6,1,5,3
4,0,4,3,26,23,3,2,0,4,4,3,3,2,1,0,0,4,4,3,1,0,1,0
4,0,0,3,4,3,1,0,0,0,4,3,1,0,1,0,0,0,4,3,1,0,1,0
2,3,4,3,20,10,10,6,3,4,2,3,10,5,5,3,3,4,2,3,5,2,3,2
0,1,2,3,19,1,18,12,1,2,0,3,18,1,17,11,1,2,0,3,17,1,16,11
3,2,0,2,3,2,1,0,2,0,3,2,1,0,1,0,2,0,3,2,1,0,1,0
1,2,4,4,17,5,12,10,2,4,1,4,12,3,9,8,2,4,1,4,9,2,7,6
0,0,0,3,9,0,9,6,0,0,0,3,9,0,9,6,0,0,0,3,9,0,9,6
4,0,1,1,9,8,1,0,0,1,4,1,1,0,1,0,0,1,4,1,1,0,1,0
0,0,0,1,4,0,4,1,0,0,0,1,4,0,4,1,0,0,0,1,4,0,4,1
4,1,3,0,27,24,3,0,1,3,4,0,3,2,1,0,1,3,4,0,1,0,1,0
3,2,0,1,4,2,2,0,2,0,3,1,2,1,1,0,2,0,3,1,1,0,1,0
3,0,1,2,15,10,5,2,0,1,3,2,5,3,2,0,0,1,3,2,2,1,1,0
4,0,3,0,25,22,3,0,0,3,4,0,3,2,1,0,0,3,4,0,1,0,1,0
4,2,4,2,18,16,2,1,2,4,4,2,2,1,1,0,2,4,4,2,1,0,1,0
1,2,4,0,21,6,15,1,2,4,1,0,15,4,11,1,2,4,1,0,11,3,8,0
4,0,4,2,26,23,3,1,0,4,4,2,3,2,1,0,0,4,4,2,1,0,1,0
3,3,3,3,1,0,1,0,3,3,3,3,1,0,1,0,3,3,3,3,1,0,1,0
2,2,4,2,24,11,13,6,2,4,2,2,13,6,7,3,2,4,2,2,7,3,4,2
3,0,0,2,8,5,3,1,0,0,3,2,3,2,1,0,0,0,3,2,1,0,1,0
2,3,1,4,6,2,4,3,3,1,2,4,4,2,2,1,3,1,2,4,2,0,2,1
0,4,1,1,2,0,2,0,4,1,0,1,2,0,2,0,4,1,0,1,2,0,2,0
4,0,3,2,27,24,3,1,0,3,4,2,3,2,1,0,0,3,4,2,1,0,1,0
0,3,0,1,11,1,10,3,3,0,0,1,10,0,10,3,3,0,0,1,10,0,10,3
2,2,4,0,21,10,11,1,2,4,2,0,11,5,6,0,2,4,2,0,6,3,3,0
2,4,1,0,8,3,5,0,4,1,2,0,5,2,3,0,4,1,2,0,3,1,2,0
2,3,2,3,11,5,6,4,3,2,2,3,6,2,4,2,3,2,2,3,4,1,3,2
1,2,0,4,5,1,4,3,2,0,1,4,4,1,3,2,2,0,1,4,3,0,3,2
4,2,1,1,2,1,1,0,2,1,4,1,1,0,1,0,2,1,4,1,1,0,1,0
4,0,0,3,8,7,1,0,0,0,4,3,1,0,1,0,0,0,4,3,1,0,1,0
4,2,4,1,22,19,3,0,2,4,4,1,3,2,1,0,2,4,4,1,1,0,1,0
3,2,2,3,7,4,3,2,2,2,3,3,3,2,1,0,2,2,3,3,1,0,1,0
2,4,1,1,7,3,4,1,4,1,2,1,4,1,3,0,4,1,2,1,3,1,2,0
0,0,3,1,27,2,25,7,0,3,0,1,25,2,23,6,0,3,0,1,23,2,21,6
4,3,0,3,0,0,0,0,3,0,4,3,0,0,0,0,3,0,4,3,0,0,0,0
4,1,2,1,20,17,3,0,1,2,4,1,3,2,1,0,1,2,4,1,1,0,1,0
1,1,2,0,13,3,10,0,1,2,1,0,10,2,8,0,1,2,1,0,8,2,6,0
0,4,2,4,9,0,9,8,4,2,0,4,9,0,9,8,4,2,0,4,9,0,9,8
2,4,2,1,1,0,1,0,4,2,2,1,1,0,1,0,4,2,2,1,1,0,1,0
4,0,4,2,27,24,3,1,0,4,4,2,3,2,1,0,0,4,4,2,1,0,1,0
4,0,4,3,29,26,3,2,0,4,4,3,3,2,1,0,0,4,4,3,1,0,1,0
3,3,1,2,7,4,3,1,3,1,3,2,3,2,1,0,3,1,3,2,1,0,1,0
4,4,3,1,4,3,1,0,4,3,4,1,1,0,1,0,4,3,4,1,1,0,1,0
1,1,0,1,7,2,5,1,1,0,1,1,5,1,4,1,1,0,1,1,4,1,3,0
0,1,1,4,3,0,3,2,1,1,0,4,3,0,3,2,1,1,0,4,3,0,3,2
3,4,3,2,8,5,3,1,4,3,3,2,3,2,1,0,4,3,3,2,1,0,1,0
3,3,0,3,3,2,1,0,3,0,3,3,1,0,1,0,3,0,3,3,1,0,1,0
4,1,4,3,27,24,3,2,1,4,4,3,3,2,1,0,1,4,4,3,1,0,1,0
2,2,1,3,9,4,5,3,2,1,2,3,5,2,3,2,2,1,2,3,3,1,2,1
3,1,0,1,7,4,3,0,1,0,3,1,3,2,1,0,1,0,3,1,1,0,1,0
4,2,0,1,5,4,1,0,2,0,4,1,1,0,1,0,2,0,4,1,1,0,1,0
2,2,0,1,9,4,5,1,2,0,2,1,5,2,3,0,2,0,2,1,3,1,2,0
3,0,0,1,17,11,6,1,0,0,3,1,6,4,2,0,0,0,3,1,2,1,1,0
0,0,3,0,25,2,23,2,0,3,0,0,23,2,21,2,0,3,0,0,21,2,19,1
1,1,0,1,12,3,9,2,1,0,1,1,9,2,7,2,1,0,1,1,7,2,5,1
2,3,2,1,5,2,3,0,3,2,2,1,3,1,2,0,3,2,2,1,2,1,1,0
0,1,1,0,10,1,9,0,1,1,0,0,9,0,9,0,1,1,0,0,9,0,9,0
2,1,1,1,2,1,1,0,1,1,2,1,1,0,1,0,1,1,2,1,1,0,1,0
4,1,0,3,8,7,1,0,1,0,4,3,1,0,1,0,1,0,4,3,1,0,1,0
4,0,2,3,22,19,3,2,0,2,4,3,3,2,1,0,0,2,4,3,1,0,1,0
1,2,1,1,4,1,3,0,2,1,1,1,3,0,3,0,2,1,1,1,3,0,3,0
3,1,3,4,20,14,6,5,1,3,3,4,6,4,2,1,1,3,3,4,2,1,1,0
2,3,1,4,1,0,1,0,3,1,2,4,1,0,1,0,3,1,2,4,1,0,1,0
3,2,3,0,18,12,6,0,2,3,3,0,6,4,2,0,2,3,3,0,2,1,1,0
1,3,2,0,14,4,10,1,3,2,1,0,10,2,8,0,3,2,1,0,8,2,6,0
4,2,1,3,4,3,1,0,2,1,4,3,1,0,1,0,2,1,4,3,1,0,1,0
1,4,3,4,2,0,2,1,4,3,1,4,2,0,2,1,4,3,1,4,2,0,2,1
2,4,4,2,13,6,7,3,4,4,2,2,7,3,4,1,4,4,2,2,4,1,3,1
0,0,3,1,24,2,22,6,0,3,0,1,22,2,20,5,0,3,0,1,20,1,19,5
2,0,3,1,23,11,12,3,0,3,2,1,12,5,7,2,0,3,2,1,7,3,4,1
2,4,4,0,8,3,5,0,4,4,2,0,5,2,3,0,4,4,2,0,3,1,2,0
4,4,0,2,2,1,1,0,4,0,4,2,1,0,1,0,4,0,4,2,1,0,1,0
1,0,2,3,18,5,13,9,0,2,1,3,13,3,10,6,0,2,1,3,10,2,8,5
2,1,4,3,25,12,13,9,1,4,2,3,13,6,7,4,1,4,2,3,7,3,4,2
1,2,1,0,5,1,4,0,2,1,1,0,4,1,3,0,2,1,1,0,3,0,3,0
2,2,3,2,22,11,11,5,2,3,2,2,11,5,6,3,2,3,2,2,6,2,4,2
4,2,1,2,3,2,1,0,2,1,4,2,1,0,1,0,2,1,4,2,1,0,1,0
3,0,3,0,22,15,7,0,0,3,3,0,7,4,3,0,0,3,3,0,3,2,1,0
4,4,0,2,7,6,1,0,4,0,4,2,1,0,1,0,4,0,4,2,1,0,1,0
0,1,3,4,23,2,21,18,1,3,0,4,21,2,19,17,1,3,0,4,19,1,18,16
0,4,3,3,5,0,5,3,4,3,0,3,5,0,5,3,4,3,0,3,5,0,5,3
3,2,0,4,2,1,1,0,2,0,3,4,1,0,1,0,2,0,3,4,1,0,1,0
3,0,4,2,28,19,9,4,0,4,3,2,9,6,3,1,0,4,3,2,3,2,1,0
3,1,1,0,23,16,7,0,1,1,3,0,7,4,3,0,1,1,3,0,3,2,1,0
0,2,1,3,18,1,17,11,2,1,0,3,17,1,16,11,2,1,0,3,16,1,15,10
3,3,2,1,7,4,3,0,3,2,3,1,3,2,1,0,3,2,3,1,1,0,1,0
4,2,0,4,1,0,1,0,2,0,4,4,1,0,1,0,2,0,4,4,1,0,1,0
4,0,0,1,8,7,1,0,0,0,4,1,1,0,1,0,0,0,4,1,1,0,1,0
2,4,2,3,8,4,4,2,4,2,2,3,4,2,2,1,4,2,2,3,2,0,2,1
0,0,3,1,29,2,27,8,0,3,0,1,27,2,25,7,0,3,0,1,25,2,23,6
3,2,2,3,15,10,5,3,2,2,3,3,5,3,2,1,2,2,3,3,2,1,1,0
4,1,1,1,3,2,1,0,1,1,4,1,1,0,1,0,1,1,4,1,1,0,1,0
0,4,2,3,3,0,3,2,4,2,0,3,3,0,3,2,4,2,0,3,3,0,3,2
1,0,3,3,24,7,17,11,0,3,1,3,17,5,12,8,0,3,1,3,12,3,9,6
2,2,0,1,10,4,6,1,2,0,2,1,6,3,3,0,2,0,2,1,3,1,2,0
2,4,1,1,4,1,3,0,4,1,2,1,3,1,2,0,4,1,2,1,2,1,1,0
4,2,3,4,19,17,2,1,2,3,4,4,2,1,1,0,2,3,4,4,1,0,1,0
3,1,1,2,11,7,4,1,1,1,3,2,4,2,2,0,1,1,3,2,2,1,1,0
3,0,2,2,23,16,7,3,0,2,3,2,7,4,3,1,0,2,3,2,3,2,1,0
2,1,4,1,26,12,14,4,1,4,2,1,14,6,8,2,1,4,2,1,8,3,5,1
2,1,1,0,15,7,8,0,1,1,2,0,8,3,5,0,1,1,2,0,5,2,3,0
4,3,1,2,8,7,1,0,3,1,4,2,1,0,1,0,3,1,4,2,1,0,1,0
1,1,0,2,10,3,7,3,1,0,1,2,7,2,5,2,1,0,1,2,5,1,4,2
2,2,0,1,2,0,2,0,2,0,2,1,2,1,1,0,2,0,2,1,1,0,1,0
4,4,2,4,0,0,0,0,4,2,4,4,0,0,0,0,4,2,4,4,0,0,0,0
2,3,1,4,8,3,5,4,3,1,2,4,5,2,3,2,3,1,2,4,3,1,2,1
3,1,2,1,18,12,6,1,1,2,3,1,6,4,2,0,1,2,3,1,2,1,1,0
3,4,2,4,4,2,2,1,4,2,3,4,2,1,1,0,4,2,3,4,1,0,1,0
4,4,0,1,6,5,1,0,4,0,4,1,1,0,1,0,4,0,4,1,1,0,1,0
4,4,1,0,0,0,0,0,4,1,4,0,0,0,0,0,4,1,4,0,0,0,0,0
2,3,0,2,10,4,6,2,3,0,2,2,6,3,3,1,3,0,2,2,3,1,2,1
1,0,4,2,20,6,14,7,0,4,1,2,14,4,10,5,0,4,1,2,10,2,8,4
0,2,0,3,10,0,10,7,2,0,0,3,10,0,10,6,2,0,0,3,10,1,9,6
3,3,1,4,3,2,1,0,3,1,3,4,1,0,1,0,3,1,3,4,1,0,1,0
1,0,3,2,20,5,15,7,0,3,1,2,15,4,11,5,0,3,1,2,11,3,8,4
3,1,1,3,12,8,4,2,1,1,3,3,4,2,2,1,1,1,3,3,2,1,1,0
3,4,2,3,5,3,2,1,4,2,3,3,2,1,1,0,4,2,3,3,1,0,1,0
1,0,2,0,19,5,14,1,0,2,1,0,14,4,10,0,0,2,1,0,10,3,7,0
3,3,1,3,8,5,3,2,3,1,3,3,3,2,1,0,3,1,3,3,1,0,1,0
0,3,1,2,11,1,10,5,3,1,0,2,10,1,9,4,3,1,0,2,9,0,9,4
3,0,1,4,19,13,6,5,0,1,3,4,6,4,2,1,0,1,3,4,2,1,1,0
3,2,0,3,4,2,2,1,2,0,3,3,2,1,1,0,2,0,3,3,1,0,1,0
1,2,1,4,5,1,4,3,2,1,1,4,4,1,3,2,2,1,1,4,3,0,3,2
3,0,2,1,16,11,5,1,0,2,3,1,5,3,2,0,0,2,3,1,2,1,1,0
3,3,3,3,12,8,4,2,3,3,3,3,4,2,2,1,3,3,3,3,2,1,1,0
3,1,0,1,8,5,3,0,1,0,3,1,3,2,1,0,1,0,3,1,1,0,1,0
1,4,3,3,3,0,3,2,4,3,1,3,3,0,3,2,4,3,1,3,3,0,3,2
3,0,1,4,22,15,7,6,0,1,3,4,7,4,3,2,0,1,3,4,3,2,1,0
0,1,0,1,3,0,3,0,1,0,0,1,3,0,3,0,1,0,0,1,3,0,3,0
2,1,0,1,10,5,5,1,1,0,2,1,5,2,3,0,1,0,2,1,3,1,2,0
2,4,2,3,2,1,1,0,4,2,2,3,1,0,1,0,4,2,2,3,1,0,1,0
1,4,0,0,5,1,4,0,4,0,1,0,4,1,3,0,4,0,1,0,3,0,3,0
1,1,3,3,21,6,15,10,1,3,1,3,15,4,11,7,1,3,1,3,11,3,8,5
0,4,1,1,1,0,1,0,4,1,0,1,1,0,1,0,4,1,0,1,1,0,1,0
3,1,3,1,29,20,9,2,1,3,3,1,9,6,3,0,1,3,3,1,3,2,1,0
2,0,1,3,15,7,8,5,0,1,2,3,8,4,4,2,0,1,2,3,4,1,3,2
3,2,0,1,2,1,1,0,2,0,3,1,1,0,1,0,2,0,3,1,1,0,1,0
3,4,4,4,8,5,3,2,4,4,3,4,3,2,1,0,4,4,3,4,1,0,1,0
2,4,2,1,4,1,3,0,4,2,2,1,3,1,2,0,4,2,2,1,2,0,2,0
0,3,3,1,7,0,7,2,3,3,0,1,7,0,7,2,3,3,0,1,7,0,7,2
2,1,0,2,11,5,6,2,1,0,2,2,6,3,3,1,1,0,2,2,3,1,2,1
3,0,3,0,25,17,8,0,0,3,3,0,8,5,3,0,0,3,3,0,3,2,1,0
2,2,1,3,12,5,7,4,2,1,2,3,7,3,4,2,2,1,2,3,4,2,2,1
3,4,0,2,0,0,0,0,4,0,3,2,0,0,0,0,4,0,3,2,0,0,0,0
1,4,2,3,4,1,3,2,4,2,1,3,3,0,3,2,4,2,1,3,3,0,3,2
4,3,1,2,4,3,1,0,3,1,4,2,1,0,1,0,3,1,4,2,1,0,1,0
0,2,2,1,15,1,14,4,2,2,0,1,14,1,13,3,2,2,0,1,13,1,12,3
1,1,1,2,11,3,8,4,1,1,1,2,8,2,6,3,1,1,1,2,6,1,5,2
0,1,2,0,14,1,13,1,1,2,0,0,13,1,12,1,1,2,0,0,12,1,11,1
4,1,3,4,23,20,3,2,1,3,4,4,3,2,1,0,1,3,4,4,1,0,1,0
1,4,0,3,10,2,8,5,4,0,1,3,8,2,6,4,4,0,1,3,6,1,5,3
4,2,0,0,2,1,1,0,2,0,4,0,1,0,1,0,2,0,4,0,1,0,1,0
2,2,1,2,1,0,1,0,2,1,2,2,1,0,1,0,2,1,2,2,1,0,1,0
3,4,1,3,7,4,3,2,4,1,3,3,3,2,1,0,4,1,3,3,1,0,1,0
0,1,3,2,17,1,16,8,1,3,0,2,16,1,15,7,1,3,0,2,15,1,14,6
3,1,3,4,21,14,7,6,1,3,3,4,7,4,3,2,1,3,3,4,3,2,1,0
3,2,3,1,16,11,5,1,2,3,3,1,5,3,2,0,2,3,3,1,2,1,1,0
0,1,3,2,22,2,20,9,1,3,0,2,20,2,18,8,1,3,0,2,18,1,17,8
3,0,2,2,18,12,6,2,0,2,3,2,6,4,2,0,0,2,3,2,2,1,1,0
0,3,1,2,2,0,2,1,3,1,0,2,2,0,2,0,3,1,0,2,2,0,2,0
3,4,2,3,7,4,3,2,4,2,3,3,3,2,1,0,4,2,3,3,1,0,1,0
0,0,3,0,27,2,25,2,0,3,0,0,25,2,23,2,0,3,0,0,23,2,21,2
0,2,0,1,5,0,5,1,2,0,0,1,5,0,5,1,2,0,0,1,5,0,5,1
3,1,1,4,10,7,3,2,1,1,3,4,3,2,1,0,1,1,3,4,1,0,1,0
2,1,2,0,20,9,11,1,1,2,2,0,11,5,6,0,1,2,2,0,6,3,3,0
0,2,1,3,2,0,2,1,2,1,0,3,2,0,2,1,2,1,0,3,2,0,2,1
2,2,4,1,26,12,14,4,2,4,2,1,14,6,8,2,2,4,2,1,8,4,4,1
1,3,3,4,16,4,12,10,3,3,1,4,12,3,9,8,3,3,1,4,9,2,7,6
2,4,0,1,6,2,4,1,4,0,2,1,4,2,2,0,4,0,2,1,2,0,2,0
0,3,1,1,3,0,3,0,3,1,0,1,3,0,3,0,3,1,0,1,3,0,3,0
3,2,0,2,6,4,2,1,2,0,3,2,2,1,1,0,2,0,3,2,1,0,1,0
3,1,1,2,15,10,5,2,1,1,3,2,5,3,2,0,1,1,3,2,2,1,1,0
3,4,0,3,0,0,0,0,4,0,3,3,0,0,0,0,4,0,3,3,0,0,0,0
0,3,3,1,14,1,13,3,3,3,0,1,13,1,12,3,3,3,0,1,12,1,11,3
2,2,3,1,16,8,8,2,2,3,2,1,8,4,4,1,2,3,2,1,4,1,3,0
1,2,0,1,3,0,3,0,2,0,1,1,3,0,3,0,2,0,1,1,3,0,3,0
2,4,3,4,6,3,3,2,4,3,2,4,3,1,2,1,4,3,2,4,2,0,2,1
0,2,3,1,23,2,21,6,2,3,0,1,21,2,19,5,2,3,0,1,19,1,18,5
3,3,2,1,6,4,2,0,3,2,3,1,2,1,1,0,3,2,3,1,1,0,1,0
0,4,3,1,11,1,10,3,4,3,0,1,10,1,9,2,4,3,0,1,9,0,9,2
4,1,3,4,11,9,2,1,1,3,4,4,2,1,1,0,1,3,4,4,1,0,1,0
1,4,2,1,8,2,6,1,4,2,1,1,6,1,5,1,4,2,1,1,5,1,4,1
1,1,2,4,12,3,9,8,1,2,1,4,9,2,7,6,1,2,1,4,7,2,5,4
1,0,2,1,21,6,15,4,0,2,1,1,15,4,11,3,0,2,1,1,11,3,8,2
4,4,1,4,7,6,1,0,4,1,4,4,1,0,1,0,4,1,4,4,1,0,1,0
0,4,4,0,16,1,15,1,4,4,0,0,15,1,14,1,4,4,0,0,14,1,13,1
0,3,0,1,10,0,10,2,3,0,0,1,10,0,10,3,3,0,0,1,10,0,10,3
3,4,0,3,3,2,1,0,4,0,3,3,1,0,1,0,4,0,3,3,1,0,1,0
2,2,2,1,1,0,1,0,2,2,2,1,1,0,1,0,2,2,2,1,1,0,1,0
2,1,1,2,19,9,10,4,1,1,2,2,10,5,5,2,1,1,2,2,5,2,3,1
4,4,0,0,4,3,1,0,4,0,4,0,1,0,1,0,4,0,4,0,1,0,1,0
3,4,0,2,0,0,0,0,4,0,3,2,0,0,0,0,4,0,3,2,0,0,0,0
4,0,4,1,29,26,3,0,0,4,4,1,3,2,1,0,0,4,4,1,1,0,1,0
3,2,4,2,21,14,7,3,2,4,3,2,7,4,3,1,2,4,3,2,3,2,1,0
0,0,3,2,21,2,19,9,0,3,0,2,19,1,18,9,0,3,0,2,18,1,17,8
1,3,3,1,12,3,9,2,3,3,1,1,9,2,7,2,3,3,1,1,7,2,5,1
0,3,3,3,7,0,7,4,3,3,0,3,7,0,7,4,3,3,0,3,7,0,7,4
1,0,4,1,24,7,17,5,0,4,1,1,17,5,12,3,0,4,1,1,12,3,9,2
4,1,0,0,5,4,1,0,1,0,4,0,1,0,1,0,1,0,4,0,1,0,1,0
3,1,3,3,26,18,8,5,1,3,3,3,8,5,3,2,1,3,3,3,3,2,1,0
3,4,1,1,8,5,3,0,4,1,3,1,3,2,1,0,4,1,3,1,1,0,1,0
3,2,2,0,12,8,4,0,2,2,3,0,4,2,2,0,2,2,3,0,2,1,1,0
1,3,0,0,9,2,7,0,3,0,1,0,7,2,5,0,3,0,1,0,5,1,4,0
2,4,3,4,7,3,4,3,4,3,2,4,4,1,3,2,4,3,2,4,3,1,2,1
1,3,3,3,8,2,6,4,3,3,1,3,6,1,5,3,3,3,1,3,5,1,4,2
0,1,0,2,0,0,0,0,1,0,0,2,0,0,0,0,1,0,0,2,0,0,0,0
1,0,3,1,29,8,21,6,0,3,1,1,21,6,15,4,0,3,1,1,15,4,11,3
3,1,3,3,20,13,7,4,1,3,3,3,7,4,3,2,1,3,3,3,3,2,1,0
1,1,1,4,11,3,8,7,1,1,1,4,8,2,6,5,1,1,1,4,6,1,5,4
4,2,0,4,2,1,1,0,2,0,4,4,1,0,1,0,2,0,4,4,1,0,1,0
3,1,2,2,8,5,3,1,1,2,3,2,3,2,1,0,1,2,3,2,1,0,1,0
3,2,0,1,1,0,1,0,2,0,3,1,1,0,1,0,2,0,3,1,1,0,1,0
1,1,3,0,14,4,10,1,1,3,1,0,10,3,7,0,1,3,1,0,7,2,5,0
2,1,3,1,23,11,12,3,1,3,2,1,12,5,7,2,1,3,2,1,7,3,4,1
0,4,3,1,1,0,1,0,4,3,0,1,1,0,1,0,4,3,0,1,1,0,1,0
1,0,0,3,6,1,5,3,0,0,1,3,5,1,4,2,0,0,1,3,4,1,3,2
2,4,1,0,8,4,4,0,4,1,2,0,4,2,2,0,4,1,2,0,2,0,2,0
4,1,4,0,28,25,3,0,1,4,4,0,3,2,1,0,1,4,4,0,1,0,1,0
4,4,3,2,5,4,1,0,4,3,4,2,1,0,1,0,4,3,4,2,1,0,1,0
1,1,4,1,27,8,19,5,1,4,1,1,19,5,14,4,1,4,1,1,14,4,10,2
4,4,3,2,1,0,1,0,4,3,4,2,1,0,1,0,4,3,4,2,1,0,1,0
1,2,0,0,8,2,6,0,2,0,1,0,6,1,5,0,2,0,1,0,5,1,4,0
0,2,3,2,26,2,24,11,2,3,0,2,24,2,22,11,2,3,0,2,22,2,20,10
2,0,3,0,29,14,15,1,0,3,2,0,15,7,8,0,0,3,2,0,8,4,4,0
4,1,2,1,19,17,2,0,1,2,4,1,2,1,1,0,1,2,4,1,1,0,1,0
1,4,2,0,9,2,7,0,4,2,1,0,7,2,5,0,4,2,1,0,5,1,4,0
3,2,2,0,17,11,6,0,2,2,3,0,6,4,2,0,2,2,3,0,2,1,1,0
4,2,0,0,11,9,2,0,2,0,4,0,2,1,1,0,2,0,4,0,1,0,1,0
1,4,3,2,4,1,3,1,4,3,1,2,3,0,3,1,4,3,1,2,3,0,3,1
1,0,1,4,16,4,12,10,0,1,1,4,12,3,9,8,0,1,1,4,9,2,7,6
1,1,1,2,13,3,10,4,1,1,1,2,10,3,7,3,1,1,1,2,7,2,5,2
2,4,2,0,8,3,5,0,4,2,2,0,5,2,3,0,4,2,2,0,3,1,2,0
4,1,0,2,3,2,1,0,1,0,4,2,1,0,1,0,1,0,4,2,1,0,1,0
4,3,2,3,3,2,1,0,3,2,4,3,1,0,1,0,3,2,4,3,1,0,1,0
4,2,3,1,15,13,2,0,2,3,4,1,2,1,1,0,2,3,4,1,1,0,1,0
1,0,3,0,20,6,14,1,0,3,1,0,14,4,10,1,0,3,1,0,10,3,7,0
4,1,3,4,13,11,2,1,1,3,4,4,2,1,1,0,1,3,4,4,1,0,1,0
2,2,0,4,3,1,2,1,2,0,2,4,2,1,1,0,2,0,2,4,1,0,1,0
2,1,0,1,2,0,2,0,1,0,2,1,2,0,2,0,1,0,2,1,2,1,1,0
0,4,2,1,10,0,10,3,4,2,0,1,10,0,10,3,4,2,0,1,10,0,10,3
1,0,2,3,25,7,18,12,0,2,1,3,18,5,13,9,0,2,1,3,13,3,10,6
0,3,4,3,13,1,12,8,3,4,0,3,12,1,11,7,3,4,0,3,11,1,10,7
2,3,0,0,8,4,4,0,3,0,2,0,4,1,3,0,3,0,2,0,3,1,2,0
1,3,2,4,4,1,3,2,3,2,1,4,3,0,3,2,3,2,1,4,3,0,3,2
2,1,2,0,18,9,9,0,1,2,2,0,9,4,5,0,1,2,2,0,5,2,3,0
1,4,4,3,4,1,3,2,4,4,1,3,3,0,3,2,4,4,1,3,3,0,3,2
3,1,1,3,15,10,5,3,1,1,3,3,5,3,2,1,1,1,3,3,2,1,1,0
2,0,0,2,3,1,2,0,0,0,2,2,2,1,1,0,0,0,2,2,1,0,1,0
4,0,0,2,9,8,1,0,0,0,4,2,1,0,1,0,0,0,4,2,1,0,1,0
4,2,1,3,9,8,1,0,2,1,4,3,1,0,1,0,2,1,4,3,1,0,1,0
4,2,2,4,7,6,1,0,2,2,4,4,1,0,1,0,2,2,4,4,1,0,1,0
2,3,1,3,6,3,3,2,3,1,2,3,3,1,2,1,3,1,2,3,2,0,2,1
1,4,2,2,7,2,5,2,4,2,1,2,5,1,4,2,4,2,1,2,4,1,3,1
4,1,1,4,4,3,1,0,1,1,4,4,1,0,1,0,1,1,4,4,1,0,1,0
0,1,4,4,28,2,26,23,1,4,0,4,26,2,24,21,1,4,0,4,24,2,22,19
0,2,1,3,7,0,7,4,2,1,0,3,7,0,7,4,2,1,0,3,7,0,7,4
1,0,0,3,16,4,12,8,0,0,1,3,12,3,9,6,0,0,1,3,9,2,7,4
1,4,2,2,5,1,4,2,4,2,1,2,4,1,3,1,4,2,1,2,3,0,3,1
4,4,3,3,0,0,0,0,4,3,4,3,0,0,0,0,4,3,4,3,0,0,0,0
3,1,4,2,25,17,8,3,1,4,3,2,8,5,3,1,1,4,3,2,3,2,1,0
2,1,4,2,26,12,14,7,1,4,2,2,14,7,7,3,1,4,2,2,7,3,4,1
0,0,2,3,19,1,18,12,0,2,0,3,18,1,17,11,0,2,0,3,17,1,16,11
3,4,4,2,6,4,2,0,4,4,3,2,2,1,1,0,4,4,3,2,1,0,1,0
4,4,1,0,2,1,1,0,4,1,4,0,1,0,1,0,4,1,4,0,1,0,1,0
0,0,4,2,28,2,26,13,0,4,0,2,26,2,24,11,0,4,0,2,24,2,22,10
1,1,0,2,12,3,9,4,1,0,1,2,9,2,7,3,1,0,1,2,7,2,5,2
1,1,1,0,9,2,7,0,1,1,1,0,7,2,5,0,1,1,1,0,5,1,4,0
0,4,2,1,5,0,5,1,4,2,0,1,5,0,5,1,4,2,0,1,5,0,5,1
0,2,2,3,9,0,9,6,2,2,0,3,9,0,9,6,2,2,0,3,9,0,9,6
2,2,0,0,5,2,3,0,2,0,2,0,3,1,2,0,2,0,2,0,2,1,1,0
3,4,0,3,8,5,3,2,4,0,3,3,3,2,1,0,4,0,3,3,1,0,1,0
4,2,2,2,8,7,1,0,2,2,4,2,1,0,1,0,2,2,4,2,1,0,1,0
2,2,3,0,22,10,12,1,2,3,2,0,12,6,6,0,2,3,2,0,6,2,4,0
1,3,3,1,14,4,10,2,3,3,1,1,10,2,8,2,3,3,1,1,8,2,6,1
1,0,0,2,5,1,4,2,0,0,1,2,4,1,3,1,0,0,1,2,3,0,3,1
1,1,2,0,20,6,14,1,1,2,1,0,14,4,10,0,1,2,1,0,10,3,7,0
3,1,0,3,0,0,0,0,1,0,3,3,0,0,0,0,1,0,3,3,0,0,0,0
2,0,4,4,28,13,15,13,0,4,2,4,15,7,8,7,0,4,2,4,8,4,4,3
4,3,2,2,10,9,1,0,3,2,4,2,1,0,1,0,3,2,4,2,1,0,1,0
4,0,4,1,29,26,3,0,0,4,4,1,3,2,1,0,0,4,4,1,1,0,1,0
3,2,2,1,9,6,3,0,2,2,3,1,3,2,1,0,2,2,3,1,1,0,1,0
4,3,0,0,1,0,1,0,3,0,4,0,1,0,1,0,3,0,4,0,1,0,1,0
2,4,4,0,7,3,4,0,4,4,2,0,4,2,2,0,4,4,2,0,2,0,2,0
3,1,2,0,12,8,4,0,1,2,3,0,4,2,2,0,1,2,3,0,2,1,1,0
2,3,1,2,5,2,3,1,3,1,2,2,3,1,2,1,3,1,2,2,2,1,1,0
3,2,4,1,29,20,9,2,2,4,3,1,9,6,3,0,2,4,3,1,3,2,1,0
1,2,1,2,3,0,3,1,2,1,1,2,3,0,3,1,2,1,1,2,3,0,3,1
1,1,1,4,11,3,8,7,1,1,1,4,8,2,6,5,1,1,1,4,6,1,5,4
1,2,3,3,23,6,17,11,2,3,1,3,17,5,12,8,2,3,1,3,12,3,9,6
3,0,2,0,21,14,7,0,0,2,3,0,7,4,3,0,0,2,3,0,3,2,1,0
1,2,4,3,20,5,15,10,2,4,1,3,15,4,11,7,2,4,1,3,11,3,8,5
3,3,3,0,14,9,5,0,3,3,3,0,5,3,2,0,3,3,3,0,2,1,1,0
2,0,0,4,6,3,3,2,0,0,2,4,3,1,2,1,0,0,2,4,2,1,1,0
3,0,0,0,9,6,3,0,0,0,3,0,3,2,1,0,0,0,3,0,1,0,1,0
0,2,4,0,25,2,23,2,2,4,0,0,23,2,21,2,2,4,0,0,21,2,19,1
4,4,2,3,6,5,1,0,4,2,4,3,1,0,1,0,4,2,4,3,1,0,1,0
3,2,2,3,4,2,2,1,2,2,3,3,2,1,1,0,2,2,3,3,1,0,1,0
1,3,3,3,7,2,5,3,3,3,1,3,5,1,4,2,3,3,1,3,4,1,3,2
2,4,2,1,7,3,4,1,4,2,2,1,4,2,2,0,4,2,2,1,2,1,1,0
4,3,4,3,14,12,2,1,3,4,4,3,2,1,1,0,3,4,4,3,1,0,1,0
0,4,4,2,12,1,11,5,4,4,0,2,11,1,10,4,4,4,0,2,10,1,9,4
0,1,1,3,5,0,5,3,1,1,0,3,5,0,5,3,1,1,0,3,5,0,5,3
1,2,3,1,20,6,14,4,2,3,1,1,14,4,10,3,2,3,1,1,10,3,7,2
3,0,1,0,12,8,4,0,0,1,3,0,4,2,2,0,0,1,3,0,2,1,1,0
0,1,4,4,26,2,24,21,1,4,0,4,24,2,22,19,1,4,0,4,22,2,20,17
3,3,3,2,12,8,4,1,3,3,3,2,4,2,2,0,3,3,3,2,2,1,1,0
1,1,2,3,14,4,10,6,1,2,1,3,10,2,8,5,1,2,1,3,8,2,6,4
1,0,4,1,28,8,20,5,0,4,1,1,20,6,14,4,0,4,1,1,14,4,10,3
3,0,1,1,14,9,5,1,0,1,3,1,5,3,2,0,0,1,3,1,2,1,1,0
4,4,2,2,8,7,1,0,4,2,4,2,1,0,1,0,4,2,4,2,1,0,1,0
1,1,0,0,6,1,5,0,1,0,1,0,5,1,4,0,1,0,1,0,4,1,3,0
4,3,4,2,20,17,3,1,3,4,4,2,3,2,1,0,3,4,4,2,1,0,1,0
3,2,2,3,8,5,3,2,2,2,3,3,3,2,1,0,2,2,3,3,1,0,1,0
1,4,3,4,6,1,5,4,4,3,1,4,5,1,4,3,4,3,1,4,4,1,3,2
0,2,0,1,7,0,7,2,2,0,0,1,7,0,7,2,2,0,0,1,7,0,7,2
0,3,1,1,7,0,7,2,3,1,0,1,7,0,7,2,3,1,0,1,7,0,7,2
1,2,4,2,27,8,19,9,2,4,1,2,19,5,14,6,2,4,1,2,14,4,10,4
2,4,4,2,16,8,8,3,4,4,2,2,8,4,4,2,4,4,2,2,4,1,3,1
3,2,3,3,14,9,5,3,2,3,3,3,5,3,2,1,2,3,3,3,2,1,1,0
4,3,2,4,10,8,2,1,3,2,4,4,2,1,1,0,3,2,4,4,1,0,1,0
3,3,2,1,11,7,4,1,3,2,3,1,4,2,2,0,3,2,3,1,2,1,1,0
0,3,0,2,3,0,3,1,3,0,0,2,3,0,3,1,3,0,0,2,3,0,3,1
1,3,4,0,10,2,8,0,3,4,1,0,8,2,6,0,3,4,1,0,6,1,5,0
2,4,4,2,5,2,3,1,4,4,2,2,3,1,2,1,4,4,2,2,2,1,1,0
1,4,0,1,7,2,5,1,4,0,1,1,5,1,4,1,4,0,1,1,4,1,3,0
1,4,3,3,19,5,14,9,4,3,1,3,14,4,10,7,4,3,1,3,10,3,7,4
0,0,1,1,12,1,11,3,0,1,0,1,11,1,10,3,0,1,0,1,10,1,9,2
1,0,0,0,9,2,7,0,0,0,1,0,7,2,5,0,0,0,1,0,5,1,4,0
0,3,4,2,17,1,16,7,3,4,0,2,16,1,15,7,3,4,0,2,15,1,14,7
0,1,3,4,25,2,23,20,1,3,0,4,23,2,21,18,1,3,0,4,21,2,19,17
2,4,2,1,4,2,2,0,4,2,2,1,2,0,2,0,4,2,2,1,2,1,1,0
4,4,1,3,3,2,1,0,4,1,4,3,1,0,1,0,4,1,4,3,1,0,1,0
0,4,4,3,15,1,14,9,4,4,0,3,14,1,13,9,4,4,0,3,13,1,12,8
4,1,3,0,22,19,3,0,1,3,4,0,3,2,1,0,1,3,4,0,1,0,1,0
1,0,0,4,2,0,2,1,0,0,1,4,2,0,2,1,0,0,1,4,2,0,2,1
3,3,3,1,14,9,5,1,3,3,3,1,5,3,2,0,3,3,3,1,2,1,1,0
4,3,1,0,13,11,2,0,3,1,4,0,2,1,1,0,3,1,4,0,1,0,1,0
3,4,0,0,2,1,1,0,4,0,3,0,1,0,1,0,4,0,3,0,1,0,1,0
4,2,3,2,15,13,2,1,2,3,4,2,2,1,1,0,2,3,4,2,1,0,1,0
1,0,0,1,7,2,5,1,0,0,1,1,5,1,4,1,0,0,1,1,4,1,3,0
1,2,1,0,8,2,6,0,2,1,1,0,6,1,5,0,2,1,1,0,5,1,4,0
4,4,0,2,1,0,1,0,4,0,4,2,1,0,1,0,4,0,4,2,1,0,1,0
1,3,1,3,4,1,3,2,3,1,1,3,3,0,3,2,3,1,1,3,3,0,3,2
2,2,1,3,9,4,5,3,2,1,2,3,5,2,3,2,2,1,2,3,3,1,2,1
2,3,3,4,9,4,5,4,3,3,2,4,5,2,3,2,3,3,2,4,3,1,2,1
2,3,4,2,8,4,4,2,3,4,2,2,4,2,2,1,3,4,2,2,2,1,1,0
0,1,3,0,23,2,21,2,1,3,0,0,21,2,19,1,1,3,0,0,19,1,18,1
3,3,0,4,9,6,3,2,3,0,3,4,3,2,1,0,3,0,3,4,1,0,1,0
0,0,3,2,28,2,26,12,0,3,0,2,26,2,24,11,0,3,0,2,24,2,22,10
0,3,0,4,3,0,3,2,3,0,0,4,3,0,3,2,3,0,0,4,3,0,3,2
4,1,2,1,15,13,2,0,1,2,4,1,2,1,1,0,1,2,4,1,1,0,1,0
1,4,4,0,16,4,12,1,4,4,1,0,12,3,9,0,4,4,1,0,9,2,7,0
2,0,4,4,29,14,15,13,0,4,2,4,15,7,8,7,0,4,2,4,8,3,5,4
4,4,0,2,7,6,1,0,4,0,4,2,1,0,1,0,4,0,4,2,1,0,1,0
2,0,2,0,24,12,12,1,0,2,2,0,12,6,6,0,0,2,2,0,6,2,4,0
3,4,2,2,7,4,3,1,4,2,3,2,3,2,1,0,4,2,3,2,1,0,1,0
0,0,3,2,28,2,26,12,0,3,0,2,26,2,24,12,0,3,0,2,24,2,22,11
0,3,3,0,18,1,17,1,3,3,0,0,17,1,16,1,3,3,0,0,16,1,15,1
4,3,1,3,5,4,1,0,3,1,4,3,1,0,1,0,3,1,4,3,1,0,1,0
3,3,2,3,13,9,4,2,3,2,3,3,4,2,2,1,3,2,3,3,2,1,1,0
1,1,1,4,3,0,3,2,1,1,1,4,3,0,3,2,1,1,1,4,3,0,3,2
2,4,3,0,6,3,3,0,4,3,2,0,3,1,2,0,4,3,2,0,2,1,1,0
2,3,3,2,4,2,2,0,3,3,2,2,2,1,1,0,3,3,2,2,1,0,1,0
4,1,2,1,14,12,2,0,1,2,4,1,2,1,1,0,1,2,4,1,1,0,1,0
3,0,3,0,24,16,8,0,0,3,3,0,8,5,3,0,0,3,3,0,3,2,1,0
2,4,3,3,7,3,4,2,4,3,2,3,4,2,2,1,4,3,2,3,2,0,2,1
1,3,3,3,13,3,10,6,3,3,1,3,10,2,8,5,3,3,1,3,8,2,6,4
4,0,3,0,27,24,3,0,0,3,4,0,3,2,1,0,0,3,4,0,1,0,1,0
0,2,0,1,12,1,11,3,2,0,0,1,11,1,10,3,2,0,0,1,10,1,9,2
4,1,3,4,22,19,3,2,1,3,4,4,3,2,1,0,1,3,4,4,1,0,1,0
2,0,2,2,15,7,8,4,0,2,2,2,8,4,4,1,0,2,2,2,4,2,2,1
1,0,1,3,18,5,13,9,0,1,1,3,13,3,10,6,0,1,1,3,10,2,8,5
0,1,1,4,2,0,2,1,1,1,0,4,2,0,2,1,1,1,0,4,2,0,2,1
2,1,1,4,9,4,5,4,1,1,2,4,5,2,3,2,1,1,2,4,3,1,2,1
1,0,0,4,7,2,5,4,0,0,1,4,5,1,4,3,0,0,1,4,4,1,3,2
1,4,4,3,11,3,8,5,4,4,1,3,8,2,6,4,4,4,1,3,6,1,5,3
4,0,0,1,8,7,1,0,0,0,4,1,1,0,1,0,0,0,4,1,1,0,1,0
0,2,2,3,10,0,10,6,2,2,0,3,10,0,10,7,2,2,0,3,10,0,10,6
2,3,0,2,13,6,7,3,3,0,2,2,7,3,4,2,3,0,2,2,4,1,3,1
1,3,1,2,7,2,5,2,3,1,1,2,5,1,4,2,3,1,1,2,4,1,3,1
1,0,4,4,23,6,17,15,0,4,1,4,17,5,12,10,0,4,1,4,12,3,9,8
4,4,1,4,1,0,1,0,4,1,4,4,1,0,1,0,4,1,4,4,1,0,1,0
1,3,1,1,5,1,4,1,3,1,1,1,4,1,3,0,3,1,1,1,3,0,3,0
1,2,1,1,14,4,10,2,2,1,1,1,10,2,8,2,2,1,1,1,8,2,6,1
1,0,3,2,20,6,14,7,0,3,1,2,14,4,10,4,0,3,1,2,10,2,8,3
2,3,4,2,20,10,10,5,3,4,2,2,10,5,5,2,3,4,2,2,5,2,3,1
0,1,2,1,12,1,11,3,1,2,0,1,11,1,10,2,1,2,0,1,10,0,10,3
1,0,0,3,8,2,6,4,0,0,1,3,6,1,5,3,0,0,1,3,5,1,4,2
1,3,0,0,9,2,7,0,3,0,1,0,7,2,5,0,3,0,1,0,5,1,4,0
3,2,3,2,20,13,7,3,2,3,3,2,7,4,3,1,2,3,3,2,3,2,1,0
4,2,2,1,16,14,2,0,2,2,4,1,2,1,1,0,2,2,4,1,1,0,1,0
4,0,2,1,23,20,3,0,0,2,4,1,3,2,1,0,0,2,4,1,1,0,1,0
3,3,2,2,8,5,3,1,3,2,3,2,3,2,1,0,3,2,3,2,1,0,1,0
2,4,2,2,6,2,4,2,4,2,2,2,4,1,3,1,4,2,2,2,3,1,2,1
2,3,0,4,16,7,9,8,3,0,2,4,9,4,5,4,3,0,2,4,5,2,3,2
3,4,1,2,0,0,0,0,4,1,3,2,0,0,0,0,4,1,3,2,0,0,0,0
1,1,0,2,8,2,6,3,1,0,1,2,6,1,5,2,1,0,1,2,5,1,4,1
4,3,3,3,1,0,1,0,3,3,4,3,1,0,1,0,3,3,4,3,1,0,1,0
3,2,3,3,16,11,5,3,2,3,3,3,5,3,2,1,2,3,3,3,2,1,1,0
0,3,2,3,11,1,10,6,3,2,0,3,10,0,10,7,3,2,0,3,10,0,10,7
3,0,2,1,27,18,9,2,0,2,3,1,9,6,3,0,0,2,3,1,3,2,1,0
3,2,4,1,24,16,8,2,2,4,3,1,8,5,3,0,2,4,3,1,3,2,1,0
1,4,1,2,6,1,5,2,4,1,1,2,5,1,4,2,4,1,1,2,4,1,3,1
4,4,3,4,3,2,1,0,4,3,4,4,1,0,1,0,4,3,4,4,1,0,1,0
0,3,4,2,15,1,14,7,3,4,0,2,14,1,13,6,3,4,0,2,13,1,12,6
4,4,2,4,5,4,1,0,4,2,4,4,1,0,1,0,4,2,4,4,1,0,1,0
3,0,2,1,23,16,7,2,0,2,3,1,7,4,3,0,0,2,3,1,3,2,1,0
4,4,0,3,1,0,1,0,4,0,4,3,1,0,1,0,4,0,4,3,1,0,1,0
0,3,3,1,12,1,11,3,3,3,0,1,11,1,10,3,3,3,0,1,10,0,10,3
2,1,3,2,22,11,11,5,1,3,2,2,11,5,6,2,1,3,2,2,6,2,4,1
2,0,2,4,20,10,10,8,0,2,2,4,10,5,5,4,0,2,2,4,5,2,3,2
4,3,2,1,8,7,1,0,3,2,4,1,1,0,1,0,3,2,4,1,1,0,1,0
1,2,3,2,21,6,15,7,2,3,1,2,15,4,11,5,2,3,1,2,11,3,8,3
3,0,3,4,25,17,8,7,0,3,3,4,8,5,3,2,0,3,3,4,3,2,1,0
2,2,3,3,16,8,8,5,2,3,2,3,8,3,5,3,2,3,2,3,5,2,3,2
2,3,1,2,4,2,2,1,3,1,2,2,2,0,2,0,3,1,2,2,2,0,2,1
3,0,0,1,12,8,4,1,0,0,3,1,4,2,2,0,0,0,3,1,2,1,1,0
0,1,2,3,16,1,15,10,1,2,0,3,15,1,14,9,1,2,0,3,14,1,13,9
4,0,0,0,6,5,1,0,0,0,4,0,1,0,1,0,0,0,4,0,1,0,1,0
2,0,2,1,19,9,10,2,0,2,2,1,10,5,5,1,0,2,2,1,5,2,3,0
0,2,4,2,22,2,20,10,2,4,0,2,20,1,19,9,2,4,0,2,19,1,18,8
3,3,0,4,6,4,2,1,3,0,3,4,2,1,1,0,3,0,3,4,1,0,1,0
2,2,4,0,24,11,13,1,2,4,2,0,13,6,7,0,2,4,2,0,7,3,4,0
2,0,0,0,8,4,4,0,0,0,2,0,4,2,2,0,0,0,2,0,2,1,1,0
4,2,4,0,29,26,3,0,2,4,4,0,3,2,1,0,2,4,4,0,1,0,1,0
4,0,1,2,17,15,2,1,0,1,4,2,2,1,1,0,0,1,4,2,1,0,1,0
2,1,2,0,15,7,8,0,1,2,2,0,8,3,5,0,1,2,2,0,5,2,3,0
4,2,4,4,17,15,2,1,2,4,4,4,2,1,1,0,2,4,4,4,1,0,1,0
4,0,2,1,25,22,3,0,0,2,4,1,3,2,1,0,0,2,4,1,1,0,1,0
2,0,3,4,26,13,13,11,0,3,2,4,13,6,7,6,0,3,2,4,7,3,4,3
0,2,0,0,0,0,0,0,2,0,0,0,0,0,0,0,2,0,0,0,0,0,0,0
4,0,1,4,11,9,2,1,0,1,4,4,2,1,1,0,0,1,4,4,1,0,1,0
3,3,0,4,2,1,1,0,3,0,3,4,1,0,1,0,3,0,3,4,1,0,1,0
2,2,3,1,21,10,11,3,2,3,2,1,11,5,6,1,2,3,2,1,6,2,4,1
1,0,2,0,22,6,16,1,0,2,1,0,16,4,12,1,0,2,1,0,12,3,9,0
4,4,4,2,8,7,1,0,4,4,4,2,1,0,1,0,4,4,4,2,1,0,1,0
3,2,4,1,15,10,5,1,2,4,3,1,5,3,2,0,2,4,3,1,2,1,1,0
1,4,3,3,14,4,10,6,4,3,1,3,10,2,8,5,4,3,1,3,8,2,6,4
3,0,3,4,17,11,6,5,0,3,3,4,6,4,2,1,0,3,3,4,2,1,1,0
1,1,0,4,6,1,5,4,1,0,1,4,5,1,4,3,1,0,1,4,4,1,3,2
2,0,3,1,28,13,15,4,0,3,2,1,15,7,8,2,0,3,2,1,8,4,4,1
0,4,3,4,4,0,4,3,4,3,0,4,4,0,4,3,4,3,0,4,4,0,4,3
2,3,3,4,13,6,7,6,3,3,2,4,7,3,4,3,3,3,2,4,4,2,2,1
0,0,2,0,26,2,24,2,0,2,0,0,24,2,22,2,0,2,0,0,22,2,20,1
0,3,3,3,8,0,8,5,3,3,0,3,8,0,8,5,3,3,0,3,8,0,8,5
1,3,4,3,21,6,15,10,3,4,1,3,15,4,11,7,3,4,1,3,11,3,8,5
2,3,4,0,12,6,6,0,3,4,2,0,6,3,3,0,3,4,2,0,3,1,2,0
0,0,2,1,19,1,18,5,0,2,0,1,18,1,17,5,0,2,0,1,17,1,16,4
2,0,1,0,14,6,8,0,0,1,2,0,8,3,5,0,0,1,2,0,5,2,3,0
1,3,0,2,5,1,4,1,3,0,1,2,4,1,3,1,3,0,1,2,3,0,3,1
1,2,2,3,8,2,6,4,2,2,1,3,6,1,5,3,2,2,1,3,5,1,4,2
3,2,4,2,24,16,8,3,2,4,3,2,8,5,3,1,2,4,3,2,3,2,1,0
4,1,2,0,17,15,2,0,1,2,4,0,2,1,1,0,1,2,4,0,1,0,1,0
3,0,1,1,13,9,4,1,0,1,3,1,4,2,2,0,0,1,3,1,2,1,1,0
0,4,2,2,4,0,4,1,4,2,0,2,4,0,4,2,4,2,0,2,4,0,4,2
4,4,1,4,7,6,1,0,4,1,4,4,1,0,1,0,4,1,4,4,1,0,1,0
0,1,3,4,26,2,24,21,1,3,0,4,24,2,22,19,1,3,0,4,22,2,20,17
3,0,0,3,12,8,4,2,0,0,3,3,4,2,2,1,0,0,3,3,2,1,1,0
1,0,3,3,26,7,19,13,0,3,1,3,19,5,14,9,0,3,1,3,14,4,10,7
4,2,1,1,12,10,2,0,2,1,4,1,2,1,1,0,2,1,4,1,1,0,1,0
0,0,3,4,19,1,18,16,0,3,0,4,18,1,17,15,0,3,0,4,17,1,16,14
4,0,4,1,29,26,3,0,0,4,4,1,3,2,1,0,0,4,4,1,1,0,1,0
0,4,0,0,5,0,5,0,4,0,0,0,5,0,5,0,4,0,0,0,5,0,5,0
3,4,0,4,2,1,1,0,4,0,3,4,1,0,1,0,4,0,3,4,1,0,1,0
0,0,3,0,28,2,26,2,0,3,0,0,26,2,24,2,0,3,0,0,24,2,22,2
4,1,1,4,6,5,1,0,1,1,4,4,1,0,1,0,1,1,4,4,1,0,1,0
0,4,2,3,8,0,8,5,4,2,0,3,8,0,8,5,4,2,0,3,8,0,8,5
3,1,3,4,16,11,5,4,1,3,3,4,5,3,2,1,1,3,3,4,2,1,1,0
0,3,4,1,13,1,12,3,3,4,0,1,12,1,11,3,3,4,0,1,11,1,10,3
1,2,4,2,15,4,11,5,2,4,1,2,11,3,8,4,2,4,1,2,8,2,6,3
2,2,1,2,5,2,3,1,2,1,2,2,3,1,2,0,2,1,2,2,2,0,2,1
3,3,2,4,10,6,4,3,3,2,3,4,4,2,2,1,3,2,3,4,2,1,1,0
4,4,1,3,4,3,1,0,4,1,4,3,1,0,1,0,4,1,4,3,1,0,1,0
4,3,4,4,18,16,2,1,3,4,4,4,2,1,1,0,3,4,4,4,1,0,1,0
2,1,2,1,19,9,10,2,1,2,2,1,10,4,6,1,1,2,2,1,6,2,4,1
4,1,2,0,13,11,2,0,1,2,4,0,2,1,1,0,1,2,4,0,1,0,1,0
4,3,2,4,13,11,2,1,3,2,4,4,2,1,1,0,3,2,4,4,1,0,1,0
2,3,1,3,2,0,2,1,3,1,2,3,2,0,2,1,3,1,2,3,2,1,1,0
4,3,4,1,25,22,3,0,3,4,4,1,3,2,1,0,3,4,4,1,1,0,1,0
2,3,1,2,8,4,4,2,3,1,2,2,4,1,3,1,3,1,2,2,3,1,2,1
0,2,0,1,10,0,10,3,2,0,0,1,10,0,10,3,2,0,0,1,10,1,9,2
3,1,2,2,11,7,4,1,1,2,3,2,4,2,2,1,1,2,3,2,2,1,1,0
2,3,3,0,14,7,7,0,3,3,2,0,7,3,4,0,3,3,2,0,4,2,2,0
1,4,3,0,11,3,8,0,4,3,1,0,8,2,6,0,4,3,1,0,6,1,5,0
4,4,0,0,5,4,1,0,4,0,4,0,1,0,1,0,4,0,4,0,1,0,1,0
3,2,2,3,10,7,3,2,2,2,3,3,3,2,1,0,2,2,3,3,1,0,1,0
2,3,1,2,2,0,2,1,3,1,2,2,2,1,1,0,3,1,2,2,1,0,1,0
0,1,1,1,5,0,5,1,1,1,0,1,5,0,5,1,1,1,0,1,5,0,5,1
3,3,2,0,9,6,3,0,3,2,3,0,3,2,1,0,3,2,3,0,1,0,1,0
2,2,1,2,12,5,7,3,2,1,2,2,7,3,4,2,2,1,2,2,4,2,2,0
0,2,2,2,9,0,9,4,2,2,0,2,9,0,9,4,2,2,0,2,9,0,9,4
0,1,0,0,3,0,3,0,1,0,0,0,3,0,3,0,1,0,0,0,3,0,3,0
3,2,3,1,11,7,4,1,2,3,3,1,4,2,2,0,2,3,3,1,2,1,1,0
3,4,4,0,5,3,2,0,4,4,3,0,2,1,1,0,4,4,3,0,1,0,1,0
2,4,4,4,10,5,5,4,4,4,2,4,5,2,3,2,4,4,2,4,3,1,2,1
1,1,0,2,2,0,2,0,1,0,1,2,2,0,2,0,1,0,1,2,2,0,2,1
4,4,3,0,3,2,1,0,4,3,4,0,1,0,1,0,4,3,4,0,1,0,1,0
2,3,4,3,18,9,9,6,3,4,2,3,9,4,5,3,3,4,2,3,5,2,3,2
1,2,4,2,27,8,19,9,2,4,1,2,19,5,14,6,2,4,1,2,14,4,10,5
3,1,0,4,10,6,4,3,1,0,3,4,4,2,2,1,1,0,3,4,2,1,1,0
0,2,0,0,10,0,10,1,2,0,0,0,10,0,10,0,2,0,0,0,10,0,10,0
1,2,1,2,12,3,9,4,2,1,1,2,9,2,7,3,2,1,1,2,7,2,5,2
4,3,3,4,6,5,1,0,3,3,4,4,1,0,1,0,3,3,4,4,1,0,1,0
3,0,0,3,9,6,3,2,0,0,3,3,3,2,1,0,0,0,3,3,1,0,1,0
1,2,2,1,8,2,6,1,2,2,1,1,6,1,5,1,2,2,1,1,5,1,4,1
3,4,3,0,8,5,3,0,4,3,3,0,3,2,1,0,4,3,3,0,1,0,1,0
0,3,0,2,5,0,5,2,3,0,0,2,5,0,5,2,3,0,0,2,5,0,5,2
1,0,3,2,24,7,17,8,0,3,1,2,17,5,12,6,0,3,1,2,12,3,9,4
1,1,2,3,23,6,17,11,1,2,1,3,17,5,12,8,1,2,1,3,12,3,9,6
3,1,3,1,23,16,7,2,1,3,3,1,7,4,3,0,1,3,3,1,3,2,1,0
3,4,2,1,10,6,4,1,4,2,3,1,4,2,2,0,4,2,3,1,2,1,1,0
1,0,0,1,16,4,12,3,0,0,1,1,12,3,9,2,0,0,1,1,9,2,7,2
1,4,1,1,3,0,3,0,4,1,1,1,3,0,3,0,4,1,1,1,3,0,3,0
1,4,4,0,12,3,9,0,4,4,1,0,9,2,7,0,4,4,1,0,7,2,5,0
3,4,3,4,11,7,4,3,4,3,3,4,4,2,2,1,4,3,3,4,2,1,1,0
0,2,2,2,9,0,9,4,2,2,0,2,9,0,9,4,2,2,0,2,9,0,9,4
1,1,3,1,26,7,19,5,1,3,1,1,19,5,14,4,1,3,1,1,14,4,10,2
3,4,2,1,1,0,1,0,4,2,3,1,1,0,1,0,4,2,3,1,1,0,1,0
4,3,3,3,14,12,2,1,3,3,4,3,2,1,1,0,3,3,4,3,1,0,1,0
4,3,1,2,8,7,1,0,3,1,4,2,1,0,1,0,3,1,4,2,1,0,1,0
0,2,0,0,10,0,10,1,2,0,0,0,10,1,9,0,2,0,0,0,9,0,9,0
4,1,2,2,28,25,3,1,1,2,4,2,3,2,1,0,1,2,4,2,1,0,1,0
0,0,2,2,27,2,25,12,0,2,0,2,25,2,23,11,0,2,0,2,23,2,21,10
1,2,2,0,15,4,11,1,2,2,1,0,11,3,8,0,2,2,1,0,8,2,6,0
4,3,4,1,17,15,2,0,3,4,4,1,2,1,1,0,3,4,4,1,1,0,1,0
3,3,3,1,14,9,5,1,3,3,3,1,5,3,2,0,3,3,3,1,2,1,1,0
1,2,2,4,14,4,10,8,2,2,1,4,10,3,7,6,2,2,1,4,7,2,5,4
1,1,4,2,23,6,17,8,1,4,1,2,17,5,12,6,1,4,1,2,12,3,9,4
4,0,4,1,25,22,3,0,0,4,4,1,3,2,1,0,0,4,4,1,1,0,1,0
1,3,4,2,15,4,11,5,3,4,1,2,11,3,8,3,3,4,1,2,8,2,6,3
2,0,3,4,27,13,14,12,0,3,2,4,14,7,7,6,0,3,2,4,7,3,4,3
2,1,0,3,3,1,2,1,1,0,2,3,2,0,2,1,1,0,2,3,2,1,1,0
4,4,4,1,1,0,1,0,4,4,4,1,1,0,1,0,4,4,4,1,1,0,1,0
0,3,3,1,17,1,16,4,3,3,0,1,16,1,15,4,3,3,0,1,15,1,14,4
4,3,4,0,12,10,2,0,3,4,4,0,2,1,1,0,3,4,4,0,1,0,1,0
4,0,0,2,13,11,2,0,0,0,4,2,2,1,1,0,0,0,4,2,1,0,1,0
2,2,2,4,21,10,11,9,2,2,2,4,11,5,6,5,2,2,2,4,6,2,4,3
1,0,3,4,25,7,18,16,0,3,1,4,18,5,13,11,0,3,1,4,13,3,10,9
4,4,0,1,10,9,1,0,4,0,4,1,1,0,1,0,4,0,4,1,1,0,1,0
2,2,0,2,1,0,1,0,2,0,2,2,1,0,1,0,2,0,2,2,1,0,1,0
4,3,0,1,5,4,1,0,3,0,4,1,1,0,1,0,3,0,4,1,1,0,1,0
4,3,3,3,18,16,2,1,3,3,4,3,2,1,1,0,3,3,4,3,1,0,1,0
4,0,1,0,17,15,2,0,0,1,4,0,2,1,1,0,0,1,4,0,1,0,1,0
0,2,2,1,14,1,13,3,2,2,0,1,13,1,12,3,2,2,0,1,12,1,11,3
3,2,0,3,2,1,1,0,2,0,3,3,1,0,1,0,2,0,3,3,1,0,1,0
0,2,0,3,7,0,7,4,2,0,0,3,7,0,7,4,2,0,0,3,7,0,7,4
1,4,3,2,2,0,2,0,4,3,1,2,2,0,2,1,4,3,1,2,2,0,2,0
2,1,2,2,17,8,9,4,1,2,2,2,9,4,5,2,1,2,2,2,5,2,3,1
0,3,2,1,12,1,11,3,3,2,0,1,11,1,10,3,3,2,0,1,10,1,9,2
2,4,3,3,13,6,7,4,4,3,2,3,7,3,4,2,4,3,2,3,4,1,3,2
0,0,4,4,28,2,26,23,0,4,0,4,26,2,24,21,0,4,0,4,24,2,22,19
2,0,3,1,28,13,15,4,0,3,2,1,15,7,8,2,0,3,2,1,8,3,5,1
0,4,1,0,5,0,5,0,4,1,0,0,5,0,5,0,4,1,0,0,5,0,5,0
3,2,3,0,19,13,6,0,2,3,3,0,6,4,2,0,2,3,3,0,2,1,1,0
1,2,4,1,17,5,12,3,2,4,1,1,12,3,9,2,2,4,1,1,9,2,7,2
4,3,1,1,1,0,1,0,3,1,4,1,1,0,1,0,3,1,4,1,1,0,1,0
4,4,3,2,5,4,1,0,4,3,4,2,1,0,1,0,4,3,4,2,1,0,1,0
2,4,4,0,11,5,6,0,4,4,2,0,6,2,4,0,4,4,2,0,4,2,2,0
3,1,1,2,9,6,3,1,1,1,3,2,3,2,1,0,1,1,3,2,1,0,1,0
1,1,0,3,3,0,3,2,1,0,1,3,3,0,3,2,1,0,1,3,3,0,3,2
4,0,2,0,21,18,3,0,0,2,4,0,3,2,1,0,0,2,4,0,1,0,1,0
3,2,1,1,11,7,4,1,2,1,3,1,4,2,2,0,2,1,3,1,2,1,1,0
4,0,4,2,28,25,3,1,0,4,4,2,3,2,1,0,0,4,4,2,1,0,1,0
2,0,2,0,25,12,13,1,0,2,2,0,13,6,7,0,0,2,2,0,7,3,4,0
0,4,2,1,8,0,8,2,4,2,0,1,8,0,8,2,4,2,0,1,8,0,8,2
0,3,0,1,7,0,7,2,3,0,0,1,7,0,7,2,3,0,0,1,7,0,7,2
0,1,2,1,19,1,18,5,1,2,0,1,18,1,17,5,1,2,0,1,17,1,16,4
1,0,3,1,28,8,20,5,0,3,1,1,20,5,15,4,0,3,1,1,15,4,11,3
1,2,0,3,1,0,1,0,2,0,1,3,1,0,1,0,2,0,1,3,1,0,1,0
2,4,3,3,2,1,1,0,4,3,2,3,1,0,1,0,4,3,2,3,1,0,1,0
0,2,2,3,15,1,14,9,2,2,0,3,14,1,13,9,2,2,0,3,13,1,12,8
1,1,1,0,3,0,3,0,1,1,1,0,3,0,3,0,1,1,1,0,3,0,3,0
0,3,2,1,5,0,5,1,3,2,0,1,5,0,5,1,3,2,0,1,5,0,5,1
1,2,1,0,9,2,7,0,2,1,1,0,7,2,5,0,2,1,1,0,5,1,4,0
2,4,4,3,12,6,6,4,4,4,2,3,6,3,3,2,4,4,2,3,3,1,2,1
2,1,0,3,10,4,6,4,1,0,2,3,6,3,3,2,1,0,2,3,3,1,2,1
2,3,2,2,11,5,6,3,3,2,2,2,6,3,3,1,3,2,2,2,3,1,2,0
4,4,0,3,5,4,1,0,4,0,4,3,1,0,1,0,4,0,4,3,1,0,1,0
2,3,4,2,13,6,7,3,3,4,2,2,7,3,4,1,3,4,2,2,4,2,2,1
3,2,3,0,20,13,7,0,2,3,3,0,7,4,3,0,2,3,3,0,3,2,1,0
0,2,1,3,13,1,12,8,2,1,0,3,12,1,11,7,2,1,0,3,11,1,10,7
4,0,0,4,4,3,1,0,0,0,4,4,1,0,1,0,0,0,4,4,1,0,1,0
3,4,2,2,3,2,1,0,4,2,3,2,1,0,1,0,4,2,3,2,1,0,1,0
2,0,2,3,13,6,7,4,0,2,2,3,7,3,4,2,0,2,2,3,4,1,3,2
2,0,2,4,16,7,9,8,0,2,2,4,9,4,5,4,0,2,2,4,5,2,3,2
2,4,0,1,5,2,3,0,4,0,2,1,3,1,2,0,4,0,2,1,2,0,2,0
2,3,2,2,15,7,8,3,3,2,2,2,8,4,4,2,3,2,2,2,4,2,2,0
2,0,1,1,14,6,8,2,0,1,2,1,8,3,5,1,0,1,2,1,5,2,3,0
3,1,3,0,26,18,8,0,1,3,3,0,8,5,3,0,1,3,3,0,3,2,1,0
0,1,1,4,5,0,5,4,1,1,0,4,5,0,5,4,1,1,0,4,5,0,5,4
0,1,4,3,24,2,22,15,1,4,0,3,22,2,20,13,1,4,0,3,20,2,18,12
0,1,3,2,21,2,19,9,1,3,0,2,19,1,18,9,1,3,0,2,18,1,17,8
3,2,1,0,21,14,7,0,2,1,3,0,7,4,3,0,2,1,3,0,3,2,1,0
0,2,0,3,3,0,3,2,2,0,0,3,3,0,3,2,2,0,0,3,3,0,3,2
0,1,0,0,9,0,9,0,1,0,0,0,9,0,9,0,1,0,0,0,9,0,9,0
4,0,3,4,21,18,3,2,0,3,4,4,3,2,1,0,0,3,4,4,1,0,1,0
2,0,0,2,17,8,9,4,0,0,2,2,9,4,5,2,0,0,2,2,5,2,3,1
4,3,4,0,12,10,2,0,3,4,4,0,2,1,1,0,3,4,4,0,1,0,1,0
2,1,0,1,10,5,5,1,1,0,2,1,5,2,3,0,1,0,2,1,3,1,2,0
1,4,0,2,4,1,3,1,4,0,1,2,3,0,3,1,4,0,1,2,3,0,3,1
1,2,2,4,13,3,10,9,2,2,1,4,10,3,7,6,2,2,1,4,7,2,5,4
2,3,2,0,18,9,9,0,3,2,2,0,9,4,5,0,3,2,2,0,5,2,3,0
2,4,3,4,0,0,0,0,4,3,2,4,0,0,0,0,4,3,2,4,0,0,0,0
4,3,4,3,17,15,2,1,3,4,4,3,2,1,1,0,3,4,4,3,1,0,1,0
3,4,3,3,2,1,1,0,4,3,3,3,1,0,1,0,4,3,3,3,1,0,1,0
0,1,4,4,25,2,23,20,1,4,0,4,23,2,21,18,1,4,0,4,21,2,19,17
2,3,1,4,13,6,7,6,3,1,2,4,7,3,4,3,3,1,2,4,4,2,2,1
3,0,3,4,27,18,9,8,0,3,3,4,9,6,3,2,0,3,3,4,3,2,1,0
3,4,4,3,12,8,4,2,4,4,3,3,4,2,2,1,4,4,3,3,2,1,1,0
3,1,2,2,20,13,7,3,1,2,3,2,7,4,3,1,1,2,3,2,3,2,1,0
2,2,2,2,6,2,4,1,2,2,2,2,4,2,2,1,2,2,2,2,2,1,1,0
4,4,1,0,7,6,1,0,4,1,4,0,1,0,1,0,4,1,4,0,1,0,1,0
2,0,2,3,22,11,11,7,0,2,2,3,11,5,6,4,0,2,2,3,6,3,3,2
1,4,4,2,13,3,10,5,4,4,1,2,10,3,7,3,4,4,1,2,7,2,5,2
0,1,4,3,28,2,26,18,1,4,0,3,26,2,24,16,1,4,0,3,24,2,22,15
3,0,4,0,25,17,8,0,0,4,3,0,8,5,3,0,0,4,3,0,3,2,1,0
1,0,2,0,19,5,14,1,0,2,1,0,14,4,10,1,0,2,1,0,10,2,8,0
3,3,4,0,11,7,4,0,3,4,3,0,4,2,2,0,3,4,3,0,2,1,1,0
0,4,3,1,7,0,7,2,4,3,0,1,7,0,7,2,4,3,0,1,7,0,7,2
0,3,4,2,8,0,8,3,3,4,0,2,8,0,8,4,3,4,0,2,8,0,8,4
2,0,3,2,28,13,15,7,0,3,2,2,15,7,8,4,0,3,2,2,8,3,5,2
3,0,0,1,0,0,0,0,0,0,3,1,0,0,0,0,0,0,3,1,0,0,0,0
4,4,4,3,7,6,1,0,4,4,4,3,1,0,1,0,4,4,4,3,1,0,1,0
0,2,1,4,7,0,7,6,2,1,0,4,7,0,7,6,2,1,0,4,7,0,7,6
2,2,2,3,12,6,6,4,2,2,2,3,6,2,4,2,2,2,2,3,4,1,3,2
3,3,1,1,7,4,3,0,3,1,3,1,3,2,1,0,3,1,3,1,1,0,1,0
1,1,2,0,17,5,12,1,1,2,1,0,12,3,9,0,1,2,1,0,9,2,7,0
0,3,2,4,2,0,2,1,3,2,0,4,2,0,2,1,3,2,0,4,2,0,2,1
4,1,2,4,13,11,2,1,1,2,4,4,2,1,1,0,1,2,4,4,1,0,1,0
0,1,0,2,2,0,2,0,1,0,0,2,2,0,2,1,1,0,0,2,2,0,2,1
2,0,0,1,19,9,10,2,0,0,2,1,10,4,6,1,0,0,2,1,6,3,3,0
1,1,4,1,26,7,19,5,1,4,1,1,19,5,14,4,1,4,1,1,14,4,10,2
1,0,2,4,26,7,19,17,0,2,1,4,19,5,14,12,0,2,1,4,14,4,10,8
2,2,4,2,21,10,11,5,2,4,2,2,11,5,6,3,2,4,2,2,6,3,3,1
3,2,1,2,9,6,3,1,2,1,3,2,3,2,1,0,2,1,3,2,1,0,1,0
1,1,4,3,28,8,20,13,1,4,1,3,20,5,15,10,1,4,1,3,15,4,11,7
0,2,1,4,15,1,14,12,2,1,0,4,14,1,13,11,2,1,0,4,13,1,12,10
2,2,4,2,24,11,13,6,2,4,2,2,13,6,7,3,2,4,2,2,7,3,4,2
1,0,2,1,28,8,20,5,0,2,1,1,20,5,15,4,0,2,1,1,15,4,11,3
0,0,2,4,21,2,19,17,0,2,0,4,19,1,18,16,0,2,0,4,18,1,17,15
1,1,2,3,21,6,15,10,1,2,1,3,15,4,11,7,1,2,1,3,11,3,8,5
3,4,0,4,6,4,2,1,4,0,3,4,2,1,1,0,4,0,3,4,1,0,1,0
2,2,1,2,13,6,7,3,2,1,2,2,7,3,4,2,2,1,2,2,4,1,3,1
1,2,4,2,20,5,15,7,2,4,1,2,15,4,11,5,2,4,1,2,11,3,8,3
3,0,3,4,28,19,9,8,0,3,3,4,9,6,3,2,0,3,3,4,3,2,1,0
4,3,1,4,12,10,2,1,3,1,4,4,2,1,1,0,3,1,4,4,1,0,1,0
3,4,1,2,9,6,3,1,4,1,3,2,3,2,1,0,4,1,3,2,1,0,1,0
2,4,2,4,2,1,1,0,4,2,2,4,1,0,1,0,4,2,2,4,1,0,1,0
0,1,4,1,25,2,23,6,1,4,0,1,23,2,21,6,1,4,0,1,21,2,19,5
1,4,0,1,2,0,2,0,4,0,1,1,2,0,2,0,4,0,1,1,2,0,2,0
3,1,0,4,9,6,3,2,1,0,3,4,3,2,1,0,1,0,3,4,1,0,1,0
4,1,0,0,5,4,1,0,1,0,4,0,1,0,1,0,1,0,4,0,1,0,1,0
1,2,3,1,17,5,12,3,2,3,1,1,12,3,9,2,2,3,1,1,9,2,7,2
0,4,3,0,3,0,3,0,4,3,0,0,3,0,3,0,4,3,0,0,3,0,3,0
3,4,4,3,1,0,1,0,4,4,3,3,1,0,1,0,4,4,3,3,1,0,1,0
4,3,4,4,18,16,2,1,3,4,4,4,2,1,1,0,3,4,4,4,1,0,1,0
4,2,1,3,10,9,1,0,2,1,4,3,1,0,1,0,2,1,4,3,1,0,1,0
4,4,4,1,4,3,1,0,4,4,4,1,1,0,1,0,4,4,4,1,1,0,1,0
3,0,3,4,23,16,7,6,0,3,3,4,7,4,3,2,0,3,3,4,3,2,1,0
0,4,2,1,8,0,8,2,4,2,0,1,8,0,8,2,4,2,0,1,8,0,8,2
2,3,0,1,6,3,3,0,3,0,2,1,3,1,2,0,3,0,2,1,2,0,2,0
2,1,1,4,16,8,8,7,1,1,2,4,8,4,4,3,1,1,2,4,4,1,3,2
2,4,3,3,6,3,3,2,4,3,2,3,3,1,2,1,4,3,2,3,2,1,1,0
0,4,0,0,7,0,7,0,4,0,0,0,7,0,7,0,4,0,0,0,7,0,7,0
3,4,4,0,13,9,4,0,4,4,3,0,4,2,2,0,4,4,3,0,2,1,1,0
2,0,0,3,11,5,6,4,0,0,2,3,6,3,3,2,0,0,2,3,3,1,2,1
4,0,1,3,19,17,2,1,0,1,4,3,2,1,1,0,0,1,4,3,1,0,1,0
4,2,2,2,23,20,3,1,2,2,4,2,3,2,1,0,2,2,4,2,1,0,1,0
0,3,3,3,20,2,18,12,3,3,0,3,18,1,17,11,3,3,0,3,17,1,16,11
2,0,0,0,0,0,0,0,0,0,2,0,0,0,0,0,0,0,2,0,0,0,0,0
4,0,3,1,27,24,3,0,0,3,4,1,3,2,1,0,0,3,4,1,1,0,1,0
4,1,1,4,14,12,2,1,1,1,4,4,2,1,1,0,1,1,4,4,1,0,1,0
1,0,4,1,26,7,19,5,0,4,1,1,19,5,14,4,0,4,1,1,14,4,10,2
3,3,3,2,12,8,4,1,3,3,3,2,4,2,2,0,3,3,3,2,2,1,1,0
1,0,1,4,20,5,15,13,0,1,1,4,15,4,11,9,0,1,1,4,11,3,8,7
4,3,2,0,7,6,1,0,3,2,4,0,1,0,1,0,3,2,4,0,1,0,1,0
3,2,3,3,22,15,7,4,2,3,3,3,7,4,3,2,2,3,3,3,3,2,1,0
0,3,2,0,3,0,3,0,3,2,0,0,3,0,3,0,3,2,0,0,3,0,3,0
0,0,0,1,1,0,1,0,0,0,0,1,1,0,1,0,0,0,0,1,1,0,1,0
1,3,3,0,11,3,8,0,3,3,1,0,8,2,6,0,3,3,1,0,6,1,5,0
3,0,0,1,11,7,4,1,0,0,3,1,4,2,2,0,0,0,3,1,2,1,1,0
1,2,3,2,24,7,17,8,2,3,1,2,17,5,12,5,2,3,1,2,12,3,9,4
4,0,2,4,15,13,2,1,0,2,4,4,2,1,1,0,0,2,4,4,1,0,1,0
2,1,1,1,10,5,5,1,1,1,2,1,5,2,3,0,1,1,2,1,3,1,2,0
1,0,3,2,24,7,17,8,0,3,1,2,17,5,12,6,0,3,1,2,12,3,9,4
1,0,2,3,20,5,15,10,0,2,1,3,15,4,11,7,0,2,1,3,11,3,8,5
2,2,0,0,9,4,5,0,2,0,2,0,5,2,3,0,2,0,2,0,3,1,2,0
1,3,2,4,7,2,5,4,3,2,1,4,5,1,4,3,3,2,1,4,4,1,3,2
0,3,3,3,14,1,13,9,3,3,0,3,13,1,12,8,3,3,0,3,12,1,11,7
3,1,1,4,9,6,3,2,1,1,3,4,3,2,1,0,1,1,3,4,1,0,1,0
0,3,0,4,6,0,6,5,3,0,0,4,6,0,6,5,3,0,0,4,6,0,6,5
3,3,1,1,16,11,5,1,3,1,3,1,5,3,2,0,3,1,3,1,2,1,1,0
1,2,4,0,27,8,19,1,2,4,1,0,19,5,14,1,2,4,1,0,14,4,10,0
0,4,3,2,2,0,2,0,4,3,0,2,2,0,2,0,4,3,0,2,2,0,2,0
4,2,0,4,13,11,2,1,2,0,4,4,2,1,1,0,2,0,4,4,1,0,1,0
0,3,4,3,15,1,14,9,3,4,0,3,14,1,13,9,3,4,0,3,13,1,12,8
4,2,1,4,17,15,2,1,2,1,4,4,2,1,1,0,2,1,4,4,1,0,1,0
0,4,0,1,5,0,5,1,4,0,0,1,5,0,5,1,4,0,0,1,5,0,5,1
3,1,4,0,19,13,6,0,1,4,3,0,6,4,2,0,1,4,3,0,2,1,1,0
3,2,0,4,10,7,3,2,2,0,3,4,3,2,1,0,2,0,3,4,1,0,1,0
2,0,1,4,12,6,6,5,0,1,2,4,6,2,4,3,0,1,2,4,4,1,3,2
2,2,4,0,20,9,11,1,2,4,2,0,11,5,6,0,2,4,2,0,6,3,3,0
4,0,4,0,29,26,3,0,0,4,4,0,3,2,1,0,0,4,4,0,1,0,1,0
3,3,2,2,3,2,1,0,3,2,3,2,1,0,1,0,3,2,3,2,1,0,1,0
3,3,1,0,7,4,3,0,3,1,3,0,3,2,1,0,3,1,3,0,1,0,1,0
0,2,3,1,20,2,18,5,2,3,0,1,18,1,17,5,2,3,0,1,17,1,16,4
4,4,3,4,4,3,1,0,4,3,4,4,1,0,1,0,4,3,4,4,1,0,1,0
0,4,0,3,0,0,0,0,4,0,0,3,0,0,0,0,4,0,0,3,0,0,0,0
0,4,1,4,10,0,10,8,4,1,0,4,10,1,9,8,4,1,0,4,9,0,9,8
0,3,2,1,4,0,4,1,3,2,0,1,4,0,4,1,3,2,0,1,4,0,4,1
0,3,2,0,18,1,17,1,3,2,0,0,17,1,16,1,3,2,0,0,16,1,15,1
0,2,2,1,21,2,19,5,2,2,0,1,19,1,18,5,2,2,0,1,18,1,17,5
3,1,4,4,26,18,8,7,1,4,3,4,8,5,3,2,1,4,3,4,3,2,1,0
3,2,3,0,17,11,6,0,2,3,3,0,6,4,2,0,2,3,3,0,2,1,1,0
2,1,0,0,10,4,6,0,1,0,2,0,6,3,3,0,1,0,2,0,3,1,2,0
1,1,1,3,12,3,9,6,1,1,1,3,9,2,7,4,1,1,1,3,7,2,5,3
0,1,3,2,23,2,21,10,1,3,0,2,21,2,19,9,1,3,0,2,19,1,18,9
2,0,2,2,26,13,13,6,0,2,2,2,13,6,7,3,0,2,2,2,7,3,4,2
2,0,4,4,29,14,15,13,0,4,2,4,15,7,8,7,0,4,2,4,8,4,4,3
2,3,0,2,0,0,0,0,3,0,2,2,0,0,0,0,3,0,2,2,0,0,0,0
3,4,1,4,5,3,2,1,4,1,3,4,2,1,1,0,4,1,3,4,1,0,1,0
2,1,0,2,7,3,4,2,1,0,2,2,4,1,3,1,1,0,2,2,3,1,2,0
4,2,2,2,9,8,1,0,2,2,4,2,1,0,1,0,2,2,4,2,1,0,1,0
1,4,4,3,3,0,3,2,4,4,1,3,3,0,3,2,4,4,1,3,3,0,3,2
0,0,3,4,21,2,19,17,0,3,0,4,19,1,18,16,0,3,0,4,18,1,17,15
3,2,1,1,10,7,3,0,2,1,3,1,3,2,1,0,2,1,3,1,1,0,1,0
4,2,3,0,22,19,3,0,2,3,4,0,3,2,1,0,2,3,4,0,1,0,1,0
3,0,0,1,2,1,1,0,0,0,3,1,1,0,1,0,0,0,3,1,1,0,1,0
1,2,4,2,24,7,17,8,2,4,1,2,17,5,12,5,2,4,1,2,12,3,9,4
2,2,2,3,5,2,3,2,2,2,2,3,3,1,2,1,2,2,2,3,2,1,1,0
1,2,2,3,15,4,11,7,2,2,1,3,11,3,8,5,2,2,1,3,8,2,6,4
3,3,2,4,9,6,3,2,3,2,3,4,3,2,1,0,3,2,3,4,1,0,1,0
1,2,4,2,26,7,19,9,2,4,1,2,19,5,14,6,2,4,1,2,14,4,10,4
1,1,4,1,27,8,19,5,1,4,1,1,19,5,14,4,1,4,1,1,14,4,10,2
3,1,3,1,17,11,6,1,1,3,3,1,6,4,2,0,1,3,3,1,2,1,1,0
0,3,3,3,12,1,11,7,3,3,0,3,11,1,10,6,3,3,0,3,10,1,9,6
2,2,4,2,25,12,13,6,2,4,2,2,13,6,7,3,2,4,2,2,7,3,4,2
3,0,0,4,10,6,4,3,0,0,3,4,4,2,2,1,0,0,3,4,2,1,1,0
4,4,3,2,6,5,1,0,4,3,4,2,1,0,1,0,4,3,4,2,1,0,1,0
0,0,1,0,13,1,12,1,0,1,0,0,12,1,11,1,0,1,0,0,11,1,10,1
3,2,3,2,21,14,7,3,2,3,3,2,7,4,3,1,2,3,3,2,3,2,1,0
0,0,0,1,4,0,4,1,0,0,0,1,4,0,4,1,0,0,0,1,4,0,4,1
4,2,2,1,13,11,2,0,2,2,4,1,2,1,1,0,2,2,4,1,1,0,1,0
1,3,4,1,18,5,13,3,3,4,1,1,13,3,10,3,3,4,1,1,10,3,7,2
0,1,2,3,15,1,14,9,1,2,0,3,14,1,13,9,1,2,0,3,13,1,12,8
1,1,3,0,22,6,16,1,1,3,1,0,16,4,12,1,1,3,1,0,12,3,9,0
2,0,2,4,20,9,11,9,0,2,2,4,11,5,6,5,0,2,2,4,6,2,4,3
4,1,1,4,14,12,2,1,1,1,4,4,2,1,1,0,1,1,4,4,1,0,1,0
1,1,0,2,4,1,3,1,1,0,1,2,3,0,3,1,1,0,1,2,3,0,3,1
1,1,0,0,6,1,5,0,1,0,1,0,5,1,4,0,1,0,1,0,4,1,3,0
3,2,0,4,1,0,1,0,2,0,3,4,1,0,1,0,2,0,3,4,1,0,1,0
0,1,2,1,12,1,11,3,1,2,0,1,11,1,10,3,1,2,0,1,10,1,9,2
2,1,4,1,21,10,11,3,1,4,2,1,11,5,6,1,1,4,2,1,6,2,4,1
4,3,1,1,3,2,1,0,3,1,4,1,1,0,1,0,3,1,4,1,1,0,1,0
4,1,4,1,28,25,3,0,1,4,4,1,3,2,1,0,1,4,4,1,1,0,1,0
3,2,2,4,1,0,1,0,2,2,3,4,1,0,1,0,2,2,3,4,1,0,1,0
2,3,1,4,6,3,3,2,3,1,2,4,3,1,2,1,3,1,2,4,2,0,2,1
3,2,4,4,19,13,6,5,2,4,3,4,6,4,2,1,2,4,3,4,2,1,1,0
3,2,2,1,10,7,3,0,2,2,3,1,3,2,1,0,2,2,3,1,1,0,1,0
4,3,4,1,13,11,2,0,3,4,4,1,2,1,1,0,3,4,4,1,1,0,1,0
3,0,0,4,8,5,3,2,0,0,3,4,3,2,1,0,0,0,3,4,1,0,1,0
4,4,0,1,6,5,1,0,4,0,4,1,1,0,1,0,4,0,4,1,1,0,1,0
4,4,4,0,9,8,1,0,4,4,4,0,1,0,1,0,4,4,4,0,1,0,1,0
0,3,1,2,8,0,8,3,3,1,0,2,8,0,8,3,3,1,0,2,8,0,8,4
4,1,3,0,24,21,3,0,1,3,4,0,3,2,1,0,1,3,4,0,1,0,1,0
2,0,3,0,25,12,13,1,0,3,2,0,13,6,7,0,0,3,2,0,7,3,4,0
4,0,0,3,7,6,1,0,0,0,4,3,1,0,1,0,0,0,4,3,1,0,1,0
1,4,4,3,14,4,10,7,4,4,1,3,10,3,7,4,4,4,1,3,7,2,5,3
2,2,3,0,17,8,9,0,2,3,2,0,9,4,5,0,2,3,2,0,5,2,3,0
3,2,0,4,6,4,2,1,2,0,3,4,2,1,1,0,2,0,3,4,1,0,1,0
2,1,3,2,27,13,14,7,1,3,2,2,14,7,7,3,1,3,2,2,7,3,4,2
3,3,4,0,10,6,4,0,3,4,3,0,4,2,2,0,3,4,3,0,2,1,1,0
2,3,4,1,11,5,6,1,3,4,2,1,6,3,3,0,3,4,2,1,3,1,2,0
3,0,3,4,29,20,9,8,0,3,3,4,9,6,3,2,0,3,3,4,3,2,1,0
0,0,4,1,25,2,23,6,0,4,0,1,23,2,21,6,0,4,0,1,21,2,19,5
1,3,4,4,15,4,11,9,3,4,1,4,11,3,8,7,3,4,1,4,8,2,6,5
3,4,2,3,2,1,1,0,4,2,3,3,1,0,1,0,4,2,3,3,1,0,1,0
3,0,0,1,1,0,1,0,0,0,3,1,1,0,1,0,0,0,3,1,1,0,1,0
1,1,4,0,19,5,14,1,1,4,1,0,14,4,10,0,1,4,1,0,10,2,8,0
1,4,2,2,0,0,0,0,4,2,1,2,0,0,0,0,4,2,1,2,0,0,0,0
3,4,4,3,10,6,4,2,4,4,3,3,4,2,2,1,4,4,3,3,2,1,1,0
0,3,3,0,19,1,18,1,3,3,0,0,18,1,17,1,3,3,0,0,17,1,16,1
0,2,4,2,18,1,17,8,2,4,0,2,17,1,16,7,2,4,0,2,16,1,15,7
1,2,4,4,24,7,17,15,2,4,1,4,17,5,12,10,2,4,1,4,12,3,9,8
1,2,3,1,16,4,12,3,2,3,1,1,12,3,9,2,2,3,1,1,9,2,7,2
1,2,0,1,4,1,3,0,2,0,1,1,3,0,3,0,2,0,1,1,3,0,3,0
1,3,1,1,0,0,0,0,3,1,1,1,0,0,0,0,3,1,1,1,0,0,0,0
3,4,1,1,9,6,3,0,4,1,3,1,3,2,1,0,4,1,3,1,1,0,1,0
2,2,1,2,4,1,3,1,2,1,2,2,3,1,2,1,2,1,2,2,2,0,2,1
3,4,2,3,1,0,1,0,4,2,3,3,1,0,1,0,4,2,3,3,1,0,1,0
3,4,2,2,3,2,1,0,4,2,3,2,1,0,1,0,4,2,3,2,1,0,1,0
0,2,4,3,23,2,21,14,2,4,0,3,21,2,19,13,2,4,0,3,19,1,18,12
0,2,3,4,21,2,19,17,2,3,0,4,19,1,18,16,2,3,0,4,18,1,17,15
1,1,0,3,11,3,8,5,1,0,1,3,8,2,6,4,1,0,1,3,6,1,5,3
0,0,1,1,16,1,15,4,0,1,0,1,15,1,14,4,0,1,0,1,14,1,13,3
3,3,2,1,9,6,3,0,3,2,3,1,3,2,1,0,3,2,3,1,1,0,1,0
1,0,0,2,13,3,10,5,0,0,1,2,10,3,7,3,0,0,1,2,7,2,5,2
3,3,3,0,14,9,5,0,3,3,3,0,5,3,2,0,3,3,3,0,2,1,1,0
1,4,2,2,8,2,6,3,4,2,1,2,6,1,5,2,4,2,1,2,5,1,4,2
2,4,0,3,3,1,2,1,4,0,2,3,2,0,2,1,4,0,2,3,2,1,1,0
1,1,0,0,3,0,3,0,1,0,1,0,3,0,3,0,1,0,1,0,3,0,3,0
1,2,2,4,10,3,7,6,2,2,1,4,7,2,5,4,2,2,1,4,5,1,4,3
2,3,0,1,4,1,3,0,3,0,2,1,3,1,2,0,3,0,2,1,2,0,2,0
2,3,1,3,9,4,5,3,3,1,2,3,5,2,3,2,3,1,2,3,3,1,2,1
0,3,1,1,7,0,7,2,3,1,0,1,7,0,7,2,3,1,0,1,7,0,7,2
2,4,2,4,8,4,4,3,4,2,2,4,4,2,2,1,4,2,2,4,2,1,1,0
0,2,4,2,24,2,22,10,2,4,0,2,22,2,20,10,2,4,0,2,20,2,18,8
0,4,2,3,2,0,2,1,4,2,0,3,2,0,2,1,4,2,0,3,2,0,2,1
3,1,0,2,15,10,5,2,1,0,3,2,5,3,2,1,1,0,3,2,2,1,1,0
1,3,0,0,8,2,6,0,3,0,1,0,6,1,5,0,3,0,1,0,5,1,4,0
3,1,2,3,15,10,5,3,1,2,3,3,5,3,2,1,1,2,3,3,2,1,1,0
3,3,0,0,4,2,2,0,3,0,3,0,2,1,1,0,3,0,3,0,1,0,1,0
1,2,2,2,24,7,17,8,2,2,1,2,17,5,12,5,2,2,1,2,12,3,9,4
4,4,4,4,4,3,1,0,4,4,4,4,1,0,1,0,4,4,4,4,1,0,1,0
2,0,4,4,28,14,14,12,0,4,2,4,14,7,7,6,0,4,2,4,7,3,4,3
4,2,1,4,7,6,1,0,2,1,4,4,1,0,1,0,2,1,4,4,1,0,1,0
4,3,1,4,3,2,1,0,3,1,4,4,1,0,1,0,3,1,4,4,1,0,1,0
3,1,2,0,21,14,7,0,1,2,3,0,7,4,3,0,1,2,3,0,3,2,1,0
1,2,3,0,18,5,13,1,2,3,1,0,13,3,10,1,2,3,1,0,10,3,7,0
4,4,1,2,2,1,1,0,4,1,4,2,1,0,1,0,4,1,4,2,1,0,1,0
4,4,3,2,6,5,1,0,4,3,4,2,1,0,1,0,4,3,4,2,1,0,1,0
2,0,1,2,21,10,11,5,0,1,2,2,11,5,6,2,0,1,2,2,6,3,3,1
0,3,2,2,10,1,9,4,3,2,0,2,9,0,9,4,3,2,0,2,9,0,9,4
3,2,4,1,21,14,7,2,2,4,3,1,7,4,3,0,2,4,3,1,3,2,1,0
2,4,3,3,1,0,1,0,4,3,2,3,1,0,1,0,4,3,2,3,1,0,1,0
3,4,2,2,0,0,0,0,4,2,3,2,0,0,0,0,4,2,3,2,0,0,0,0
1,3,1,2,5,1,4,1,3,1,1,2,4,1,3,1,3,1,1,2,3,0,3,1
1,2,4,4,19,5,14,12,2,4,1,4,14,4,10,9,2,4,1,4,10,3,7,6
0,3,4,0,14,1,13,1,3,4,0,0,13,1,12,1,3,4,0,0,12,1,11,1
2,3,1,0,9,4,5,0,3,1,2,0,5,2,3,0,3,1,2,0,3,1,2,0
3,2,0,4,2,1,1,0,2,0,3,4,1,0,1,0,2,0,3,4,1,0,1,0
1,0,1,0,12,3,9,0,0,1,1,0,9,2,7,0,0,1,1,0,7,2,5,0
1,2,3,0,9,2,7,0,2,3,1,0,7,2,5,0,2,3,1,0,5,1,4,0
3,1,4,3,26,18,8,5,1,4,3,3,8,5,3,2,1,4,3,3,3,2,1,0
2,4,3,3,0,0,0,0,4,3,2,3,0,0,0,0,4,3,2,3,0,0,0,0
2,2,3,4,17,8,9,8,2,3,2,4,9,4,5,4,2,3,2,4,5,2,3,2
1,0,0,3,10,2,8,5,0,0,1,3,8,2,6,4,0,0,1,3,6,1,5,3
4,1,4,2,20,18,2,1,1,4,4,2,2,1,1,0,1,4,4,2,1,0,1,0
2,2,0,1,5,2,3,0,2,0,2,1,3,1,2,0,2,0,2,1,2,0,2,0
4,1,0,0,4,3,1,0,1,0,4,0,1,0,1,0,1,0,4,0,1,0,1,0
0,2,0,4,3,0,3,2,2,0,0,4,3,0,3,2,2,0,0,4,3,0,3,2
4,1,3,4,29,26,3,2,1,3,4,4,3,2,1,0,1,3,4,4,1,0,1,0
1,4,2,0,7,2,5,0,4,2,1,0,5,1,4,0,4,2,1,0,4,1,3,0
4,2,3,4,14,12,2,1,2,3,4,4,2,1,1,0,2,3,4,4,1,0,1,0
1,0,2,3,11,3,8,5,0,2,1,3,8,2,6,4,0,2,1,3,6,1,5,3
3,4,3,4,14,9,5,4,4,3,3,4,5,3,2,1,4,3,3,4,2,1,1,0
1,4,4,1,7,2,5,1,4,4,1,1,5,1,4,1,4,4,1,1,4,1,3,0
4,4,2,1,0,0,0,0,4,2,4,1,0,0,0,0,4,2,4,1,0,0,0,0
1,4,4,3,10,3,7,4,4,4,1,3,7,2,5,3,4,4,1,3,5,1,4,2
1,2,1,1,12,3,9,2,2,1,1,1,9,2,7,2,2,1,1,1,7,2,5,1
4,4,2,4,5,4,1,0,4,2,4,4,1,0,1,0,4,2,4,4,1,0,1,0
0,1,4,4,29,2,27,24,1,4,0,4,27,2,25,22,1,4,0,4,25,2,23,20
1,4,0,0,5,1,4,0,4,0,1,0,4,1,3,0,4,0,1,0,3,0,3,0
4,2,4,0,18,16,2,0,2,4,4,0,2,1,1,0,2,4,4,0,1,0,1,0
3,0,0,2,6,4,2,0,0,0,3,2,2,1,1,0,0,0,3,2,1,0,1,0
1,1,0,2,1,0,1,0,1,0,1,2,1,0,1,0,1,0,1,2,1,0,1,0
1,3,1,0,0,0,0,0,3,1,1,0,0,0,0,0,3,1,1,0,0,0,0,0
4,3,0,0,0,0,0,0,3,0,4,0,0,0,0,0,3,0,4,0,0,0,0,0
0,3,0,0,6,0,6,0,3,0,0,0,6,0,6,0,3,0,0,0,6,0,6,0
4,1,1,0,18,16,2,0,1,1,4,0,2,1,1,0,1,1,4,0,1,0,1,0
1,4,0,1,6,1,5,1,4,0,1,1,5,1,4,1,4,0,1,1,4,1,3,0
2,2,3,4,17,8,9,8,2,3,2,4,9,4,5,4,2,3,2,4,5,2,3,2
3,2,3,4,21,14,7,6,2,3,3,4,7,4,3,2,2,3,3,4,3,2,1,0
4,2,0,4,11,9,2,1,2,0,4,4,2,1,1,0,2,0,4,4,1,0,1,0
0,0,0,3,6,0,6,4,0,0,0,3,6,0,6,4,0,0,0,3,6,0,6,4
3,0,2,1,17,11,6,1,0,2,3,1,6,4,2,0,0,2,3,1,2,1,1,0
4,2,1,4,10,9,1,0,2,1,4,4,1,0,1,0,2,1,4,4,1,0,1,0
4,4,0,4,5,4,1,0,4,0,4,4,1,0,1,0,4,0,4,4,1,0,1,0
2,3,4,2,17,8,9,4,3,4,2,2,9,4,5,2,3,4,2,2,5,2,3,1
4,0,2,1,21,18,3,0,0,2,4,1,3,2,1,0,0,2,4,1,1,0,1,0
0,4,4,3,8,0,8,5,4,4,0,3,8,0,8,5,4,4,0,3,8,0,8,5
2,4,0,3,5,2,3,2,4,0,2,3,3,1,2,1,4,0,2,3,2,1,1,0
0,2,0,3,6,0,6,4,2,0,0,3,6,0,6,4,2,0,0,3,6,0,6,4
0,4,0,4,8,0,8,7,4,0,0,4,8,0,8,7,4,0,0,4,8,0,8,7
1,2,4,1,22,6,16,4,2,4,1,1,16,4,12,3,2,4,1,1,12,3,9,2
2,0,3,0,26,13,13,1,0,3,2,0,13,6,7,0,0,3,2,0,7,3,4,0
4,1,1,1,6,5,1,0,1,1,4,1,1,0,1,0,1,1,4,1,1,0,1,0
4,4,0,1,4,3,1,0,4,0,4,1,1,0,1,0,4,0,4,1,1,0,1,0
2,2,0,1,8,3,5,1,2,0,2,1,5,2,3,0,2,0,2,1,3,1,2,0
2,3,3,1,10,5,5,1,3,3,2,1,5,2,3,0,3,3,2,1,3,1,2,0
1,1,3,4,24,7,17,15,1,3,1,4,17,5,12,10,1,3,1,4,12,3,9,8
2,4,4,2,15,7,8,3,4,4,2,2,8,3,5,2,4,4,2,2,5,2,3,1
3,4,2,2,8,5,3,1,4,2,3,2,3,2,1,0,4,2,3,2,1,0,1,0
4,4,3,4,5,4,1,0,4,3,4,4,1,0,1,0,4,3,4,4,1,0,1,0
0,1,2,2,16,1,15,7,1,2,0,2,15,1,14,7,1,2,0,2,14,1,13,6
0,1,3,2,28,2,26,12,1,3,0,2,26,2,24,12,1,3,0,2,24,2,22,11
4,4,4,4,9,8,1,0,4,4,4,4,1,0,1,0,4,4,4,4,1,0,1,0
4,3,4,1,9,8,1,0,3,4,4,1,1,0,1,0,3,4,4,1,1,0,1,0
0,3,2,3,2,0,2,1,3,2,0,3,2,0,2,1,3,2,0,3,2,0,2,1
0,3,1,0,2,0,2,0,3,1,0,0,2,0,2,0,3,1,0,0,2,0,2,0
3,1,3,3,27,18,9,6,1,3,3,3,9,6,3,2,1,3,3,3,3,2,1,0
1,3,4,1,19,5,14,4,3,4,1,1,14,4,10,2,3,4,1,1,10,2,8,2
2,3,2,3,5,2,3,2,3,2,2,3,3,1,2,1,3,2,2,3,2,1,1,0
4,4,1,0,11,9,2,0,4,1,4,0,2,1,1,0,4,1,4,0,1,0,1,0
1,1,1,4,7,2,5,4,1,1,1,4,5,1,4,3,1,1,1,4,4,1,3,2
3,2,3,4,16,11,5,4,2,3,3,4,5,3,2,1,2,3,3,4,2,1,1,0
0,0,1,2,16,1,15,7,0,1,0,2,15,1,14,7,0,1,0,2,14,1,13,6
0,4,2,4,2,0,2,1,4,2,0,4,2,0,2,1,4,2,0,4,2,0,2,1
1,1,3,1,24,7,17,5,1,3,1,1,17,5,12,3,1,3,1,1,12,3,9,2
3,4,4,0,14,9,5,0,4,4,3,0,5,3,2,0,4,4,3,0,2,1,1,0
2,0,0,1,12,6,6,1,0,0,2,1,6,3,3,0,0,0,2,1,3,1,2,0
2,4,0,1,1,0,1,0,4,0,2,1,1,0,1,0,4,0,2,1,1,0,1,0
4,0,3,0,27,24,3,0,0,3,4,0,3,2,1,0,0,3,4,0,1,0,1,0
0,1,2,2,12,1,11,5,1,2,0,2,11,1,10,4,1,2,0,2,10,1,9,4
1,1,2,4,10,2,8,7,1,2,1,4,8,2,6,5,1,2,1,4,6,1,5,4
2,3,3,3,10,4,6,4,3,3,2,3,6,3,3,2,3,3,2,3,3,1,2,1
1,0,4,0,28,8,20,1,0,4,1,0,20,5,15,1,0,4,1,0,15,4,11,1
2,2,1,3,6,3,3,2,2,1,2,3,3,1,2,1,2,1,2,3,2,0,2,1
3,4,3,4,2,1,1,0,4,3,3,4,1,0,1,0,4,3,3,4,1,0,1,0
2,2,0,2,4,1,3,1,2,0,2,2,3,1,2,1,2,0,2,2,2,0,2,1
0,0,0,1,18,1,17,5,0,0,0,1,17,1,16,4,0,0,0,1,16,1,15,4
0,4,4,3,7,0,7,4,4,4,0,3,7,0,7,4,4,4,0,3,7,0,7,4
0,3,1,3,13,1,12,8,3,1,0,3,12,1,11,7,3,1,0,3,11,1,10,6
0,3,4,0,7,0,7,0,3,4,0,0,7,0,7,0,3,4,0,0,7,0,7,0
4,4,0,1,0,0,0,0,4,0,4,1,0,0,0,0,4,0,4,1,0,0,0,0
3,3,0,4,12,8,4,3,3,0,3,4,4,2,2,1,3,0,3,4,2,1,1,0
3,2,3,0,21,14,7,0,2,3,3,0,7,4,3,0,2,3,3,0,3,2,1,0
4,0,3,0,20,18,2,0,0,3,4,0,2,1,1,0,0,3,4,0,1,0,1,0
4,4,1,2,6,5,1,0,4,1,4,2,1,0,1,0,4,1,4,2,1,0,1,0
4,1,3,3,24,21,3,2,1,3,4,3,3,2,1,0,1,3,4,3,1,0,1,0
1,0,4,2,29,8,21,10,0,4,1,2,21,6,15,7,0,4,1,2,15,4,11,5
4,1,4,0,26,23,3,0,1,4,4,0,3,2,1,0,1,4,4,0,1,0,1,0
1,3,0,3,3,0,3,2,3,0,1,3,3,0,3,2,3,0,1,3,3,0,3,2
0,3,0,1,8,0,8,2,3,0,0,1,8,0,8,2,3,0,0,1,8,0,8,2
3,1,3,0,29,20,9,0,1,3,3,0,9,6,3,0,1,3,3,0,3,2,1,0
3,2,4,4,18,12,6,5,2,4,3,4,6,4,2,1,2,4,3,4,2,1,1,0
2,0,1,3,17,8,9,6,0,1,2,3,9,4,5,3,0,1,2,3,5,2,3,2
0,2,1,3,14,1,13,9,2,1,0,3,13,1,12,8,2,1,0,3,12,1,11,7
4,2,1,0,11,9,2,0,2,1,4,0,2,1,1,0,2,1,4,0,1,0,1,0
4,3,2,1,2,1,1,0,3,2,4,1,1,0,1,0,3,2,4,1,1,0,1,0
0,0,3,3,26,2,24,16,0,3,0,3,24,2,22,15,0,3,0,3,22,2,20,14
3,0,2,1,23,16,7,2,0,2,3,1,7,4,3,0,0,2,3,1,3,2,1,0
0,1,3,4,24,2,22,19,1,3,0,4,22,2,20,17,1,3,0,4,20,1,19,17
4,0,4,0,29,26,3,0,0,4,4,0,3,2,1,0,0,4,4,0,1,0,1,0
3,4,1,3,12,8,4,2,4,1,3,3,4,2,2,1,4,1,3,3,2,1,1,0
4,0,1,1,17,15,2,0,0,1,4,1,2,1,1,0,0,1,4,1,1,0,1,0
0,2,0,0,3,0,3,0,2,0,0,0,3,0,3,0,2,0,0,0,3,0,3,0
0,1,3,0,20,2,18,1,1,3,0,0,18,1,17,1,1,3,0,0,17,1,16,1
4,3,4,4,20,17,3,2,3,4,4,4,3,2,1,0,3,4,4,4,1,0,1,0
0,2,1,2,11,1,10,5,2,1,0,2,10,0,10,5,2,1,0,2,10,1,9,4
2,1,1,0,12,5,7,0,1,1,2,0,7,3,4,0,1,1,2,0,4,2,2,0
4,0,4,2,28,25,3,1,0,4,4,2,3,2,1,0,0,4,4,2,1,0,1,0
0,0,4,3,26,2,24,16,0,4,0,3,24,2,22,15,0,4,0,3,22,2,20,13
2,0,4,4,29,14,15,13,0,4,2,4,15,7,8,7,0,4,2,4,8,4,4,3
0,3,3,1,10,1,9,2,3,3,0,1,9,0,9,2,3,3,0,1,9,0,9,2
2,0,1,1,19,9,10,2,0,1,2,1,10,4,6,1,0,1,2,1,6,2,4,1
3,2,2,2,5,3,2,1,2,2,3,2,2,1,1,0,2,2,3,2,1,0,1,0
2,3,4,0,15,7,8,0,3,4,2,0,8,4,4,0,3,4,2,0,4,1,3,0
4,4,2,4,7,6,1,0,4,2,4,4,1,0,1,0,4,2,4,4,1,0,1,0
2,4,2,3,5,2,3,2,4,2,2,3,3,1,2,1,4,2,2,3,2,1,1,0
1,1,1,2,13,3,10,4,1,1,1,2,10,2,8,4,1,1,1,2,8,2,6,3
1,1,1,1,24,7,17,5,1,1,1,1,17,5,12,3,1,1,1,1,12,3,9,2
3,1,4,3,29,20,9,6,1,4,3,3,9,6,3,2,1,4,3,3,3,2,1,0
0,0,1,3,8,0,8,5,0,1,0,3,8,0,8,5,0,1,0,3,8,0,8,5
0,2,2,0,12,1,11,1,2,2,0,0,11,1,10,0,2,2,0,0,10,0,10,1
2,0,2,1,24,12,12,3,0,2,2,1,12,5,7,2,0,2,2,1,7,3,4,1
1,4,4,3,0,0,0,0,4,4,1,3,0,0,0,0,4,4,1,3,0,0,0,0
0,3,1,0,3,0,3,0,3,1,0,0,3,0,3,0,3,1,0,0,3,0,3,0
1,2,3,4,9,2,7,6,2,3,1,4,7,2,5,4,2,3,1,4,5,1,4,3
0,2,4,0,22,2,20,1,2,4,0,0,20,2,18,1,2,4,0,0,18,1,17,1
3,0,1,1,8,5,3,0,0,1,3,1,3,2,1,0,0,1,3,1,1,0,1,0
0,4,4,2,14,1,13,6,4,4,0,2,13,1,12,5,4,4,0,2,12,1,11,5
2,1,4,0,28,13,15,1,1,4,2,0,15,7,8,0,1,4,2,0,8,3,5,0
2,2,2,1,8,4,4,1,2,2,2,1,4,2,2,0,2,2,2,1,2,0,2,0
2,2,3,3,19,9,10,6,2,3,2,3,10,5,5,3,2,3,2,3,5,2,3,2
0,4,3,2,7,0,7,3,4,3,0,2,7,0,7,3,4,3,0,2,7,0,7,3
4,0,3,0,24,21,3,0,0,3,4,0,3,2,1,0,0,3,4,0,1,0,1,0
1,4,4,4,3,0,3,2,4,4,1,4,3,0,3,2,4,4,1,4,3,0,3,2
0,3,4,0,26,2,24,2,3,4,0,0,24,2,22,2,3,4,0,0,22,2,20,1
2,1,3,2,17,8,9,4,1,3,2,2,9,4,5,2,1,3,2,2,5,2,3,1
3,0,4,1,29,20,9,2,0,4,3,1,9,6,3,0,0,4,3,1,3,2,1,0
1,3,0,0,0,0,0,0,3,0,1,0,0,0,0,0,3,0,1,0,0,0,0,0
0,3,3,2,9,0,9,4,3,3,0,2,9,0,9,4,3,3,0,2,9,0,9,4
2,3,2,3,14,7,7,4,3,2,2,3,7,3,4,2,3,2,2,3,4,1,3,2
4,1,2,4,20,18,2,1,1,2,4,4,2,1,1,0,1,2,4,4,1,0,1,0
2,0,3,4,27,13,14,12,0,3,2,4,14,6,8,7,0,3,2,4,8,4,4,3
0,0,2,4,14,1,13,11,0,2,0,4,13,1,12,10,0,2,0,4,12,1,11,9
2,1,4,2,26,13,13,6,1,4,2,2,13,6,7,3,1,4,2,2,7,3,4,2
4,0,4,4,26,23,3,2,0,4,4,4,3,2,1,0,0,4,4,4,1,0,1,0
2,3,3,3,13,6,7,4,3,3,2,3,7,3,4,2,3,3,2,3,4,2,2,1
3,4,0,4,4,2,2,1,4,0,3,4,2,1,1,0,4,0,3,4,1,0,1,0
0,4,4,2,5,0,5,2,4,4,0,2,5,0,5,2,4,4,0,2,5,0,5,2
4,3,2,3,8,7,1,0,3,2,4,3,1,0,1,0,3,2,4,3,1,0,1,0
4,0,4,3,29,26,3,2,0,4,4,3,3,2,1,0,0,4,4,3,1,0,1,0
1,3,4,1,17,5,12,3,3,4,1,1,12,3,9,2,3,4,1,1,9,2,7,2
0,2,2,1,18,1,17,5,2,2,0,1,17,1,16,4,2,2,0,1,16,1,15,4
2,2,4,3,27,13,14,9,2,4,2,3,14,6,8,5,2,4,2,3,8,3,5,3
2,0,2,4,28,13,15,13,0,2,2,4,15,7,8,7,0,2,2,4,8,4,4,3
2,4,0,2,10,5,5,2,4,0,2,2,5,2,3,1,4,0,2,2,3,1,2,1
0,3,3,3,18,1,17,11,3,3,0,3,17,1,16,11,3,3,0,3,16,1,15,10
2,0,4,3,27,13,14,9,0,4,2,3,14,7,7,4,0,4,2,3,7,3,4,2
2,0,3,0,25,12,13,1,0,3,2,0,13,6,7,0,0,3,2,0,7,3,4,0
3,0,4,3,28,19,9,6,0,4,3,3,9,6,3,2,0,4,3,3,3,2,1,0
1,4,1,2,0,0,0,0,4,1,1,2,0,0,0,0,4,1,1,2,0,0,0,0
2,1,2,1,14,6,8,2,1,2,2,1,8,4,4,1,1,2,2,1,4,2,2,0
3,2,0,4,6,4,2,1,2,0,3,4,2,1,1,0,2,0,3,4,1,0,1,0
4,1,1,0,9,8,1,0,1,1,4,0,1,0,1,0,1,1,4,0,1,0,1,0
4,2,1,1,12,10,2,0,2,1,4,1,2,1,1,0,2,1,4,1,1,0,1,0
0,2,3,1,15,1,14,4,2,3,0,1,14,1,13,3,2,3,0,1,13,1,12,3
3,3,4,2,16,11,5,2,3,4,3,2,5,3,2,1,3,4,3,2,2,1,1,0
0,2,4,2,29,2,27,13,2,4,0,2,27,2,25,12,2,4,0,2,25,2,23,11
1,3,0,4,4,1,3,2,3,0,1,4,3,0,3,2,3,0,1,4,3,0,3,2
0,1,0,1,9,0,9,2,1,0,0,1,9,0,9,2,1,0,0,1,9,0,9,2
3,0,3,2,27,18,9,4,0,3,3,2,9,6,3,1,0,3,3,2,3,2,1,0
0,1,1,2,8,0,8,3,1,1,0,2,8,0,8,4,1,1,0,2,8,0,8,4
3,1,0,2,4,2,2,0,1,0,3,2,2,1,1,0,1,0,3,2,1,0,1,0
2,2,0,4,6,3,3,2,2,0,2,4,3,1,2,1,2,0,2,4,2,1,1,0
1,1,1,4,10,3,7,6,1,1,1,4,7,2,5,4,1,1,1,4,5,1,4,3
2,2,1,3,5,2,3,2,2,1,2,3,3,1,2,1,2,1,2,3,2,0,2,1
0,2,4,2,20,2,18,9,2,4,0,2,18,1,17,8,2,4,0,2,17,1,16,7
0,4,1,3,3,0,3,2,4,1,0,3,3,0,3,2,4,1,0,3,3,0,3,2
3,4,3,0,9,6,3,0,4,3,3,0,3,2,1,0,4,3,3,0,1,0,1,0
3,4,4,3,3,2,1,0,4,4,3,3,1,0,1,0,4,4,3,3,1,0,1,0
2,3,0,0,1,0,1,0,3,0,2,0,1,0,1,0,3,0,2,0,1,0,1,0
1,0,0,3,2,0,2,1,0,0,1,3,2,0,2,1,0,0,1,3,2,0,2,1
4,1,0,1,13,11,2,0,1,0,4,1,2,1,1,0,1,0,4,1,1,0,1,0
1,1,1,3,10,3,7,4,1,1,1,3,7,2,5,3,1,1,1,3,5,1,4,2
2,4,2,0,9,4,5,0,4,2,2,0,5,2,3,0,4,2,2,0,3,1,2,0
2,1,0,1,9,4,5,1,1,0,2,1,5,2,3,0,1,0,2,1,3,1,2,0
2,3,0,4,1,0,1,0,3,0,2,4,1,0,1,0,3,0,2,4,1,0,1,0
0,2,4,0,20,2,18,1,2,4,0,0,18,1,17,1,2,4,0,0,17,1,16,1
0,2,4,1,27,2,25,7,2,4,0,1,25,2,23,6,2,4,0,1,23,2,21,6
4,2,0,2,5,4,1,0,2,0,4,2,1,0,1,0,2,0,4,2,1,0,1,0
2,3,4,1,17,8,9,2,3,4,2,1,9,4,5,1,3,4,2,1,5,2,3,0
0,1,0,2,4,0,4,2,1,0,0,2,4,0,4,1,1,0,0,2,4,0,4,2
1,3,0,3,2,0,2,1,3,0,1,3,2,0,2,1,3,0,1,3,2,0,2,1
0,0,4,4,28,2,26,23,0,4,0,4,26,2,24,21,0,4,0,4,24,2,22,19
3,2,1,2,8,5,3,1,2,1,3,2,3,2,1,0,2,1,3,2,1,0,1,0
1,4,3,4,6,1,5,4,4,3,1,4,5,1,4,3,4,3,1,4,4,1,3,2
4,3,0,0,6,5,1,0,3,0,4,0,1,0,1,0,3,0,4,0,1,0,1,0
1,2,3,3,14,4,10,6,2,3,1,3,10,3,7,4,2,3,1,3,7,2,5,3
0,0,1,4,10,1,9,8,0,1,0,4,9,0,9,8,0,1,0,4,9,0,9,8
4,1,1,0,7,6,1,0,1,1,4,0,1,0,1,0,1,1,4,0,1,0,1,0
3,1,3,2,25,17,8,4,1,3,3,2,8,5,3,1,1,3,3,2,3,2,1,0
3,0,4,0,27,18,9,0,0,4,3,0,9,6,3,0,0,4,3,0,3,2,1,0
4,4,3,4,6,5,1,0,4,3,4,4,1,0,1,0,4,3,4,4,1,0,1,0
3,4,2,0,5,3,2,0,4,2,3,0,2,1,1,0,4,2,3,0,1,0,1,0
0,4,3,4,13,1,12,10,4,3,0,4,12,1,11,9,4,3,0,4,11,1,10,9
1,0,2,4,17,5,12,10,0,2,1,4,12,3,9,8,0,2,1,4,9,2,7,6
4,1,1,0,7,6,1,0,1,1,4,0,1,0,1,0,1,1,4,0,1,0,1,0
0,1,3,1,23,2,21,6,1,3,0,1,21,2,19,5,1,3,0,1,19,1,18,5
2,1,2,2,23,11,12,6,1,2,2,2,12,6,6,3,1,2,2,2,6,2,4,2
1,2,1,0,9,2,7,0,2,1,1,0,7,2,5,0,2,1,1,0,5,1,4,0
2,2,0,0,9,4,5,0,2,0,2,0,5,2,3,0,2,0,2,0,3,1,2,0
0,0,2,1,26,2,24,7,0,2,0,1,24,2,22,6,0,2,0,1,22,2,20,5
4,1,0,2,4,3,1,0,1,0,4,2,1,0,1,0,1,0,4,2,1,0,1,0
0,1,3,1,15,1,14,4,1,3,0,1,14,1,13,3,1,3,0,1,13,1,12,3
4,1,4,2,27,24,3,1,1,4,4,2,3,2,1,0,1,4,4,2,1,0,1,0
1,3,2,2,8,2,6,2,3,2,1,2,6,1,5,2,3,2,1,2,5,1,4,1
2,3,1,2,1,0,1,0,3,1,2,2,1,0,1,0,3,1,2,2,1,0,1,0
2,1,1,4,4,2,2,1,1,1,2,4,2,1,1,0,1,1,2,4,1,0,1,0
1,0,3,2,29,8,21,10,0,3,1,2,21,6,15,7,0,3,1,2,15,4,11,5
4,3,1,1,5,4,1,0,3,1,4,1,1,0,1,0,3,1,4,1,1,0,1,0
4,2,3,2,15,13,2,1,2,3,4,2,2,1,1,0,2,3,4,2,1,0,1,0
0,4,3,2,8,0,8,4,4,3,0,2,8,0,8,3,4,3,0,2,8,0,8,3
0,3,3,4,15,1,14,12,3,3,0,4,14,1,13,11,3,3,0,4,13,1,12,10
0,3,0,2,2,0,2,0,3,0,0,2,2,0,2,0,3,0,0,2,2,0,2,1
4,3,1,4,8,7,1,0,3,1,4,4,1,0,1,0,3,1,4,4,1,0,1,0
2,1,2,2,25,12,13,6,1,2,2,2,13,6,7,3,1,2,2,2,7,3,4,2
1,3,1,1,4,1,3,0,3,1,1,1,3,0,3,0,3,1,1,1,3,0,3,0
3,3,0,0,0,0,0,0,3,0,3,0,0,0,0,0,3,0,3,0,0,0,0,0
4,2,2,2,5,4,1,0,2,2,4,2,1,0,1,0,2,2,4,2,1,0,1,0
0,0,2,0,19,1,18,1,0,2,0,0,18,1,17,1,0,2,0,0,17,1,16,1
2,2,1,3,18,9,9,6,2,1,2,3,9,4,5,3,2,1,2,3,5,2,3,2
3,4,3,3,9,6,3,2,4,3,3,3,3,2,1,0,4,3,3,3,1,0,1,0
1,0,3,0,29,8,21,2,0,3,1,0,21,6,15,1,0,3,1,0,15,4,11,1
1,4,2,4,2,0,2,1,4,2,1,4,2,0,2,1,4,2,1,4,2,0,2,1
3,3,2,2,13,9,4,1,3,2,3,2,4,2,2,1,3,2,3,2,2,1,1,0
2,0,1,3,19,9,10,7,0,1,2,3,10,5,5,3,0,1,2,3,5,2,3,2
